event_time,event_name,surface,num_of_sets,playerA,playerB,winner,score,round,duration_minutes,a_aces,a_double_faults,a_first_serve_hits,a_first_serve_total,a_first_serve_won,a_first_serve_played,a_second_serve_won,a_second_serve_played,a_break_points_saved,a_break_points_total,a_service_games,a_service_points_won,a_service_points_total,b_aces,b_double_faults,b_first_serve_hits,b_first_serve_total,b_first_serve_won,b_first_serve_played,b_second_serve_won,b_second_serve_played,b_break_points_saved,b_break_points_total,b_service_games,b_service_points_won,b_service_points_total
1995-01-02 00:00:00.000,Adelaide Australia ATP World Tour,HARD,2,Yevgeny Kafelnikov,Marcos Ondruska,Yevgeny Kafelnikov,7-6(5); 6-1,R32,82,5,1,22,57,17,22,23,35,0,1,9,40,57,5,4,48,75,31,48,11,27,11,15,10,42,75
1995-01-02 00:00:00.000,Adelaide Australia ATP World Tour,HARD,2,Henrik Holm,Cedric Pioline,Henrik Holm,6-2; 6-2,R32,70,4,8,28,59,22,28,17,31,7,7,8,39,59,1,5,30,55,19,30,9,25,7,11,8,28,55
1995-01-02 00:00:00.000,Adelaide Australia ATP World Tour,HARD,2,Jeremy Bates,Joern Renzenbrink,Jeremy Bates,6-4; 4-6; 6-4,R32,101,1,4,43,84,30,43,23,41,0,3,15,53,84,9,9,48,86,34,48,19,38,3,7,15,53,86
1995-01-02 00:00:00.000,Adelaide Australia ATP World Tour,HARD,2,Mark Woodforde,Marc-Kevin Goellner,Mark Woodforde,6-4; 6-4,R32,67,9,2,30,53,26,30,12,23,0,1,10,38,53,4,8,28,66,21,28,17,38,3,6,10,38,66
1995-01-02 00:00:00.000,Adelaide Australia ATP World Tour,HARD,2,Jim Courier,Jakob Hlasek,Jim Courier,7-6(2); 6-1,R32,82,2,2,36,65,26,36,16,29,5,6,9,42,65,4,6,42,71,25,42,11,29,3,7,10,36,71
1995-01-02 00:00:00.000,Adelaide Australia ATP World Tour,HARD,2,Daniel Vacek,Alex O'Brien,Daniel Vacek,6-4; 5-7; 6-4,R32,132,9,9,62,94,46,62,16,32,3,5,16,62,94,2,3,76,124,52,76,26,48,13,16,16,78,124
1995-01-02 00:00:00.000,Adelaide Australia ATP World Tour,HARD,2,Thomas Enqvist,David Adams,Thomas Enqvist,6-4; 6-3,R32,0,4,4,30,51,24,30,9,21,1,3,9,33,51,7,1,35,68,21,35,15,33,5,10,10,36,68
1995-01-02 00:00:00.000,Adelaide Australia ATP World Tour,HARD,2,Jason Stoltenberg,Nicklas Kulti,Jason Stoltenberg,7-5; 6-3,R32,82,6,8,31,67,27,31,20,36,1,1,11,47,67,3,4,40,73,27,40,16,33,6,8,10,43,73
1995-01-02 00:00:00.000,Adelaide Australia ATP World Tour,HARD,2,Patrick Rafter,Todd Woodbridge,Patrick Rafter,7-6(3); 6-1,R32,84,5,1,43,71,28,43,20,28,3,4,10,48,71,0,0,30,62,15,30,19,32,4,7,9,34,62
1995-01-02 00:00:00.000,Adelaide Australia ATP World Tour,HARD,2,Jamie Morgan,Byron Black,Jamie Morgan,4-6; 6-2; 6-3,R32,90,12,0,44,82,33,44,23,38,4,6,14,56,82,2,4,37,65,27,37,15,28,2,6,13,42,65
1995-01-02 00:00:00.000,Adelaide Australia ATP World Tour,HARD,2,Richard Fromberg,Jonathan Stark,Richard Fromberg,6-4; 6-2,R32,62,12,3,31,49,26,31,12,18,0,0,9,38,49,1,2,38,58,25,38,9,20,5,8,9,34,58
1995-01-02 00:00:00.000,Adelaide Australia ATP World Tour,HARD,2,Richard Krajicek,Fabrice Santoro,Richard Krajicek,6-3; 6-3,R32,64,6,1,26,48,23,26,14,22,2,2,9,37,48,1,4,31,63,18,31,19,32,4,7,9,37,63
1995-01-02 00:00:00.000,Adelaide Australia ATP World Tour,HARD,2,Renzo Furlan,Gianluca Pozzi,Renzo Furlan,6-3; 6-4,R32,68,4,0,26,52,20,26,17,26,2,4,10,37,52,2,1,30,59,19,30,13,29,5,9,9,32,59
1995-01-02 00:00:00.000,Adelaide Australia ATP World Tour,HARD,2,Arnaud Boetsch,Bryan Shelton,Arnaud Boetsch,4-6; 7-5; 7-6(2),R32,149,1,6,73,127,54,73,26,54,10,12,17,80,127,6,8,74,118,52,74,22,44,13,15,17,74,118
1995-01-02 00:00:00.000,Adelaide Australia ATP World Tour,HARD,2,Carl-Uwe Steeb,Wally Masur,Carl-Uwe Steeb,6-4; 7-6(5),R32,90,1,1,41,65,33,41,17,24,1,1,11,50,65,9,2,39,85,29,39,25,46,5,6,11,54,85
1995-01-02 00:00:00.000,Adelaide Australia ATP World Tour,HARD,2,Hendrik Dreekmann,Wayne Ferreira,Hendrik Dreekmann,7-6(6); 6-2,R32,86,4,2,39,70,27,39,18,31,3,5,10,45,70,4,6,36,75,24,36,18,39,8,12,10,42,75
1995-01-02 00:00:00.000,Adelaide Australia ATP World Tour,HARD,2,Yevgeny Kafelnikov,Henrik Holm,Yevgeny Kafelnikov,7-5; 6-3,R16,73,3,0,38,58,33,38,9,20,0,1,11,42,58,11,12,42,75,35,42,6,33,9,12,10,41,75
1995-01-02 00:00:00.000,Adelaide Australia ATP World Tour,HARD,2,Mark Woodforde,Jeremy Bates,Mark Woodforde,7-6(6); 6-4,R16,91,4,1,38,73,28,38,21,35,2,3,11,49,73,4,10,39,77,33,39,12,38,2,4,11,45,77
1995-01-02 00:00:00.000,Adelaide Australia ATP World Tour,HARD,2,Jim Courier,Daniel Vacek,Jim Courier,6-3; 6-4,R16,69,1,3,45,65,30,45,12,20,2,3,10,42,65,4,6,32,55,21,32,11,23,0,3,9,32,55
1995-01-02 00:00:00.000,Adelaide Australia ATP World Tour,HARD,2,Thomas Enqvist,Jason Stoltenberg,Thomas Enqvist,6-4; 6-4,R16,70,3,1,34,55,25,34,10,21,5,8,10,35,55,2,1,34,64,22,34,10,30,5,10,10,32,64
1995-01-02 00:00:00.000,Adelaide Australia ATP World Tour,HARD,2,Patrick Rafter,Jamie Morgan,Patrick Rafter,7-6(2); 6-3,R16,94,5,5,43,68,35,43,15,25,0,0,11,50,68,4,4,44,76,33,44,14,32,4,5,10,47,76
1995-01-02 00:00:00.000,Adelaide Australia ATP World Tour,HARD,2,Richard Krajicek,Richard Fromberg,Richard Krajicek,7-5; 7-5,R16,82,6,4,32,65,29,32,20,33,2,2,12,49,65,4,5,49,75,38,49,11,26,5,7,12,49,75
1995-01-02 00:00:00.000,Adelaide Australia ATP World Tour,HARD,2,Arnaud Boetsch,Renzo Furlan,Arnaud Boetsch,6-3; 7-5,R16,91,5,5,39,73,30,39,12,34,2,5,11,42,73,2,4,37,67,20,37,14,30,6,11,10,34,67
1995-01-02 00:00:00.000,Adelaide Australia ATP World Tour,HARD,2,Hendrik Dreekmann,Carl-Uwe Steeb,Hendrik Dreekmann,7-6(2); 3-6; 6-2,R16,108,7,3,34,80,26,34,21,46,2,7,14,47,80,3,4,52,84,27,52,17,32,3,9,15,44,84
1995-01-02 00:00:00.000,Adelaide Australia ATP World Tour,HARD,2,Mark Woodforde,Yevgeny Kafelnikov,Mark Woodforde,6-3; 7-5,Q,96,6,4,30,67,23,30,20,37,1,3,11,43,67,1,5,56,91,33,56,14,35,8,12,10,47,91
1995-01-02 00:00:00.000,Adelaide Australia ATP World Tour,HARD,2,Jim Courier,Thomas Enqvist,Jim Courier,6-2; 6-4,Q,68,2,1,38,56,28,38,9,18,1,2,9,37,56,3,3,36,57,23,36,7,21,6,10,9,30,57
1995-01-02 00:00:00.000,Adelaide Australia ATP World Tour,HARD,2,Richard Krajicek,Patrick Rafter,Richard Krajicek,6-4; 7-6(4),Q,78,10,5,39,80,35,39,21,41,5,5,11,56,80,9,0,42,69,31,42,17,27,4,5,11,48,69
1995-01-02 00:00:00.000,Adelaide Australia ATP World Tour,HARD,2,Arnaud Boetsch,Hendrik Dreekmann,Arnaud Boetsch,6-3; 6-4,Q,67,1,3,30,50,26,30,9,20,1,3,10,35,50,2,2,26,60,14,26,16,34,6,10,9,30,60
1995-01-02 00:00:00.000,Adelaide Australia ATP World Tour,HARD,2,Jim Courier,Mark Woodforde,Jim Courier,6-3; 6-4,S,82,2,3,50,76,35,50,14,26,10,11,10,49,76,4,3,31,57,21,31,11,26,1,4,9,32,57
1995-01-02 00:00:00.000,Adelaide Australia ATP World Tour,HARD,2,Arnaud Boetsch,Richard Krajicek,Arnaud Boetsch,7-6(4); 6-2,S,67,2,2,39,61,30,39,14,22,2,3,10,44,61,5,4,38,65,28,38,11,27,2,5,10,39,65
1995-01-02 00:00:00.000,Adelaide Australia ATP World Tour,HARD,2,Jim Courier,Arnaud Boetsch,Jim Courier,6-2; 7-5,F,96,4,0,44,73,29,44,18,29,3,4,10,47,73,1,2,43,79,26,43,16,36,6,10,10,42,79
1995-01-02 00:00:00.000,Doha Qatar ATP World Tour,HARD,2,Stefan Edberg,Ronald Agenor,Stefan Edberg,6-2; 7-6(8),R32,89,1,6,36,69,26,36,18,33,3,5,10,44,69,4,1,49,66,30,49,7,17,2,6,10,37,66
1995-01-02 00:00:00.000,Doha Qatar ATP World Tour,HARD,2,Adrian Voinea,Jeff Tarango,Adrian Voinea,6-7(4); 7-6(5); 6-3,R32,135,7,4,71,112,48,71,19,41,6,10,16,67,112,2,2,100,126,59,100,9,26,8,14,17,68,126
1995-01-02 00:00:00.000,Doha Qatar ATP World Tour,HARD,2,Younes El Aynaoui,Lars Jonsson,Younes El Aynaoui,2-6; 6-4; 7-6(4),R32,114,10,2,55,91,38,55,20,36,4,7,15,58,91,1,2,74,101,49,74,16,27,7,9,15,65,101
1995-01-02 00:00:00.000,Doha Qatar ATP World Tour,HARD,2,Karim Alami,Paul Haarhuis,Karim Alami,5-7; 6-3; 7-5,R32,138,5,6,49,104,42,49,25,55,4,6,16,67,104,7,5,59,112,44,59,26,53,9,13,17,70,112
1995-01-02 00:00:00.000,Doha Qatar ATP World Tour,HARD,2,Javier Sanchez,Jacco Eltingh,Javier Sanchez,3-6; 6-2; 6-3,R32,92,2,3,46,72,32,46,16,26,2,4,13,48,72,2,6,51,86,34,51,16,35,4,8,13,50,86
1995-01-02 00:00:00.000,Doha Qatar ATP World Tour,HARD,2,Karsten Braasch,Sandor Noszaly,Karsten Braasch,3-6; 6-3; 6-2,R32,97,13,2,40,74,32,40,17,34,0,2,13,49,74,2,6,54,85,32,54,17,31,1,5,13,49,85
1995-01-02 00:00:00.000,Doha Qatar ATP World Tour,HARD,2,Filip Dewulf,Patrik Kuhnen,Filip Dewulf,6-3; 4-6; 6-1,R32,97,5,3,44,76,37,44,17,32,2,3,13,54,76,9,8,58,94,39,58,13,36,6,10,13,52,94
1995-01-02 00:00:00.000,Doha Qatar ATP World Tour,HARD,2,Henri Leconte,Alexander Volkov,Henri Leconte,4-6; 7-6(6); 7-5,R32,156,5,9,60,129,40,60,32,69,11,17,17,72,129,5,9,67,119,41,67,26,52,12,18,17,67,119
1995-01-02 00:00:00.000,Doha Qatar ATP World Tour,HARD,2,Markus Zoecke,Bernd Karbacher,Markus Zoecke,4-6; 6-3; 6-4,R32,123,9,7,53,91,41,53,22,38,6,7,15,63,91,6,3,40,90,31,40,28,50,5,7,14,59,90
1995-01-02 00:00:00.000,Doha Qatar ATP World Tour,HARD,2,Shuzo Matsuoka,Jan Apell,Shuzo Matsuoka,7-6(3); 6-4,R32,91,9,3,45,64,32,45,9,19,2,5,11,41,64,0,2,50,84,26,50,20,34,4,8,11,46,84
1995-01-02 00:00:00.000,Doha Qatar ATP World Tour,HARD,2,Jonas Bjorkman,Alexander Mronz,Jonas Bjorkman,7-5; 6-2,R32,79,3,4,26,50,24,26,14,24,1,2,10,38,50,2,4,44,79,27,44,16,35,5,9,10,43,79
1995-01-02 00:00:00.000,Doha Qatar ATP World Tour,HARD,2,Magnus Larsson,Karol Kucera,Magnus Larsson,6-1; 6-4,R32,75,2,2,28,60,23,28,17,32,2,3,9,40,60,1,3,41,70,24,41,11,29,8,12,8,35,70
1995-01-02 00:00:00.000,Doha Qatar ATP World Tour,HARD,2,Guy Forget,Patrick McEnroe,Guy Forget,7-5; 6-2,R32,83,14,2,34,63,29,34,15,29,2,3,10,44,63,1,2,33,56,19,33,12,23,2,6,10,31,56
1995-01-02 00:00:00.000,Doha Qatar ATP World Tour,HARD,2,Jan Siemerink,Andrei Olhovskiy,Jan Siemerink,6-1; 6-2,R32,60,1,0,32,47,25,32,10,15,1,1,8,35,47,0,2,31,55,13,31,13,24,8,12,7,26,55
1995-01-02 00:00:00.000,Doha Qatar ATP World Tour,HARD,2,Oliver Gross,Gilbert Schaller,Oliver Gross,4-6; 7-6(1); 6-2,R32,127,7,4,44,86,37,44,23,42,4,7,15,60,86,1,2,73,111,41,73,20,38,15,19,15,61,111
1995-01-02 00:00:00.000,Doha Qatar ATP World Tour,HARD,2,Michael Stich,Olivier Delaitre,Michael Stich,6-3; 7-5,R32,82,6,3,34,70,23,34,19,36,1,4,11,42,70,0,2,40,62,19,40,12,22,5,10,10,31,62
1995-01-02 00:00:00.000,Doha Qatar ATP World Tour,HARD,2,Stefan Edberg,Adrian Voinea,Stefan Edberg,6-7(8); 6-3; 6-3,R16,111,0,5,57,89,42,57,18,32,3,6,15,60,89,3,0,54,93,30,54,25,39,0,6,15,55,93
1995-01-02 00:00:00.000,Doha Qatar ATP World Tour,HARD,2,Karim Alami,Younes El Aynaoui,Karim Alami,7-5; 6-3,R16,94,2,7,42,77,30,42,18,35,2,4,11,48,77,2,1,37,64,24,37,12,27,6,10,10,36,64
1995-01-02 00:00:00.000,Doha Qatar ATP World Tour,HARD,2,Javier Sanchez,Karsten Braasch,Javier Sanchez,6-7(2); 6-0; 6-4,R16,105,1,2,67,94,47,67,15,27,7,8,14,62,94,7,2,40,88,32,40,21,48,7,12,14,53,88
1995-01-02 00:00:00.000,Doha Qatar ATP World Tour,HARD,2,Henri Leconte,Filip Dewulf,Henri Leconte,6-3; 7-6(1),R16,85,5,1,25,60,20,25,24,35,0,2,11,44,60,5,1,34,70,24,34,16,36,4,7,10,40,70
1995-01-02 00:00:00.000,Doha Qatar ATP World Tour,HARD,2,Markus Zoecke,Shuzo Matsuoka,Markus Zoecke,6-1; 6-3,R16,66,2,2,30,46,22,30,9,16,0,1,8,31,46,3,5,23,51,13,23,12,28,5,10,8,25,51
1995-01-02 00:00:00.000,Doha Qatar ATP World Tour,HARD,2,Magnus Larsson,Jonas Bjorkman,Magnus Larsson,6-2; 7-6(4),R16,79,9,1,44,66,32,44,14,22,5,6,10,46,66,0,3,35,71,24,35,16,36,7,10,10,40,71
1995-01-02 00:00:00.000,Doha Qatar ATP World Tour,HARD,2,Jan Siemerink,Guy Forget,Jan Siemerink,6-3; 7-6(5),R16,98,4,2,49,81,39,49,17,32,6,6,11,56,81,1,4,51,80,37,51,14,29,6,7,10,51,80
1995-01-02 00:00:00.000,Doha Qatar ATP World Tour,HARD,2,Michael Stich,Oliver Gross,Michael Stich,6-4; 7-5,R16,86,3,4,41,77,32,41,20,36,6,6,11,52,77,4,2,31,63,23,31,19,32,1,3,11,42,63
1995-01-02 00:00:00.000,Doha Qatar ATP World Tour,HARD,2,Stefan Edberg,Karim Alami,Stefan Edberg,6-1; 6-1,Q,44,0,0,23,34,22,23,6,11,0,0,7,28,34,3,1,30,47,16,30,3,17,3,8,7,19,47
1995-01-02 00:00:00.000,Doha Qatar ATP World Tour,HARD,2,Henri Leconte,Javier Sanchez,Henri Leconte,4-6; 6-4; 6-3,Q,106,2,5,49,97,37,49,23,48,9,12,15,60,97,3,2,66,89,44,66,11,23,9,13,14,55,89
1995-01-02 00:00:00.000,Doha Qatar ATP World Tour,HARD,2,Magnus Larsson,Markus Zoecke,Magnus Larsson,7-6(7); 4-6; 6-3,Q,111,10,4,59,90,50,59,16,31,2,3,16,66,90,15,6,56,98,46,56,21,42,2,3,15,67,98
1995-01-02 00:00:00.000,Doha Qatar ATP World Tour,HARD,2,Michael Stich,Jan Siemerink,Michael Stich,6-3; 6-1,Q,58,5,3,25,45,23,25,10,20,0,0,8,33,45,1,1,33,50,16,33,9,17,5,9,8,25,50
1995-01-02 00:00:00.000,Doha Qatar ATP World Tour,HARD,2,Stefan Edberg,Henri Leconte,Stefan Edberg,6-2; 7-6(5),S,85,5,4,36,67,26,36,15,31,5,8,10,41,67,3,2,45,74,26,45,10,29,8,13,10,36,74
1995-01-02 00:00:00.000,Doha Qatar ATP World Tour,HARD,2,Magnus Larsson,Michael Stich,Magnus Larsson,6-3; 6-2,S,64,4,1,42,61,29,42,13,19,3,3,9,42,61,5,2,36,52,23,36,7,16,3,6,8,30,52
1995-01-02 00:00:00.000,Doha Qatar ATP World Tour,HARD,2,Stefan Edberg,Magnus Larsson,Stefan Edberg,7-6(4); 6-1,F,79,5,2,37,64,30,37,18,27,1,1,10,48,64,5,1,48,71,34,48,9,23,6,8,9,43,71
1995-01-09 00:00:00.000,Auckland New Zealand ATP World Tour,HARD,2,Jan Siemerink,Wayne Ferreira,Jan Siemerink,2-6; 7-5; 6-3,R32,86,3,4,43,77,32,43,18,34,1,5,15,50,77,4,2,56,80,38,56,10,24,4,8,14,48,80
1995-01-09 00:00:00.000,Auckland New Zealand ATP World Tour,HARD,2,Alex O'Brien,James Sekulov,Alex O'Brien,7-6(7); 6-4,R32,93,4,2,50,81,35,50,19,31,5,6,11,54,81,1,1,44,71,28,44,17,27,1,3,11,45,71
1995-01-09 00:00:00.000,Auckland New Zealand ATP World Tour,HARD,2,Vincent Spadea,Henrik Holm,Vincent Spadea,7-6(4); 6-3,R32,84,0,1,41,68,31,41,16,27,7,8,10,47,68,4,8,41,74,28,41,15,33,3,6,11,43,74
1995-01-09 00:00:00.000,Auckland New Zealand ATP World Tour,HARD,2,Carl-Uwe Steeb,Jonas Bjorkman,Carl-Uwe Steeb,0-6; 6-1; 7-5,R32,96,4,2,50,81,30,50,18,31,3,7,13,48,81,6,6,34,83,24,34,24,49,7,11,12,48,83
1995-01-09 00:00:00.000,Auckland New Zealand ATP World Tour,HARD,2,Javier Sanchez,Byron Black,Javier Sanchez,7-6(9); 6-2,R32,85,7,1,52,72,41,52,8,20,3,4,10,49,72,1,2,43,79,25,43,19,36,5,8,10,44,79
1995-01-09 00:00:00.000,Auckland New Zealand ATP World Tour,HARD,2,Jakob Hlasek,Luiz Mattar,Jakob Hlasek,6-1; 6-2,R32,64,4,1,33,53,25,33,11,20,1,1,8,36,53,0,1,20,45,10,20,12,25,5,9,7,22,45
1995-01-09 00:00:00.000,Auckland New Zealand ATP World Tour,HARD,2,Marc-Kevin Goellner,Jan Apell,Marc-Kevin Goellner,4-6; 6-3; 6-4,R32,96,14,3,59,91,49,59,16,32,9,10,15,65,91,5,1,52,93,36,52,24,41,3,5,14,60,93
1995-01-09 00:00:00.000,Auckland New Zealand ATP World Tour,HARD,2,Chuck Adams,Scott Clark,Chuck Adams,6-2; 6-2,R32,69,6,2,23,36,21,23,11,13,0,0,8,32,36,0,1,36,64,15,36,17,28,1,5,8,32,64
1995-01-09 00:00:00.000,Auckland New Zealand ATP World Tour,HARD,2,Steven Downs,Fabrice Santoro,Steven Downs,6-2; 4-6; 6-1,R32,107,5,4,47,82,32,47,13,35,5,9,13,45,82,2,5,65,89,36,65,7,24,8,15,12,43,89
1995-01-09 00:00:00.000,Auckland New Zealand ATP World Tour,HARD,2,Brett Steven,Ben Ellwood,Brett Steven,7-6(2); 7-6(5),R32,120,1,2,54,82,42,54,18,28,2,2,12,60,82,6,5,53,96,38,53,22,43,1,1,12,60,96
1995-01-09 00:00:00.000,Auckland New Zealand ATP World Tour,HARD,2,Thomas Enqvist,Jonathan Stark,Thomas Enqvist,7-6(2); 6-3,R32,83,11,6,33,70,28,33,22,37,6,7,11,50,70,15,3,39,63,31,39,10,24,4,6,10,41,63
1995-01-09 00:00:00.000,Auckland New Zealand ATP World Tour,HARD,2,Christian Ruud,MaliVai Washington,Christian Ruud,7-6(3); 3-6; 6-3,R32,142,3,1,71,112,49,71,20,41,9,12,15,69,112,7,5,60,107,39,60,26,47,9,12,15,65,107
1995-01-09 00:00:00.000,Auckland New Zealand ATP World Tour,HARD,2,Cedric Pioline,Bryan Shelton,Cedric Pioline,6-0; 6-4,R32,64,3,0,26,44,17,26,15,18,0,0,8,32,44,0,5,29,54,17,29,10,25,5,9,8,27,54
1995-01-09 00:00:00.000,Auckland New Zealand ATP World Tour,HARD,2,Hendrik Dreekmann,Gianluca Pozzi,Hendrik Dreekmann,6-3; 7-6(4),R32,91,2,0,31,58,25,31,17,27,2,3,10,42,58,3,2,53,96,35,53,19,43,5,8,11,54,96
1995-01-09 00:00:00.000,Auckland New Zealand ATP World Tour,HARD,2,Jeremy Bates,Brian Dunn,Jeremy Bates,7-5; 0-1 RET,R32,41,2,1,20,31,17,20,7,11,0,0,7,24,31,5,1,20,40,16,20,11,20,1,2,7,27,40
1995-01-09 00:00:00.000,Auckland New Zealand ATP World Tour,HARD,2,Alexander Volkov,James Greenhalgh,Alexander Volkov,6-4; 6-4,R32,76,6,3,36,63,25,36,15,27,3,5,10,40,63,4,3,38,62,25,38,9,24,2,6,10,34,62
1995-01-09 00:00:00.000,Auckland New Zealand ATP World Tour,HARD,2,Jan Siemerink,Alex O'Brien,Jan Siemerink,7-5; 6-3,R16,80,8,1,48,69,33,48,14,21,7,9,11,47,69,1,2,37,56,22,37,9,19,3,7,10,31,56
1995-01-09 00:00:00.000,Auckland New Zealand ATP World Tour,HARD,2,Vincent Spadea,Carl-Uwe Steeb,Vincent Spadea,6-3; 6-1,R16,72,6,1,34,64,26,34,12,30,5,6,8,38,64,1,1,36,60,18,36,10,24,5,10,8,28,60
1995-01-09 00:00:00.000,Auckland New Zealand ATP World Tour,HARD,2,Jakob Hlasek,Javier Sanchez,Jakob Hlasek,6-1; 6-2,R16,54,2,0,33,45,25,33,6,12,1,2,8,31,45,0,2,35,54,18,35,5,19,3,8,7,23,54
1995-01-09 00:00:00.000,Auckland New Zealand ATP World Tour,HARD,2,Chuck Adams,Marc-Kevin Goellner,Chuck Adams,7-5; 7-6(10),R16,10,6,5,50,84,38,50,14,34,1,3,12,52,84,7,1,36,76,27,36,20,40,1,4,12,47,76
1995-01-09 00:00:00.000,Auckland New Zealand ATP World Tour,HARD,2,Brett Steven,Steven Downs,Brett Steven,6-3; 6-4,R16,78,5,2,52,68,37,52,10,16,2,2,10,47,68,3,4,41,65,26,41,10,24,2,4,9,36,65
1995-01-09 00:00:00.000,Auckland New Zealand ATP World Tour,HARD,2,Thomas Enqvist,Christian Ruud,Thomas Enqvist,6-4; 5-7; 6-1,R16,126,14,1,54,86,40,54,14,32,4,7,14,54,86,11,4,65,121,40,65,26,56,12,18,15,66,121
1995-01-09 00:00:00.000,Auckland New Zealand ATP World Tour,HARD,2,Cedric Pioline,Hendrik Dreekmann,Cedric Pioline,6-2; 6-3,R16,71,7,4,34,53,31,34,7,19,2,2,9,38,53,2,1,22,52,14,22,15,30,2,5,8,29,52
1995-01-09 00:00:00.000,Auckland New Zealand ATP World Tour,HARD,2,Alexander Volkov,Jeremy Bates,Alexander Volkov,6-2; 6-4,R16,65,4,0,21,46,18,21,17,25,1,2,9,35,46,3,1,21,54,17,21,12,33,0,4,9,29,54
1995-01-09 00:00:00.000,Auckland New Zealand ATP World Tour,HARD,2,Vincent Spadea,Jan Siemerink,Vincent Spadea,7-5; 6-2,Q,76,1,3,34,64,25,34,14,30,4,6,10,39,64,3,6,35,67,18,35,15,32,1,6,10,33,67
1995-01-09 00:00:00.000,Auckland New Zealand ATP World Tour,HARD,2,Chuck Adams,Jakob Hlasek,Chuck Adams,7-6(5); 7-6(5),Q,113,6,3,61,95,41,61,17,34,2,5,12,58,95,10,6,49,82,39,49,14,33,5,8,12,53,82
1995-01-09 00:00:00.000,Auckland New Zealand ATP World Tour,HARD,2,Thomas Enqvist,Brett Steven,Thomas Enqvist,7-6(9); 7-5,Q,104,4,6,41,87,31,41,27,46,3,3,12,58,87,7,0,56,79,38,56,15,23,4,5,12,53,79
1995-01-09 00:00:00.000,Auckland New Zealand ATP World Tour,HARD,2,Alexander Volkov,Cedric Pioline,Alexander Volkov,6-4; 6-7(2); 6-1,Q,131,8,3,35,86,28,35,31,51,3,5,15,59,86,8,5,53,88,36,53,17,35,2,7,14,53,88
1995-01-09 00:00:00.000,Auckland New Zealand ATP World Tour,HARD,2,Chuck Adams,Vincent Spadea,Chuck Adams,7-6(9); 2-6; 6-4,S,158,3,4,89,128,59,89,13,39,7,11,15,72,128,4,0,69,117,45,69,25,48,12,15,15,70,117
1995-01-09 00:00:00.000,Auckland New Zealand ATP World Tour,HARD,2,Thomas Enqvist,Alexander Volkov,Thomas Enqvist,7-6(3); 6-2,S,81,8,4,35,67,28,35,17,32,1,2,10,45,67,5,7,35,79,25,35,18,44,5,8,10,43,79
1995-01-09 00:00:00.000,Auckland New Zealand ATP World Tour,HARD,2,Thomas Enqvist,Chuck Adams,Thomas Enqvist,6-2; 6-1,F,59,1,4,23,40,20,23,9,17,0,0,7,29,40,1,1,40,53,19,40,5,13,3,8,8,24,53
1995-01-09 00:00:00.000,Jakarta Indonesia ATP World Tour,HARD,2,Ronald Agenor,Filip Dewulf,Ronald Agenor,7-5; 6-1,R32,69,12,3,39,57,27,39,12,18,1,2,10,39,57,1,7,22,56,14,22,15,34,2,6,9,29,56
1995-01-09 00:00:00.000,Jakarta Indonesia ATP World Tour,HARD,2,Stefano Pescosolido,Lars Jonsson,Stefano Pescosolido,6-0; 7-5,R32,82,8,4,28,58,19,28,16,30,4,6,9,35,58,0,2,33,67,18,33,12,34,8,14,9,30,67
1995-01-09 00:00:00.000,Jakarta Indonesia ATP World Tour,HARD,2,Guillaume Raoux,Leander Paes,Guillaume Raoux,6-2; 6-2,R32,76,3,4,20,59,17,20,24,39,3,3,8,41,59,0,3,31,52,19,31,7,21,6,10,8,26,52
1995-01-09 00:00:00.000,Jakarta Indonesia ATP World Tour,HARD,2,Xavier Daufresne,Andrei Olhovskiy,Xavier Daufresne,6-3; 7-5,R32,81,2,3,49,69,32,49,12,20,3,6,11,44,69,3,3,31,68,20,31,15,37,5,10,10,35,68
1995-01-09 00:00:00.000,Jakarta Indonesia ATP World Tour,HARD,2,Markus Zoecke,Bing Chao Lin,Markus Zoecke,6-1; 6-2,R32,62,5,2,30,50,22,30,13,20,6,6,7,35,50,0,0,38,56,20,38,6,18,3,8,8,26,56
1995-01-09 00:00:00.000,Jakarta Indonesia ATP World Tour,HARD,2,Mark Petchey,Hicham Arazi,Mark Petchey,6-1; 6-3,R32,65,2,4,23,45,21,23,12,22,1,1,8,33,45,0,3,34,65,18,34,16,31,6,10,8,34,65
1995-01-09 00:00:00.000,Jakarta Indonesia ATP World Tour,HARD,2,Gerard Solves,Alexander Mronz,Gerard Solves,6-4; 2-1 RET,R32,50,5,0,21,30,16,21,9,9,0,0,7,25,30,3,6,25,55,18,25,12,30,6,8,7,30,55
1995-01-09 00:00:00.000,Jakarta Indonesia ATP World Tour,HARD,2,Radomir Vasek,Karim Alami,Radomir Vasek,6-1; 6-4,R32,76,4,2,30,47,25,30,12,17,3,3,9,37,47,4,2,33,79,22,33,19,46,11,14,8,41,79
1995-01-09 00:00:00.000,Jakarta Indonesia ATP World Tour,HARD,2,Sander Groen,David Rikl,Sander Groen,1-6; 6-2; 6-0,R32,88,4,8,32,63,25,32,11,31,7,10,10,36,63,0,10,49,92,28,49,16,43,10,16,11,44,92
1995-01-09 00:00:00.000,Jakarta Indonesia ATP World Tour,HARD,2,Kenneth Carlsen,David Adams,Kenneth Carlsen,6-2; 6-3,R32,69,1,2,22,46,19,22,12,24,4,5,8,31,46,1,4,25,55,14,25,11,30,4,9,9,25,55
1995-01-09 00:00:00.000,Jakarta Indonesia ATP World Tour,HARD,2,Nicolas Pereira,Donny Susetyo,Nicolas Pereira,6-1; 6-3,R32,58,3,2,28,48,21,28,11,20,3,4,8,32,48,1,5,30,48,16,30,6,18,4,9,8,22,48
1995-01-09 00:00:00.000,Jakarta Indonesia ATP World Tour,HARD,2,Gilbert Schaller,Shuzo Matsuoka,Gilbert Schaller,4-6; 6-3; 6-4,R32,119,0,0,62,93,45,62,19,31,3,5,15,64,93,8,2,56,88,45,56,14,32,7,10,14,59,88
1995-01-09 00:00:00.000,Jakarta Indonesia ATP World Tour,HARD,2,Rodolphe Gilbert,Jean-Philippe Fleurian,Rodolphe Gilbert,3-6; 7-6(4); 7-6(4),R32,175,3,2,50,113,35,50,30,63,6,11,16,65,113,2,3,63,121,40,63,31,58,6,10,17,71,121
1995-01-09 00:00:00.000,Jakarta Indonesia ATP World Tour,HARD,2,Greg Rusedski,Suwandi Suwandi,Greg Rusedski,7-6(4); 6-2,R32,77,8,1,25,57,24,25,19,32,0,1,10,43,57,1,1,38,68,28,38,11,30,3,6,10,39,68
1995-01-09 00:00:00.000,Jakarta Indonesia ATP World Tour,HARD,2,Martin Sinner,Bonit Wiryawan,Martin Sinner,6-4; 6-1,R32,66,4,1,27,46,20,27,8,19,3,6,9,28,46,2,1,41,62,20,41,7,21,5,11,8,27,62
1995-01-09 00:00:00.000,Jakarta Indonesia ATP World Tour,HARD,2,Paul Haarhuis,Younes El Aynaoui,Paul Haarhuis,6-3; 6-2,R32,63,4,3,34,56,30,34,11,22,1,1,9,41,56,3,2,30,46,22,30,4,16,2,5,8,26,46
1995-01-09 00:00:00.000,Jakarta Indonesia ATP World Tour,HARD,2,Ronald Agenor,Stefano Pescosolido,Ronald Agenor,6-1; 6-3,R16,78,6,2,29,50,21,29,12,21,4,5,8,33,50,2,1,31,70,15,31,18,39,6,11,8,33,70
1995-01-09 00:00:00.000,Jakarta Indonesia ATP World Tour,HARD,2,Guillaume Raoux,Xavier Daufresne,Guillaume Raoux,6-1; 6-4,R16,71,5,2,33,57,27,33,13,24,2,2,9,40,57,2,0,40,59,23,40,9,19,4,7,8,32,59
1995-01-09 00:00:00.000,Jakarta Indonesia ATP World Tour,HARD,2,Mark Petchey,Markus Zoecke,Mark Petchey,7-5; 6-2,R16,76,2,1,43,63,31,43,14,20,5,5,10,45,63,2,3,34,55,23,34,10,21,1,4,10,33,55
1995-01-09 00:00:00.000,Jakarta Indonesia ATP World Tour,HARD,2,Radomir Vasek,Gerard Solves,Radomir Vasek,6-1; 7-6(1),R16,77,1,5,30,61,26,30,15,31,1,2,9,41,61,0,0,35,58,17,35,15,23,4,8,10,32,58
1995-01-09 00:00:00.000,Jakarta Indonesia ATP World Tour,HARD,2,Kenneth Carlsen,Sander Groen,Kenneth Carlsen,W/O,R16,0,0,0,0,0,0,0,0,0,0,0,0,0,0,0,0,0,0,0,0,0,0,0,0,0,0,0
1995-01-09 00:00:00.000,Jakarta Indonesia ATP World Tour,HARD,2,Gilbert Schaller,Nicolas Pereira,Gilbert Schaller,7-6(3); 3-6; 6-3,R16,125,2,0,65,94,41,65,21,29,3,5,15,62,94,13,4,58,96,43,58,16,38,2,4,15,59,96
1995-01-09 00:00:00.000,Jakarta Indonesia ATP World Tour,HARD,2,Greg Rusedski,Rodolphe Gilbert,Greg Rusedski,6-3; 4-6; 6-4,R16,118,15,6,45,85,37,45,25,40,2,3,15,62,85,2,0,66,103,44,66,21,37,8,10,14,65,103
1995-01-09 00:00:00.000,Jakarta Indonesia ATP World Tour,HARD,2,Paul Haarhuis,Martin Sinner,Paul Haarhuis,6-4; 6-4,R16,81,4,1,41,68,28,41,19,27,5,5,10,47,68,6,4,37,65,23,37,18,28,3,5,10,41,65
1995-01-09 00:00:00.000,Jakarta Indonesia ATP World Tour,HARD,2,Ronald Agenor,Guillaume Raoux,Ronald Agenor,6-4; 6-4,Q,76,5,3,40,56,30,40,11,16,1,2,10,41,56,3,1,33,58,22,33,14,25,2,5,10,36,58
1995-01-09 00:00:00.000,Jakarta Indonesia ATP World Tour,HARD,2,Radomir Vasek,Mark Petchey,Radomir Vasek,6-3; 4-6; 6-4,Q,116,2,6,85,111,54,85,14,26,6,9,15,68,111,5,2,56,83,35,56,13,27,3,7,14,48,83
1995-01-09 00:00:00.000,Jakarta Indonesia ATP World Tour,HARD,2,Kenneth Carlsen,Gilbert Schaller,Kenneth Carlsen,6-4; 7-6(1),Q,103,8,2,37,76,32,37,22,39,4,4,11,54,76,0,2,55,75,36,55,11,20,5,6,11,47,75
1995-01-09 00:00:00.000,Jakarta Indonesia ATP World Tour,HARD,2,Paul Haarhuis,Greg Rusedski,Paul Haarhuis,5-7; 6-3; 6-1,Q,111,9,2,55,91,38,55,21,36,8,10,14,59,91,6,9,47,89,35,47,16,42,6,11,14,51,89
1995-01-09 00:00:00.000,Jakarta Indonesia ATP World Tour,HARD,2,Radomir Vasek,Ronald Agenor,Radomir Vasek,2-6; 6-4; 6-2,S,109,4,8,53,83,36,53,12,30,4,8,13,48,83,10,1,49,88,32,49,17,39,7,12,13,49,88
1995-01-09 00:00:00.000,Jakarta Indonesia ATP World Tour,HARD,2,Paul Haarhuis,Kenneth Carlsen,Paul Haarhuis,3-6; 6-3; 6-3,S,117,2,2,47,77,33,47,21,30,5,6,13,54,77,10,6,61,99,43,61,16,38,9,12,14,59,99
1995-01-09 00:00:00.000,Jakarta Indonesia ATP World Tour,HARD,2,Paul Haarhuis,Radomir Vasek,Paul Haarhuis,7-5; 7-5,F,99,5,0,36,65,24,36,16,29,1,4,12,40,65,3,5,57,88,31,57,16,31,7,12,12,47,88
1995-01-09 00:00:00.000,Sydney Outdoor Australia ATP World Tour,HARD,2,Richard Fromberg,Marc Rosset,Richard Fromberg,6-4; 6-4,R32,81,8,5,37,69,28,37,18,32,6,6,10,46,69,3,3,29,59,24,29,15,30,2,4,10,39,59
1995-01-09 00:00:00.000,Sydney Outdoor Australia ATP World Tour,HARD,2,Aaron Krickstein,Nicklas Kulti,Aaron Krickstein,4-6; 6-2; 6-3,R32,91,6,1,48,84,38,48,19,36,4,6,14,57,84,16,3,48,78,37,48,9,30,6,10,13,46,78
1995-01-09 00:00:00.000,Sydney Outdoor Australia ATP World Tour,HARD,2,Mark Woodforde,Daniel Vacek,Mark Woodforde,6-2; 6-2,R32,68,5,5,18,45,17,18,17,27,2,3,8,34,45,0,4,37,62,21,37,9,25,5,10,8,30,62
1995-01-09 00:00:00.000,Sydney Outdoor Australia ATP World Tour,HARD,2,Karel Novacek,Louis Gloria,Karel Novacek,6-7(5); 6-4; 7-6(5),R32,152,6,3,54,106,41,54,28,52,2,6,17,69,106,0,6,103,142,67,103,14,39,10,15,17,81,142
1995-01-09 00:00:00.000,Sydney Outdoor Australia ATP World Tour,HARD,2,Jamie Morgan,Thomas Muster,Jamie Morgan,6-2; 6-4,R32,58,10,2,24,46,19,24,14,22,0,1,9,33,46,2,4,31,54,19,31,10,23,6,10,9,29,54
1995-01-09 00:00:00.000,Sydney Outdoor Australia ATP World Tour,HARD,2,Todd Woodbridge,Joern Renzenbrink,Todd Woodbridge,6-3; 6-2,R32,63,4,2,35,54,28,35,9,19,5,6,9,37,54,4,8,36,59,23,36,9,23,8,12,8,32,59
1995-01-09 00:00:00.000,Sydney Outdoor Australia ATP World Tour,HARD,2,Jaime Yzaga,Lars Burgsmuller,Jaime Yzaga,5-7; 7-5; 6-3,R32,127,0,6,60,97,37,60,17,37,3,10,16,54,97,7,4,77,121,41,77,19,44,11,20,17,60,121
1995-01-09 00:00:00.000,Sydney Outdoor Australia ATP World Tour,HARD,2,Renzo Furlan,Petr Korda,Renzo Furlan,2-6; 6-3; 6-2,R32,95,2,0,26,63,17,26,25,37,0,3,12,42,63,4,13,46,84,33,46,14,38,6,11,13,47,84
1995-01-09 00:00:00.000,Sydney Outdoor Australia ATP World Tour,HARD,2,Arnaud Boetsch,Jacco Eltingh,Arnaud Boetsch,6-2; 5-7; 7-6(1),R32,125,12,5,55,97,45,55,22,42,5,8,16,67,97,8,12,57,108,38,57,26,51,10,14,16,64,108
1995-01-09 00:00:00.000,Sydney Outdoor Australia ATP World Tour,HARD,2,Patrick McEnroe,Karsten Braasch,Patrick McEnroe,6-7(5); 7-6(7); 6-2,R32,152,0,1,77,117,52,77,27,40,9,10,16,79,117,9,1,46,101,34,46,33,55,5,8,16,67,101
1995-01-09 00:00:00.000,Sydney Outdoor Australia ATP World Tour,HARD,2,Olivier Delaitre,Karol Kucera,Olivier Delaitre,7-6(4); 6-3,R32,78,3,1,42,70,32,42,19,28,2,3,11,51,70,7,3,37,72,26,37,17,35,5,7,10,43,72
1995-01-09 00:00:00.000,Sydney Outdoor Australia ATP World Tour,HARD,2,Richard Krajicek,Horst Skoff,Richard Krajicek,6-3; 6-1,R32,56,6,1,28,44,23,28,10,16,0,0,8,33,44,1,3,29,58,18,29,10,29,3,7,8,28,58
1995-01-09 00:00:00.000,Sydney Outdoor Australia ATP World Tour,HARD,2,Andrea Gaudenzi,David Wheaton,Andrea Gaudenzi,6-3; 6-2,R32,71,1,1,38,53,29,38,11,15,4,4,9,40,53,9,2,44,70,30,44,9,26,5,8,8,39,70
1995-01-09 00:00:00.000,Sydney Outdoor Australia ATP World Tour,HARD,2,Lionel Roux,Ignacio Martinez,Lionel Roux,7-6(3); 6-4,R32,93,1,3,34,75,24,34,24,41,1,3,11,48,75,0,1,29,61,18,29,20,32,0,3,11,38,61
1995-01-09 00:00:00.000,Sydney Outdoor Australia ATP World Tour,HARD,2,Michael Tebbutt,Jared Palmer,Michael Tebbutt,7-6(3); 6-7(4); 7-5,R32,150,21,10,75,130,63,75,25,55,9,10,18,88,130,6,8,71,123,52,71,33,52,9,11,18,85,123
1995-01-09 00:00:00.000,Sydney Outdoor Australia ATP World Tour,HARD,2,Andrei Medvedev,Richey Reneberg,Andrei Medvedev,6-4; 6-3,R32,60,5,1,30,47,26,30,12,17,1,1,9,38,47,4,3,30,67,20,30,19,37,7,10,10,39,67
1995-01-09 00:00:00.000,Sydney Outdoor Australia ATP World Tour,HARD,2,Richard Fromberg,Aaron Krickstein,Richard Fromberg,6-3; 6-3,R16,72,11,1,30,52,23,30,11,22,2,3,9,34,52,1,2,39,63,23,39,10,24,5,9,9,33,63
1995-01-09 00:00:00.000,Sydney Outdoor Australia ATP World Tour,HARD,2,Mark Woodforde,Karel Novacek,Mark Woodforde,6-3; 6-4,R16,74,1,0,33,56,24,33,15,23,1,2,10,39,56,4,4,41,67,27,41,11,26,8,11,9,38,67
1995-01-09 00:00:00.000,Sydney Outdoor Australia ATP World Tour,HARD,2,Jamie Morgan,Todd Woodbridge,Jamie Morgan,4-6; 6-4; 7-5,R16,147,6,8,47,104,33,47,29,57,1,5,16,62,104,5,9,64,116,43,64,22,52,15,20,16,65,116
1995-01-09 00:00:00.000,Sydney Outdoor Australia ATP World Tour,HARD,2,Renzo Furlan,Jaime Yzaga,Renzo Furlan,7-5; 5-7; 7-5,R16,147,6,3,72,114,49,72,23,42,5,9,18,72,114,2,3,71,121,43,71,30,50,6,11,18,73,121
1995-01-09 00:00:00.000,Sydney Outdoor Australia ATP World Tour,HARD,2,Patrick McEnroe,Arnaud Boetsch,Patrick McEnroe,7-6(5); 3-6; 6-2,R16,126,2,4,69,93,49,69,13,24,11,13,14,62,93,5,5,59,97,47,59,14,38,10,13,15,61,97
1995-01-09 00:00:00.000,Sydney Outdoor Australia ATP World Tour,HARD,2,Richard Krajicek,Olivier Delaitre,Richard Krajicek,6-3; 7-6(4),R16,77,8,2,38,71,27,38,21,33,3,5,11,48,71,1,1,45,65,29,45,11,20,3,6,10,40,65
1995-01-09 00:00:00.000,Sydney Outdoor Australia ATP World Tour,HARD,2,Andrea Gaudenzi,Lionel Roux,Andrea Gaudenzi,6-0; 6-4,R16,80,2,2,30,48,23,30,12,18,2,2,8,35,48,3,5,39,77,22,39,19,38,12,16,8,41,77
1995-01-09 00:00:00.000,Sydney Outdoor Australia ATP World Tour,HARD,2,Michael Tebbutt,Andrei Medvedev,Michael Tebbutt,5-7; 6-1; 6-2,R16,100,12,6,56,104,44,56,22,48,11,12,14,66,104,5,6,45,82,33,45,17,37,4,8,13,50,82
1995-01-09 00:00:00.000,Sydney Outdoor Australia ATP World Tour,HARD,2,Richard Fromberg,Mark Woodforde,Richard Fromberg,7-6(6); 6-3,Q,94,8,2,42,77,30,42,26,35,6,6,11,56,77,2,3,34,63,29,34,15,29,0,1,10,44,63
1995-01-09 00:00:00.000,Sydney Outdoor Australia ATP World Tour,HARD,2,Renzo Furlan,Jamie Morgan,Renzo Furlan,6-4; 7-6(5),Q,96,7,2,38,74,32,38,16,36,2,3,11,48,74,4,5,45,75,32,45,14,30,4,6,11,46,75
1995-01-09 00:00:00.000,Sydney Outdoor Australia ATP World Tour,HARD,2,Patrick McEnroe,Richard Krajicek,Patrick McEnroe,7-5; 6-1,Q,65,3,1,40,61,29,40,14,21,5,6,10,43,61,8,1,39,55,22,39,8,16,4,8,9,30,55
1995-01-09 00:00:00.000,Sydney Outdoor Australia ATP World Tour,HARD,2,Andrea Gaudenzi,Michael Tebbutt,Andrea Gaudenzi,6-4; 6-4,Q,66,1,3,46,64,34,46,10,18,2,2,10,44,64,9,1,36,53,28,36,9,17,4,6,10,37,53
1995-01-09 00:00:00.000,Sydney Outdoor Australia ATP World Tour,HARD,2,Richard Fromberg,Renzo Furlan,Richard Fromberg,6-4; 6-3,S,85,3,3,36,61,22,36,14,25,9,11,9,36,61,2,2,31,62,21,31,13,31,5,10,10,34,62
1995-01-09 00:00:00.000,Sydney Outdoor Australia ATP World Tour,HARD,2,Patrick McEnroe,Andrea Gaudenzi,Patrick McEnroe,6-3; 6-4,S,82,4,1,43,78,29,43,16,35,2,5,10,45,78,2,2,30,46,17,30,5,16,2,7,9,22,46
1995-01-09 00:00:00.000,Sydney Outdoor Australia ATP World Tour,HARD,2,Patrick McEnroe,Richard Fromberg,Patrick McEnroe,6-2; 7-6(4),F,102,0,1,46,66,34,46,12,20,2,3,10,46,66,8,2,39,74,27,39,14,35,7,10,10,41,74
1995-01-16 00:00:00.000,Australian Open Australia Grand Slams,HARD,3,Pete Sampras,Gianluca Pozzi,Pete Sampras,6-3; 6-2; 6-0,R128,73,7,1,46,66,41,46,13,20,1,2,12,54,66,0,0,52,66,23,52,7,14,4,11,11,30,66
1995-01-16 00:00:00.000,Australian Open Australia Grand Slams,HARD,3,Jan Kroslak,Jared Palmer,Jan Kroslak,6-2; 6-2; 6-7(9); 4-6; 6-0,R128,150,19,10,98,167,81,98,35,69,5,6,22,116,167,4,6,85,141,61,85,25,56,5,12,22,86,141
1995-01-16 00:00:00.000,Australian Open Australia Grand Slams,HARD,3,Richard Fromberg,Rodolphe Gilbert,Richard Fromberg,6-4; 6-2; 6-0,R128,89,12,2,54,75,49,54,12,21,0,0,12,61,75,2,5,41,87,28,41,13,46,7,13,12,41,87
1995-01-16 00:00:00.000,Australian Open Australia Grand Slams,HARD,3,Lars Jonsson,Jaime Yzaga,Lars Jonsson,6-2; 4-6; 6-4; 7-6(3),R128,159,11,1,100,156,78,100,30,56,11,13,20,108,156,5,2,64,125,45,64,37,61,5,9,20,82,125
1995-01-16 00:00:00.000,Australian Open Australia Grand Slams,HARD,3,Thomas Enqvist,Paul Haarhuis,Thomas Enqvist,6-2; 6-1; 6-1,R128,80,5,5,44,72,35,44,16,28,2,2,11,51,72,4,3,54,93,30,54,13,39,9,16,11,43,93
1995-01-16 00:00:00.000,Australian Open Australia Grand Slams,HARD,3,Daniel Nestor,Alexander Mronz,Daniel Nestor,3-6; 6-3; 6-2; 7-6(0),R128,143,17,15,92,169,72,92,36,77,9,10,19,108,169,13,2,76,124,63,76,25,48,5,8,19,88,124
1995-01-16 00:00:00.000,Australian Open Australia Grand Slams,HARD,3,Nicolas Pereira,Scott Draper,Nicolas Pereira,6-2; 7-6(4); 6-7(8); 6-4,R128,166,10,4,103,143,89,103,21,40,2,2,21,110,143,10,5,119,181,88,119,30,62,19,22,21,118,181
1995-01-16 00:00:00.000,Australian Open Australia Grand Slams,HARD,3,Magnus Larsson,Brian MacPhie,Magnus Larsson,7-6(6); 7-6(1); 6-4,R128,127,7,4,83,127,59,83,24,44,7,10,17,83,127,4,3,67,120,46,67,29,53,6,10,17,75,120
1995-01-16 00:00:00.000,Australian Open Australia Grand Slams,HARD,3,Jim Courier,David Rikl,Jim Courier,6-4; 6-0; 7-6(2),R128,97,2,1,64,84,51,64,12,20,1,1,14,63,84,6,2,70,109,48,70,14,39,9,13,14,62,109
1995-01-16 00:00:00.000,Australian Open Australia Grand Slams,HARD,3,Cristiano Caratti,Lionel Roux,Cristiano Caratti,6-3; 6-1; 6-1,R128,81,2,4,55,71,42,55,4,16,3,4,11,46,71,3,4,55,77,26,55,6,22,3,11,12,32,77
1995-01-16 00:00:00.000,Australian Open Australia Grand Slams,HARD,3,Mark Woodforde,Arnaud Boetsch,Mark Woodforde,6-4; 7-5; 6-3,R128,128,6,7,63,110,50,63,19,47,4,7,16,69,110,6,8,74,128,52,74,16,54,9,15,15,68,128
1995-01-16 00:00:00.000,Australian Open Australia Grand Slams,HARD,3,Brett Steven,Horst Skoff,Brett Steven,7-6(1); 4-6; 6-2; 6-3,R128,151,14,3,95,135,75,95,24,40,5,7,19,99,135,4,11,93,144,61,93,15,51,2,7,20,76,144
1995-01-16 00:00:00.000,Australian Open Australia Grand Slams,HARD,3,Karel Novacek,Bryan Shelton,Karel Novacek,6-3; 6-3; 7-6(6),R128,113,8,3,71,111,54,71,22,40,5,6,15,76,111,7,2,61,101,46,61,17,40,0,4,15,63,101
1995-01-16 00:00:00.000,Australian Open Australia Grand Slams,HARD,3,Radomir Vasek,Mark Petchey,Radomir Vasek,3-6; 6-3; 6-1; 6-3,R128,132,5,9,74,120,57,74,15,46,9,14,17,72,120,5,8,70,122,44,70,14,52,7,16,17,58,122
1995-01-16 00:00:00.000,Australian Open Australia Grand Slams,HARD,3,Alex O'Brien,Pat Cash,Alex O'Brien,4-6; 6-4; 6-4; 6-2,R128,135,8,1,81,119,62,81,20,38,4,6,19,82,119,13,5,81,128,59,81,22,47,5,10,19,81,128
1995-01-16 00:00:00.000,Australian Open Australia Grand Slams,HARD,3,Michael Stich,Jeff Tarango,Michael Stich,6-3; 6-1; 6-3,R128,89,14,0,55,88,48,55,21,33,0,0,13,69,88,3,6,69,103,40,69,13,34,5,10,12,53,103
1995-01-16 00:00:00.000,Australian Open Australia Grand Slams,HARD,3,Carl-Uwe Steeb,Goran Ivanisevic,Carl-Uwe Steeb,6-1; 7-6(4); 6-3,R128,94,7,1,72,95,53,72,13,23,3,3,13,66,95,10,4,62,105,39,62,22,43,7,12,15,61,105
1995-01-16 00:00:00.000,Australian Open Australia Grand Slams,HARD,3,Renzo Furlan,Ronald Agenor,Renzo Furlan,7-6(0); 6-2; 4-6; 7-5,R128,163,9,1,86,155,63,86,38,69,14,18,21,101,155,4,1,86,131,53,86,25,45,7,13,21,78,131
1995-01-16 00:00:00.000,Australian Open Australia Grand Slams,HARD,3,Jan Siemerink,MaliVai Washington,Jan Siemerink,6-4; 7-5; 6-2,R128,112,4,6,54,98,42,54,23,44,5,6,15,65,98,4,3,62,108,43,62,19,46,4,9,15,62,108
1995-01-16 00:00:00.000,Australian Open Australia Grand Slams,HARD,3,David Wheaton,Joern Renzenbrink,David Wheaton,6-3; 7-5; 7-6(6),R128,125,10,1,97,123,70,97,17,26,5,7,17,87,123,13,7,92,132,69,92,11,40,6,10,16,80,132
1995-01-16 00:00:00.000,Australian Open Australia Grand Slams,HARD,3,Michael Tebbutt,Jamie Morgan,Michael Tebbutt,6-7(0); 7-5; 6-3; 3-6; 7-5,R128,213,27,8,124,216,95,124,48,92,13,16,27,143,216,5,12,96,183,71,96,40,87,7,12,27,111,183
1995-01-16 00:00:00.000,Australian Open Australia Grand Slams,HARD,3,Stefano Pescosolido,Andrew Ilie,Stefano Pescosolido,7-6(3); 6-2; 6-1,R128,99,9,5,56,95,50,56,18,39,1,2,14,68,95,4,1,52,98,31,52,23,46,6,11,13,54,98
1995-01-16 00:00:00.000,Australian Open Australia Grand Slams,HARD,3,Lars Rehmann,Luiz Mattar,Lars Rehmann,6-3; 6-4; 6-1,R128,91,4,7,49,79,44,49,12,30,0,0,13,56,79,3,2,56,87,29,56,19,31,10,15,13,48,87
1995-01-16 00:00:00.000,Australian Open Australia Grand Slams,HARD,3,Andrei Medvedev,Leander Paes,Andrei Medvedev,6-1; 7-5; 7-6(4),R128,112,5,2,60,98,45,60,17,38,5,8,15,62,98,2,7,59,102,36,59,15,43,4,11,16,51,102
1995-01-16 00:00:00.000,Australian Open Australia Grand Slams,HARD,3,Andrea Gaudenzi,Marc Rosset,Andrea Gaudenzi,6-7(4); 6-4; 6-3; 6-4,R128,165,2,2,118,140,80,118,7,22,8,12,20,87,140,9,10,100,161,69,100,18,61,14,22,21,87,161
1995-01-16 00:00:00.000,Australian Open Australia Grand Slams,HARD,3,Andrei Olhovskiy,Markus Zoecke,Andrei Olhovskiy,6-4; 6-4; 6-4,R128,89,16,2,66,95,58,66,21,29,2,2,15,79,95,7,0,60,94,44,60,19,34,5,8,15,63,94
1995-01-16 00:00:00.000,Australian Open Australia Grand Slams,HARD,3,Jan Apell,Cedric Pioline,Jan Apell,7-6(7); 6-1; 6-3,R128,106,6,2,68,101,52,68,18,33,3,4,14,70,101,9,5,58,97,42,58,15,39,3,8,14,57,97
1995-01-16 00:00:00.000,Australian Open Australia Grand Slams,HARD,3,Olivier Delaitre,Ashley Naumann,Olivier Delaitre,3-6; 6-3; 6-4; 6-3,R128,141,4,3,72,102,52,72,14,30,1,5,18,66,102,5,2,97,143,62,97,17,46,9,16,19,79,143
1995-01-16 00:00:00.000,Australian Open Australia Grand Slams,HARD,3,Martin Damm,Daniel Vacek,Martin Damm,5-7; 6-4; 6-4; 6-4,R128,165,9,4,72,124,59,72,30,52,2,4,21,89,124,12,6,88,148,70,88,27,60,5,9,21,97,148
1995-01-16 00:00:00.000,Australian Open Australia Grand Slams,HARD,3,Tommy Ho,Kenny Thorne,Tommy Ho,3-6; 6-1; 6-2; 6-4,R128,114,4,3,74,107,57,74,15,33,8,10,17,72,107,5,0,84,121,51,84,16,37,12,18,17,67,121
1995-01-16 00:00:00.000,Australian Open Australia Grand Slams,HARD,3,Karim Alami,Brad Gilbert,Karim Alami,6-4; 6-4; 2-6; 6-1,R128,129,8,1,70,110,52,70,23,40,6,9,17,75,110,2,4,71,126,46,71,26,55,7,13,18,72,126
1995-01-16 00:00:00.000,Australian Open Australia Grand Slams,HARD,3,Michael Chang,Paul Kilderry,Michael Chang,6-2; 6-4; 5-7; 6-2,R128,156,3,4,81,126,57,81,14,45,7,13,19,71,126,1,6,84,136,49,84,13,52,7,17,19,62,136
1995-01-16 00:00:00.000,Australian Open Australia Grand Slams,HARD,3,Stefan Edberg,Mark Philippoussis,Stefan Edberg,4-6; 6-3; 7-6(1); 7-5,R128,149,5,4,79,133,60,79,37,54,8,10,22,97,133,10,6,90,140,67,90,24,50,4,7,21,91,140
1995-01-16 00:00:00.000,Australian Open Australia Grand Slams,HARD,3,Adrian Voinea,Filip Dewulf,Adrian Voinea,6-2; 5-7; 7-5; 6-2,R128,125,12,2,69,128,54,69,37,59,4,7,20,91,128,5,8,70,133,49,70,25,63,4,11,20,74,133
1995-01-16 00:00:00.000,Australian Open Australia Grand Slams,HARD,3,Hendrik Dreekmann,Javier Sanchez,Hendrik Dreekmann,6-3; 6-2; 6-4,R128,92,8,7,45,96,42,45,23,51,6,7,14,65,96,3,5,45,85,29,45,17,40,1,6,13,46,85
1995-01-16 00:00:00.000,Australian Open Australia Grand Slams,HARD,3,Fabrice Santoro,Ben Ellwood,Fabrice Santoro,2-6; 6-2; 2-6; 7-6(7); 6-4,R128,195,3,6,105,162,66,105,26,57,11,18,23,92,162,7,13,95,180,64,95,36,85,7,13,23,100,180
1995-01-16 00:00:00.000,Australian Open Australia Grand Slams,HARD,3,Lars Burgsmuller,Younes El Aynaoui,Lars Burgsmuller,6-3; 6-7(8); 6-1; 7-6(3),R128,163,6,11,103,162,72,103,27,59,6,9,21,99,162,5,6,97,159,61,97,25,62,9,15,19,86,159
1995-01-16 00:00:00.000,Australian Open Australia Grand Slams,HARD,3,Petr Korda,Guillaume Raoux,Petr Korda,2-6; 7-6(5); 6-4; 6-3,R128,146,7,11,92,144,72,92,14,52,10,15,20,86,144,4,3,84,129,59,84,20,45,6,11,19,79,129
1995-01-16 00:00:00.000,Australian Open Australia Grand Slams,HARD,3,Aaron Krickstein,Marc-Kevin Goellner,Aaron Krickstein,6-3; 6-1; 5-7; 6-1,R128,112,11,1,74,122,63,74,26,48,7,8,18,89,122,19,10,63,131,50,63,26,68,1,7,17,76,131
1995-01-16 00:00:00.000,Australian Open Australia Grand Slams,HARD,3,Wayne Ferreira,Karsten Braasch,Wayne Ferreira,6-3; 6-7(10); 6-4; 7-6(2),R128,160,8,2,110,158,83,110,28,48,5,7,22,111,158,8,3,92,151,68,92,29,59,3,7,21,97,151
1995-01-16 00:00:00.000,Australian Open Australia Grand Slams,HARD,3,Thomas Muster,Richey Reneberg,Thomas Muster,2-6; 6-2; 7-6(4); 4-6; 6-3,R128,180,15,3,130,179,91,130,26,49,11,16,24,117,179,14,5,91,173,64,91,46,82,6,11,23,110,173
1995-01-16 00:00:00.000,Australian Open Australia Grand Slams,HARD,3,Thierry Guardiola,Jason Stoltenberg,Thierry Guardiola,6-4; 6-2; 6-2,R128,104,8,1,72,119,52,72,23,47,12,13,13,75,119,0,8,52,79,33,52,3,27,2,8,13,36,79
1995-01-16 00:00:00.000,Australian Open Australia Grand Slams,HARD,3,Jacco Eltingh,Mats Wilander,Jacco Eltingh,6-3; 7-6(4); 6-4,R128,125,9,9,70,120,57,70,17,50,4,7,16,74,120,6,3,64,104,42,64,20,40,6,11,15,62,104
1995-01-16 00:00:00.000,Australian Open Australia Grand Slams,HARD,3,Sebastien Lareau,Steve Bryan,Sebastien Lareau,6-1; 3-6; 6-4; 7-6(6),R128,153,15,6,91,156,71,91,29,65,9,13,19,100,156,2,4,80,129,51,80,22,49,4,10,19,73,129
1995-01-16 00:00:00.000,Australian Open Australia Grand Slams,HARD,3,Wally Masur,Todd Woodbridge,Wally Masur,7-6(4); 7-6(5); 6-4,R128,133,6,0,76,110,55,76,26,34,0,1,17,81,110,5,5,74,131,50,74,33,57,5,7,17,83,131
1995-01-16 00:00:00.000,Australian Open Australia Grand Slams,HARD,3,David Prinosil,Byron Black,David Prinosil,3-6; 6-4; 6-4; 6-2,R128,133,13,9,76,144,57,76,31,68,5,8,19,88,144,5,5,76,125,49,76,26,49,5,10,18,75,125
1995-01-16 00:00:00.000,Australian Open Australia Grand Slams,HARD,3,Jeremy Bates,Henrik Holm,Jeremy Bates,6-4; 6-7(5); 3-6; 7-6(5); 6-3,R128,186,1,7,104,181,73,104,28,77,13,22,27,101,181,16,16,108,194,87,108,22,86,15,24,25,109,194
1995-01-16 00:00:00.000,Australian Open Australia Grand Slams,HARD,3,Patrick McEnroe,Boris Becker,Patrick McEnroe,6-3; 6-4; 7-6(4),R128,131,2,1,76,105,59,76,16,29,5,6,16,75,105,14,3,73,120,55,73,25,47,7,10,15,80,120
1995-01-16 00:00:00.000,Australian Open Australia Grand Slams,HARD,3,Todd Martin,Oliver Gross,Todd Martin,6-3; 6-4; 6-4,R128,97,3,2,49,91,40,49,27,42,5,6,15,67,91,2,5,50,90,34,50,17,40,3,7,14,51,90
1995-01-16 00:00:00.000,Australian Open Australia Grand Slams,HARD,3,Jean-Philippe Fleurian,Karol Kucera,Jean-Philippe Fleurian,3-6; 6-3; 5-7; 7-6(0); 6-2,R128,197,4,1,110,167,78,110,31,57,10,15,25,109,167,12,8,91,174,66,91,40,83,8,14,25,106,174
1995-01-16 00:00:00.000,Australian Open Australia Grand Slams,HARD,3,Vincent Spadea,Bernd Karbacher,Vincent Spadea,6-4; 6-0 RET,R128,52,0,0,31,45,22,31,9,14,2,3,9,31,45,0,1,30,47,19,30,2,17,3,8,8,21,47
1995-01-16 00:00:00.000,Australian Open Australia Grand Slams,HARD,3,Wayne Black,Grant Doyle,Wayne Black,7-6(6); 4-6; 6-1; 1-6; 7-5,R128,242,1,5,116,193,68,116,36,77,13,23,24,104,193,4,4,104,172,62,104,31,68,10,20,24,93,172
1995-01-16 00:00:00.000,Australian Open Australia Grand Slams,HARD,3,Guy Forget,Gilbert Schaller,Guy Forget,6-3; 7-6(5); 6-3,R128,117,15,1,86,108,71,86,12,22,3,4,16,83,108,5,3,86,109,55,86,10,23,5,8,14,65,109
1995-01-16 00:00:00.000,Australian Open Australia Grand Slams,HARD,3,Jonas Bjorkman,Christian Ruud,Jonas Bjorkman,6-3; 6-3; 6-2,R128,103,5,6,63,96,47,63,11,33,7,9,13,58,96,1,3,56,106,30,56,21,50,13,20,13,51,106
1995-01-16 00:00:00.000,Australian Open Australia Grand Slams,HARD,3,Kenneth Carlsen,Shuzo Matsuoka,Kenneth Carlsen,6-3; 7-6(8); 2-6; 6-7(3); 6-1,R128,224,13,9,94,192,76,94,51,98,7,9,24,127,192,8,3,108,165,83,108,26,57,6,10,24,109,165
1995-01-16 00:00:00.000,Australian Open Australia Grand Slams,HARD,3,Yevgeny Kafelnikov,Brent Larkham,Yevgeny Kafelnikov,6-3; 6-0; 6-1,R128,78,0,5,45,67,35,45,9,22,0,1,11,44,67,1,2,53,94,28,53,12,41,9,17,11,40,94
1995-01-16 00:00:00.000,Australian Open Australia Grand Slams,HARD,3,Richard Krajicek,Clinton Marsh,Richard Krajicek,6-1; 6-1; 6-1,R128,75,8,3,45,71,39,45,14,26,1,1,11,53,71,0,6,52,79,25,52,6,27,13,20,10,31,79
1995-01-16 00:00:00.000,Australian Open Australia Grand Slams,HARD,3,Marcos Ondruska,Sandon Stolle,Marcos Ondruska,2-6; 6-2; 6-7(5); 6-1; 6-2,R128,172,7,13,82,172,55,82,39,90,11,17,22,94,172,6,13,86,156,63,86,15,70,5,15,21,78,156
1995-01-16 00:00:00.000,Australian Open Australia Grand Slams,HARD,3,Patrick Rafter,Jakob Hlasek,Patrick Rafter,6-3; 1-6; 5-7; 7-6(5); 6-3,R128,187,11,7,86,164,69,86,38,78,8,14,24,107,164,13,3,105,172,76,105,37,67,9,15,25,113,172
1995-01-16 00:00:00.000,Australian Open Australia Grand Slams,HARD,3,Steve Campbell,Chuck Adams,Steve Campbell,6-2; 7-6(6) RET,R128,86,8,0,55,86,36,55,19,31,3,5,11,55,86,1,2,60,88,34,60,12,28,5,9,10,46,88
1995-01-16 00:00:00.000,Australian Open Australia Grand Slams,HARD,3,Greg Rusedski,Alexander Volkov,Greg Rusedski,6-4; 6-2; 6-3,R128,93,12,2,60,109,47,60,25,49,3,5,13,72,109,2,9,41,94,27,41,17,53,6,13,14,44,94
1995-01-16 00:00:00.000,Australian Open Australia Grand Slams,HARD,3,Nicklas Kulti,Jonathan Stark,Nicklas Kulti,6-4; 6-7(12); 6-3; 6-3,R128,158,17,4,100,153,84,100,29,53,7,7,20,113,153,14,8,94,157,69,94,34,63,5,9,20,103,157
1995-01-16 00:00:00.000,Australian Open Australia Grand Slams,HARD,3,Jerome Golmard,Luke Jensen,Jerome Golmard,6-2; 6-1; 6-3,R128,88,3,1,39,59,36,39,15,20,0,0,12,51,59,4,3,72,107,44,72,12,35,17,23,12,56,107
1995-01-16 00:00:00.000,Australian Open Australia Grand Slams,HARD,3,Andre Agassi,Grant Stafford,Andre Agassi,6-2; 6-4; 6-2,R128,90,6,0,62,78,47,62,8,16,3,5,13,55,78,3,1,59,85,33,59,9,26,5,12,13,42,85
1995-01-16 00:00:00.000,Australian Open Australia Grand Slams,HARD,3,Pete Sampras,Jan Kroslak,Pete Sampras,6-2; 6-0; 6-1,R64,76,10,0,53,76,43,53,15,23,5,5,11,58,76,3,5,32,70,18,32,12,38,8,15,10,30,70
1995-01-16 00:00:00.000,Australian Open Australia Grand Slams,HARD,3,Lars Jonsson,Richard Fromberg,Lars Jonsson,7-6; 7-6(4); 3-6; 6-2,R64,202,4,2,103,160,69,103,30,57,17,20,20,99,160,27,7,113,190,87,113,33,77,12,17,21,120,190
1995-01-16 00:00:00.000,Australian Open Australia Grand Slams,HARD,3,Thomas Enqvist,Daniel Nestor,Thomas Enqvist,6-4; 6-4; 7-5,R64,96,10,0,59,82,54,59,17,23,0,1,16,71,82,18,11,83,132,66,83,16,49,7,11,16,82,132
1995-01-16 00:00:00.000,Australian Open Australia Grand Slams,HARD,3,Magnus Larsson,Nicolas Pereira,Magnus Larsson,7-6(4); 6-4; 6-3,R64,103,8,1,58,90,51,58,24,32,3,3,15,75,90,10,2,83,119,64,83,13,36,5,8,16,77,119
1995-01-16 00:00:00.000,Australian Open Australia Grand Slams,HARD,3,Jim Courier,Cristiano Caratti,Jim Courier,6-2; 6-2; 6-1,R64,80,4,3,50,77,40,50,13,27,2,3,12,53,77,3,6,50,82,27,50,7,32,6,13,11,34,82
1995-01-16 00:00:00.000,Australian Open Australia Grand Slams,HARD,3,Mark Woodforde,Brett Steven,Mark Woodforde,1-6; 6-3; 7-5; 6-3,R64,151,5,8,76,131,55,76,25,55,8,12,18,80,131,5,9,81,137,51,81,25,56,7,13,19,76,137
1995-01-16 00:00:00.000,Australian Open Australia Grand Slams,HARD,3,Karel Novacek,Radomir Vasek,Karel Novacek,6-3; 6-3; 6-4,R64,98,12,2,64,96,53,64,17,32,2,3,14,70,96,2,4,58,96,34,58,20,38,6,11,14,54,96
1995-01-16 00:00:00.000,Australian Open Australia Grand Slams,HARD,3,Michael Stich,Alex O'Brien,Michael Stich,6-0; 6-3; 6-4,R64,98,10,2,53,90,45,53,19,37,3,4,13,64,90,2,4,64,95,37,64,9,31,7,13,12,46,95
1995-01-16 00:00:00.000,Australian Open Australia Grand Slams,HARD,3,Renzo Furlan,Carl-Uwe Steeb,Renzo Furlan,7-5; 6-3; 6-2,R64,106,7,0,72,99,56,72,17,27,2,2,15,73,99,2,1,66,82,43,66,8,16,2,6,14,51,82
1995-01-16 00:00:00.000,Australian Open Australia Grand Slams,HARD,3,David Wheaton,Jan Siemerink,David Wheaton,6-2; 6-2; 6-2,R64,81,4,3,49,72,40,49,12,23,3,4,12,52,72,4,3,48,80,30,48,9,32,4,11,12,39,80
1995-01-16 00:00:00.000,Australian Open Australia Grand Slams,HARD,3,Stefano Pescosolido,Michael Tebbutt,Stefano Pescosolido,6-3; 6-4; 6-2,R64,97,5,4,56,92,49,56,17,36,2,2,14,66,92,8,6,40,94,33,40,24,54,2,6,13,57,94
1995-01-16 00:00:00.000,Australian Open Australia Grand Slams,HARD,3,Andrei Medvedev,Lars Rehmann,Andrei Medvedev,7-5; 6-4; 6-1,R64,101,11,5,61,96,52,61,16,35,1,2,14,68,96,6,7,74,109,52,74,9,35,6,12,15,61,109
1995-01-16 00:00:00.000,Australian Open Australia Grand Slams,HARD,3,Andrei Olhovskiy,Andrea Gaudenzi,Andrei Olhovskiy,6-2; 6-3; 6-3,R64,84,14,2,67,98,59,67,14,31,4,4,13,73,98,1,5,61,90,41,61,6,29,7,12,13,47,90
1995-01-16 00:00:00.000,Australian Open Australia Grand Slams,HARD,3,Olivier Delaitre,Jan Apell,Olivier Delaitre,7-6(2); 6-4; 6-2,R64,99,5,2,62,90,53,62,16,28,3,4,15,69,90,10,9,65,120,49,65,22,55,6,10,15,71,120
1995-01-16 00:00:00.000,Australian Open Australia Grand Slams,HARD,3,Martin Damm,Tommy Ho,Martin Damm,3-6; 3-6; 7-6(6); 6-3; 6-3,R64,187,15,3,108,169,76,108,29,61,5,12,24,105,169,7,6,99,163,69,99,28,64,4,11,24,97,163
1995-01-16 00:00:00.000,Australian Open Australia Grand Slams,HARD,3,Michael Chang,Karim Alami,Michael Chang,6-3; 6-4; 6-1,R64,103,5,3,47,86,40,47,19,39,8,9,13,59,86,4,3,43,84,29,43,13,41,4,10,13,42,84
1995-01-16 00:00:00.000,Australian Open Australia Grand Slams,HARD,3,Stefan Edberg,Adrian Voinea,Stefan Edberg,6-3; 7-6(3); 6-4,R64,124,4,6,71,108,56,71,15,37,5,7,15,71,108,4,3,69,122,47,69,23,53,11,16,16,70,122
1995-01-16 00:00:00.000,Australian Open Australia Grand Slams,HARD,3,Hendrik Dreekmann,Fabrice Santoro,Hendrik Dreekmann,6-3; 6-4; 6-2,R64,104,4,3,54,88,45,54,18,34,2,3,14,63,88,5,10,48,102,32,48,21,54,5,10,13,53,102
1995-01-16 00:00:00.000,Australian Open Australia Grand Slams,HARD,3,Petr Korda,Lars Burgsmuller,Petr Korda,2-6; 5-7; 6-4; 7-6(2); 7-5,R64,205,6,12,110,197,79,110,30,87,12,21,27,109,197,6,7,132,196,83,132,30,64,12,20,27,113,196
1995-01-16 00:00:00.000,Australian Open Australia Grand Slams,HARD,3,Aaron Krickstein,Wayne Ferreira,Aaron Krickstein,6-3; 6-7(8); 7-6(4); 6-3,R64,181,2,4,88,150,68,88,32,62,6,9,21,100,150,12,3,91,166,67,91,32,75,6,12,21,99,166
1995-01-16 00:00:00.000,Australian Open Australia Grand Slams,HARD,3,Thomas Muster,Thierry Guardiola,Thomas Muster,6-3; 7-6(3); 6-2,R64,104,0,3,64,93,48,64,15,29,5,6,14,63,93,2,3,47,99,30,47,27,52,6,11,15,57,99
1995-01-16 00:00:00.000,Australian Open Australia Grand Slams,HARD,3,Jacco Eltingh,Sebastien Lareau,Jacco Eltingh,7-6(4); 5-7; 7-6(5); 7-5,R64,201,17,9,118,197,86,118,34,79,12,16,24,120,197,25,10,111,188,86,111,34,77,8,12,24,120,188
1995-01-16 00:00:00.000,Australian Open Australia Grand Slams,HARD,3,David Prinosil,Wally Masur,David Prinosil,7-6(4); 6-3; 6-4,R64,121,20,2,77,119,70,77,25,42,2,2,16,95,119,3,3,77,117,50,77,23,40,11,13,15,73,117
1995-01-16 00:00:00.000,Australian Open Australia Grand Slams,HARD,3,Patrick McEnroe,Jeremy Bates,Patrick McEnroe,6-3; 7-5; 6-3,R64,140,3,4,92,133,58,92,20,41,17,20,15,78,133,5,2,71,107,45,71,12,36,11,18,15,57,107
1995-01-16 00:00:00.000,Australian Open Australia Grand Slams,HARD,3,Todd Martin,Jean-Philippe Fleurian,Todd Martin,6-4; 6-2; 6-3,R64,135,17,4,69,119,55,69,24,50,6,8,13,79,119,6,3,69,120,39,69,22,51,15,22,14,61,120
1995-01-16 00:00:00.000,Australian Open Australia Grand Slams,HARD,3,Vincent Spadea,Wayne Black,Vincent Spadea,6-4; 6-1; 6-0,R64,94,1,0,47,74,34,47,11,27,4,7,12,45,74,1,1,63,87,29,63,8,24,10,19,11,37,87
1995-01-16 00:00:00.000,Australian Open Australia Grand Slams,HARD,3,Jonas Bjorkman,Guy Forget,Jonas Bjorkman,6-4; 1-6; 2-6; 6-4; 6-3,R64,172,8,7,99,156,69,99,26,57,11,15,22,95,156,19,6,104,172,84,104,28,68,13,16,22,112,172
1995-01-16 00:00:00.000,Australian Open Australia Grand Slams,HARD,3,Yevgeny Kafelnikov,Kenneth Carlsen,Yevgeny Kafelnikov,4-6; 6-3; 6-1; 6-3,R64,149,4,4,63,110,52,63,27,47,1,2,18,79,110,14,11,83,154,60,83,26,71,7,12,17,86,154
1995-01-16 00:00:00.000,Australian Open Australia Grand Slams,HARD,3,Marcos Ondruska,Richard Krajicek,Marcos Ondruska,7-6(5); 6-4; 6-3,R64,131,0,4,84,127,66,84,14,43,9,10,16,80,127,2,1,65,96,49,65,12,31,1,4,15,61,96
1995-01-16 00:00:00.000,Australian Open Australia Grand Slams,HARD,3,Patrick Rafter,Steve Campbell,Patrick Rafter,6-4; 7-6(1); 6-2,R64,115,8,3,59,94,44,59,20,35,0,3,15,64,94,2,6,67,112,43,67,15,45,7,13,15,58,112
1995-01-16 00:00:00.000,Australian Open Australia Grand Slams,HARD,3,Greg Rusedski,Nicklas Kulti,Greg Rusedski,7-6(3); 4-6; 2-6; 6-3,R64,172,18,15,95,177,80,95,29,82,4,8,23,109,177,4,2,85,141,64,85,31,56,4,9,24,95,141
1995-01-16 00:00:00.000,Australian Open Australia Grand Slams,HARD,3,Andre Agassi,Jerome Golmard,Andre Agassi,6-2; 6-3; 6-1,R64,93,10,2,53,74,46,53,12,21,0,0,12,58,74,4,3,74,100,43,74,6,26,9,15,12,49,100
1995-01-16 00:00:00.000,Australian Open Australia Grand Slams,HARD,3,Pete Sampras,Lars Jonsson,Pete Sampras,6-1; 6-2; 6-4,R32,99,15,4,48,93,44,48,26,45,0,0,13,70,93,5,2,58,103,28,58,28,45,10,15,12,56,103
1995-01-16 00:00:00.000,Australian Open Australia Grand Slams,HARD,3,Magnus Larsson,Thomas Enqvist,Magnus Larsson,W/O,R32,0,0,0,0,0,0,0,0,0,0,0,0,0,0,0,0,1,1,0,1,0,0,0,0,1,0,1
1995-01-16 00:00:00.000,Australian Open Australia Grand Slams,HARD,3,Jim Courier,Mark Woodforde,Jim Courier,6-3; 6-3; 6-3,R32,105,4,1,56,79,45,56,11,23,4,6,14,56,79,3,4,36,81,26,36,16,45,4,10,13,42,81
1995-01-16 00:00:00.000,Australian Open Australia Grand Slams,HARD,3,Karel Novacek,Michael Stich,Karel Novacek,7-5; 6-2; 6-4,R32,99,5,0,56,90,44,56,25,34,2,2,15,69,90,1,3,53,90,40,53,13,37,3,7,15,53,90
1995-01-16 00:00:00.000,Australian Open Australia Grand Slams,HARD,3,David Wheaton,Renzo Furlan,David Wheaton,7-6(6); 6-4; 6-3,R32,143,13,2,85,124,67,85,21,39,8,8,16,88,124,4,2,65,120,49,65,26,55,9,11,15,75,120
1995-01-16 00:00:00.000,Australian Open Australia Grand Slams,HARD,3,Andrei Medvedev,Stefano Pescosolido,Andrei Medvedev,6-4; 6-3; 6-3,R32,106,9,6,40,101,33,40,30,61,2,5,14,63,101,3,7,55,107,28,55,24,52,6,13,14,52,107
1995-01-16 00:00:00.000,Australian Open Australia Grand Slams,HARD,3,Olivier Delaitre,Andrei Olhovskiy,Olivier Delaitre,6-4; 6-4; 6-2,R32,93,5,1,69,86,57,69,7,17,2,2,14,64,86,8,2,54,98,40,54,19,44,3,7,14,59,98
1995-01-16 00:00:00.000,Australian Open Australia Grand Slams,HARD,3,Michael Chang,Martin Damm,Michael Chang,6-3; 7-5; 6-3,R32,122,15,1,66,91,58,66,15,25,0,1,15,73,91,9,6,74,121,55,74,14,47,8,13,15,69,121
1995-01-16 00:00:00.000,Australian Open Australia Grand Slams,HARD,3,Stefan Edberg,Hendrik Dreekmann,Stefan Edberg,7-6(8); 6-2; 6-3,R32,123,6,4,71,116,51,71,26,45,5,6,15,77,116,4,2,62,112,42,62,21,50,4,8,14,63,112
1995-01-16 00:00:00.000,Australian Open Australia Grand Slams,HARD,3,Aaron Krickstein,Petr Korda,Aaron Krickstein,6-1; 6-4; 7-6(1),R32,123,4,2,97,129,62,97,16,32,13,15,15,78,129,7,11,83,128,55,83,10,45,6,11,14,65,128
1995-01-16 00:00:00.000,Australian Open Australia Grand Slams,HARD,3,Jacco Eltingh,Thomas Muster,Jacco Eltingh,6-3; 6-2; 2-6; 7-5,R32,118,11,8,81,132,64,81,21,51,2,6,19,85,132,3,4,86,111,54,86,13,25,7,13,18,67,111
1995-01-16 00:00:00.000,Australian Open Australia Grand Slams,HARD,3,Patrick McEnroe,David Prinosil,Patrick McEnroe,6-3; 6-2; 6-4,R32,108,1,2,69,95,47,69,13,26,6,7,14,60,95,11,8,69,114,49,69,14,45,2,7,13,63,114
1995-01-16 00:00:00.000,Australian Open Australia Grand Slams,HARD,3,Todd Martin,Vincent Spadea,Todd Martin,6-3; 6-1; 6-2,R32,90,9,2,51,79,41,51,14,28,3,4,12,55,79,1,5,49,90,26,49,14,41,10,17,12,40,90
1995-01-16 00:00:00.000,Australian Open Australia Grand Slams,HARD,3,Yevgeny Kafelnikov,Jonas Bjorkman,Yevgeny Kafelnikov,4-6; 6-1; 6-2; 7-6(8),R32,149,1,3,99,155,69,99,25,56,7,10,19,94,155,4,6,69,125,50,69,21,56,8,14,18,71,125
1995-01-16 00:00:00.000,Australian Open Australia Grand Slams,HARD,3,Patrick Rafter,Marcos Ondruska,Patrick Rafter,6-3; 1-6; 3-6; 6-2; 6-2,R32,163,11,6,93,140,69,93,23,47,5,9,21,92,140,2,3,76,133,54,76,29,57,10,15,20,83,133
1995-01-16 00:00:00.000,Australian Open Australia Grand Slams,HARD,3,Andre Agassi,Greg Rusedski,Andre Agassi,6-2; 6-4; 6-2,R32,82,1,2,41,64,33,41,17,23,0,1,13,50,64,2,4,45,92,28,45,18,47,9,15,13,46,92
1995-01-16 00:00:00.000,Australian Open Australia Grand Slams,HARD,3,Pete Sampras,Magnus Larsson,Pete Sampras,4-6; 6-7(4); 7-5; 6-4; 6-4,R16,187,18,5,118,184,101,118,32,66,11,13,27,133,184,17,3,116,178,94,116,34,62,6,10,27,128,178
1995-01-16 00:00:00.000,Australian Open Australia Grand Slams,HARD,3,Jim Courier,Karel Novacek,Jim Courier,6-2; 6-3; 6-2,R16,85,3,4,57,85,46,57,13,28,2,2,13,59,85,3,2,41,73,29,41,13,32,2,7,12,42,73
1995-01-16 00:00:00.000,Australian Open Australia Grand Slams,HARD,3,Andrei Medvedev,David Wheaton,Andrei Medvedev,3-6; 6-3; 6-4; 6-7(4); 10-8,R16,207,13,6,65,124,57,65,34,59,0,2,20,91,124,8,6,94,140,70,94,22,46,7,10,20,92,140
1995-01-16 00:00:00.000,Australian Open Australia Grand Slams,HARD,3,Michael Chang,Olivier Delaitre,Michael Chang,6-3; 6-2; 6-4,R16,112,5,1,43,90,34,43,29,47,2,4,14,63,90,1,2,51,90,30,51,14,39,5,11,13,44,90
1995-01-16 00:00:00.000,Australian Open Australia Grand Slams,HARD,3,Aaron Krickstein,Stefan Edberg,Aaron Krickstein,6-7(6); 5-7; 6-4; 7-6(5); 6-4,R16,5,12,1,134,213,90,134,44,79,12,18,28,134,213,13,6,141,205,104,141,26,64,13,20,28,130,205
1995-01-16 00:00:00.000,Australian Open Australia Grand Slams,HARD,3,Jacco Eltingh,Patrick McEnroe,Jacco Eltingh,6-4; 6-4; 6-7(7); 5-7; 6-4,R16,217,32,5,123,199,102,123,37,76,7,11,27,139,199,6,4,135,189,97,135,23,54,12,18,27,120,189
1995-01-16 00:00:00.000,Australian Open Australia Grand Slams,HARD,3,Yevgeny Kafelnikov,Todd Martin,Yevgeny Kafelnikov,6-1; 6-4; 6-2,R16,96,4,3,55,82,44,55,14,27,3,4,13,58,82,4,2,53,90,31,53,15,37,9,15,12,46,90
1995-01-16 00:00:00.000,Australian Open Australia Grand Slams,HARD,3,Andre Agassi,Patrick Rafter,Andre Agassi,6-3; 6-4; 6-0,R16,86,4,0,48,67,44,48,9,19,0,0,12,53,67,7,3,51,82,39,51,7,31,4,10,13,46,82
1995-01-16 00:00:00.000,Australian Open Australia Grand Slams,HARD,3,Pete Sampras,Jim Courier,Pete Sampras,6-7(4); 6-7(3); 6-3; 6-4; 6-3,Q,238,24,4,104,184,92,104,46,80,3,4,26,138,184,10,2,129,191,92,129,35,62,3,8,26,127,191
1995-01-16 00:00:00.000,Australian Open Australia Grand Slams,HARD,3,Michael Chang,Andrei Medvedev,Michael Chang,7-6(7); 7-5; 6-3,Q,143,6,5,57,121,42,57,28,64,7,13,16,70,121,6,4,66,121,44,66,16,55,5,14,17,60,121
1995-01-16 00:00:00.000,Australian Open Australia Grand Slams,HARD,3,Aaron Krickstein,Jacco Eltingh,Aaron Krickstein,7-6(3); 6-4; 5-7; 6-4,Q,154,21,1,101,154,77,101,30,53,4,8,22,107,154,8,7,101,160,70,101,26,59,8,13,22,96,160
1995-01-16 00:00:00.000,Australian Open Australia Grand Slams,HARD,3,Andre Agassi,Yevgeny Kafelnikov,Andre Agassi,6-2; 7-5; 6-0,Q,2,6,1,50,74,37,50,19,24,1,2,13,56,74,3,3,47,78,29,47,10,31,4,11,13,39,78
1995-01-16 00:00:00.000,Australian Open Australia Grand Slams,HARD,3,Pete Sampras,Michael Chang,Pete Sampras,6-7(6); 6-3; 6-4; 6-4,S,4,13,4,82,156,70,82,38,74,6,8,21,108,156,20,2,84,156,69,84,35,72,10,15,20,104,156
1995-01-16 00:00:00.000,Australian Open Australia Grand Slams,HARD,3,Andre Agassi,Aaron Krickstein,Andre Agassi,6-4; 6-4; 3-0 RET,S,1,5,0,47,59,37,47,7,12,1,3,12,44,59,3,0,40,63,25,40,10,23,0,6,12,35,63
1995-01-16 00:00:00.000,Australian Open Australia Grand Slams,HARD,3,Andre Agassi,Pete Sampras,Andre Agassi,4-6; 6-1; 7-6(6); 6-4,F,3,10,4,95,132,70,95,20,37,2,4,19,90,132,28,6,104,173,82,104,30,69,16,21,20,112,173
1995-02-06 00:00:00.000,Dubai U.A.E. ATP World Tour,HARD,2,Sergi Bruguera,Oscar Martinez,Sergi Bruguera,6-4; 6-1,R32,78,1,1,32,57,23,32,15,25,1,2,9,38,57,1,4,24,63,15,24,18,39,5,9,8,33,63
1995-02-06 00:00:00.000,Dubai U.A.E. ATP World Tour,HARD,2,Javier Sanchez,Richard Fromberg,Javier Sanchez,6-2; 6-4,R32,64,0,1,34,49,25,34,10,15,3,4,9,35,49,4,1,32,61,19,32,12,29,3,7,9,31,61
1995-02-06 00:00:00.000,Dubai U.A.E. ATP World Tour,HARD,2,Todd Woodbridge,Tomas Carbonell,Todd Woodbridge,6-3; 6-2,R32,72,0,2,43,60,32,43,10,17,4,4,9,42,60,0,1,30,60,21,30,11,30,3,6,8,32,60
1995-02-06 00:00:00.000,Dubai U.A.E. ATP World Tour,HARD,2,Jason Stoltenberg,Markus Zoecke,Jason Stoltenberg,6-3; 6-1,R32,58,3,5,35,52,27,35,8,17,3,4,8,35,52,2,4,29,50,14,29,6,21,1,6,8,20,50
1995-02-06 00:00:00.000,Dubai U.A.E. ATP World Tour,HARD,2,Wayne Ferreira,John Fitzgerald,Wayne Ferreira,6-4; 6-1,R32,71,2,3,27,63,18,27,22,36,6,7,8,40,63,2,10,35,70,21,35,13,35,5,10,9,34,70
1995-02-06 00:00:00.000,Dubai U.A.E. ATP World Tour,HARD,2,Kent Kinnear,Alexander Volkov,Kent Kinnear,7-6(3); 7-6(1),R32,106,5,8,53,100,34,53,25,47,10,14,12,59,100,1,10,37,83,25,37,20,46,4,8,12,45,83
1995-02-06 00:00:00.000,Dubai U.A.E. ATP World Tour,HARD,2,Albert Costa,Vincent Spadea,Albert Costa,6-2; 6-3,R32,66,1,5,31,52,19,31,14,21,4,5,8,33,52,2,2,23,56,15,23,14,33,4,9,9,29,56
1995-02-06 00:00:00.000,Dubai U.A.E. ATP World Tour,HARD,2,Pat Cash,Thomas Muster,Pat Cash,2-6; 6-4; 6-4,R32,115,14,7,55,98,38,55,21,43,9,13,14,59,98,1,3,55,81,38,55,12,26,1,5,14,50,81
1995-02-06 00:00:00.000,Dubai U.A.E. ATP World Tour,HARD,2,Petr Korda,Oliver Gross,Petr Korda,6-1; 6-2,R32,67,2,1,29,58,21,29,15,29,3,3,7,36,58,1,6,27,52,12,27,11,25,3,8,8,23,52
1995-02-06 00:00:00.000,Dubai U.A.E. ATP World Tour,HARD,2,Carlos Costa,Francisco Roig,Carlos Costa,3-6; 6-2; 6-4,R32,106,2,4,43,77,28,43,18,34,4,8,13,46,77,0,3,49,82,32,49,12,33,3,9,14,44,82
1995-02-06 00:00:00.000,Dubai U.A.E. ATP World Tour,HARD,2,Carsten Arriens,Jeremy Bates,Carsten Arriens,6-3; 6-4,R32,71,6,4,30,58,25,30,17,28,2,3,10,42,58,1,2,28,53,18,28,11,25,0,3,9,29,53
1995-02-06 00:00:00.000,Dubai U.A.E. ATP World Tour,HARD,2,Alberto Berasategui,Danny Sapsford,Alberto Berasategui,6-1; 6-2,R32,42,0,4,33,50,28,33,8,17,3,3,8,36,50,0,2,25,35,12,25,5,10,3,7,7,17,35
1995-02-06 00:00:00.000,Dubai U.A.E. ATP World Tour,HARD,2,Henrik Holm,Alex Corretja,Henrik Holm,4-6; 6-2; 7-5,R32,111,4,9,49,90,35,49,21,41,4,7,15,56,90,0,3,57,87,34,57,17,30,7,12,15,51,87
1995-02-06 00:00:00.000,Dubai U.A.E. ATP World Tour,HARD,2,Hicham Arazi,Karel Novacek,Hicham Arazi,7-6(4); 6-7(1); 6-2,R32,133,1,1,55,101,39,55,30,46,5,7,16,69,101,9,3,60,108,43,60,23,48,7,11,16,66,108
1995-02-06 00:00:00.000,Dubai U.A.E. ATP World Tour,HARD,2,Francisco Clavet,Karsten Braasch,Francisco Clavet,6-7(6); 7-5 RET,R32,112,2,3,47,68,37,47,10,21,1,3,13,47,68,11,11,45,109,38,45,27,64,15,18,12,65,109
1995-02-06 00:00:00.000,Dubai U.A.E. ATP World Tour,HARD,2,Andrea Gaudenzi,Goran Ivanisevic,Andrea Gaudenzi,3-6; 6-3; 6-3,R32,89,5,3,55,86,40,55,16,31,4,6,13,56,86,6,4,31,77,26,31,23,46,1,5,14,49,77
1995-02-06 00:00:00.000,Dubai U.A.E. ATP World Tour,HARD,2,Javier Sanchez,Sergi Bruguera,Javier Sanchez,W/O,R16,0,0,0,0,0,0,0,0,0,0,0,0,0,0,0,0,0,0,0,0,0,0,0,0,0,0,0
1995-02-06 00:00:00.000,Dubai U.A.E. ATP World Tour,HARD,2,Todd Woodbridge,Jason Stoltenberg,Todd Woodbridge,6-3; 2-1 RET,R16,47,0,4,16,34,12,16,11,18,1,2,7,23,34,0,2,25,43,14,25,7,18,1,4,6,21,43
1995-02-06 00:00:00.000,Dubai U.A.E. ATP World Tour,HARD,2,Wayne Ferreira,Kent Kinnear,Wayne Ferreira,6-1; 7-6(4),R16,81,6,5,38,69,26,38,18,31,3,5,10,44,69,1,6,37,69,24,37,12,32,7,11,9,36,69
1995-02-06 00:00:00.000,Dubai U.A.E. ATP World Tour,HARD,2,Pat Cash,Albert Costa,Pat Cash,6-3; 4-6; 6-3,R16,118,6,12,37,88,32,37,26,51,7,9,14,58,88,0,3,69,95,41,69,16,26,6,10,14,57,95
1995-02-06 00:00:00.000,Dubai U.A.E. ATP World Tour,HARD,2,Petr Korda,Carlos Costa,Petr Korda,6-4; 6-7(5); 6-1,R16,112,13,9,54,94,45,54,13,40,1,3,14,58,94,4,3,30,91,24,30,24,61,3,9,15,48,91
1995-02-06 00:00:00.000,Dubai U.A.E. ATP World Tour,HARD,2,Carsten Arriens,Alberto Berasategui,Carsten Arriens,6-4; 6-4,R16,70,2,3,30,58,25,30,13,28,0,2,10,38,58,0,3,50,71,31,50,8,21,6,10,10,39,71
1995-02-06 00:00:00.000,Dubai U.A.E. ATP World Tour,HARD,2,Henrik Holm,Hicham Arazi,Henrik Holm,6-3; 6-2,R16,55,6,6,25,48,23,25,14,23,0,0,9,37,48,1,4,26,47,16,26,10,21,2,5,8,26,47
1995-02-06 00:00:00.000,Dubai U.A.E. ATP World Tour,HARD,2,Andrea Gaudenzi,Francisco Clavet,Andrea Gaudenzi,7-6(5); 1-6; 6-2,R16,140,0,5,52,88,37,52,12,36,5,10,14,49,88,2,5,56,95,33,56,21,39,8,12,13,54,95
1995-02-06 00:00:00.000,Dubai U.A.E. ATP World Tour,HARD,2,Javier Sanchez,Todd Woodbridge,Javier Sanchez,6-2; 6-4,Q,68,0,3,30,48,23,30,12,18,1,2,9,35,48,0,3,37,63,23,37,11,26,3,7,9,34,63
1995-02-06 00:00:00.000,Dubai U.A.E. ATP World Tour,HARD,2,Wayne Ferreira,Pat Cash,Wayne Ferreira,6-1; 6-2,Q,65,0,2,17,41,11,17,18,24,3,4,7,29,41,0,2,21,52,15,21,7,31,2,8,8,22,52
1995-02-06 00:00:00.000,Dubai U.A.E. ATP World Tour,HARD,2,Petr Korda,Carsten Arriens,Petr Korda,4-6; 6-2; 6-4,Q,109,0,5,43,73,30,43,13,30,4,8,14,43,73,3,1,54,102,34,54,19,48,6,12,14,53,102
1995-02-06 00:00:00.000,Dubai U.A.E. ATP World Tour,HARD,2,Andrea Gaudenzi,Henrik Holm,Andrea Gaudenzi,6-4; 6-2,Q,63,0,2,34,50,27,34,8,16,0,1,9,35,50,2,6,23,55,13,23,17,32,4,8,9,30,55
1995-02-06 00:00:00.000,Dubai U.A.E. ATP World Tour,HARD,2,Wayne Ferreira,Javier Sanchez,Wayne Ferreira,5-7; 6-1; 6-4,S,100,5,2,46,90,39,46,19,44,3,6,15,58,90,1,4,52,71,34,52,9,19,3,8,14,43,71
1995-02-06 00:00:00.000,Dubai U.A.E. ATP World Tour,HARD,2,Andrea Gaudenzi,Petr Korda,Andrea Gaudenzi,3-6; 7-6(3); 6-4,S,120,0,3,75,109,47,75,17,34,9,13,15,64,109,12,8,58,102,43,58,18,44,5,9,16,61,102
1995-02-06 00:00:00.000,Dubai U.A.E. ATP World Tour,HARD,2,Wayne Ferreira,Andrea Gaudenzi,Wayne Ferreira,6-3; 6-3,F,65,7,0,35,55,28,35,11,20,0,0,9,39,55,0,1,36,52,22,36,8,16,5,8,9,30,52
1995-02-06 00:00:00.000,Marseille France ATP World Tour,HARD,2,Boris Becker,Juan Albert Viloca-Puig,Boris Becker,6-2; 6-4,R32,52,11,1,27,42,25,27,11,15,0,0,9,36,42,2,2,29,50,23,29,8,21,2,5,9,31,50
1995-02-06 00:00:00.000,Marseille France ATP World Tour,HARD,2,Henri Leconte,Jan Siemerink,Henri Leconte,6-4; 6-4,R32,81,7,4,37,63,28,37,14,26,3,4,10,42,63,6,4,31,63,19,31,17,32,4,7,10,36,63
1995-02-06 00:00:00.000,Marseille France ATP World Tour,HARD,2,Carl-Uwe Steeb,Adrian Voinea,Carl-Uwe Steeb,6-4; 6-1,R32,55,3,1,26,47,21,26,13,21,0,1,9,34,47,3,5,25,47,15,25,9,22,1,5,8,24,47
1995-02-06 00:00:00.000,Marseille France ATP World Tour,HARD,2,Joern Renzenbrink,Hendrik Dreekmann,Joern Renzenbrink,7-6(2); 7-6(4),R32,108,8,6,48,76,39,48,16,28,1,2,12,55,76,5,5,53,99,40,53,21,46,12,13,12,61,99
1995-02-06 00:00:00.000,Marseille France ATP World Tour,HARD,2,Olivier Delaitre,Guillaume Raoux,Olivier Delaitre,7-6(6); 6-3,R32,91,10,5,40,78,35,40,20,38,2,2,11,55,78,15,3,40,78,33,40,17,38,10,11,10,50,78
1995-02-06 00:00:00.000,Marseille France ATP World Tour,HARD,2,Alexander Mronz,Pier Gauthier,Alexander Mronz,6-3; 1-6; 6-3,R32,100,6,2,40,72,31,40,18,32,2,4,13,49,72,4,3,47,78,36,47,12,31,10,12,12,48,78
1995-02-06 00:00:00.000,Marseille France ATP World Tour,HARD,2,David Rikl,Thierry Guardiola,David Rikl,2-6; 7-6(5); 6-4,R32,121,8,8,45,96,37,45,27,51,5,8,15,64,96,10,5,53,99,34,53,29,46,1,3,15,63,99
1995-02-06 00:00:00.000,Marseille France ATP World Tour,HARD,2,Mikael Stadling,Fabrice Santoro,Mikael Stadling,6-4; 4-6; 6-4,R32,125,3,4,67,109,42,67,18,42,11,17,15,60,109,2,6,49,97,28,49,20,48,10,17,15,48,97
1995-02-06 00:00:00.000,Marseille France ATP World Tour,HARD,2,Karol Kucera,Cristiano Caratti,Karol Kucera,6-1; 6-2,R32,49,7,3,32,47,25,32,8,15,3,4,8,33,47,2,1,24,39,13,24,3,15,0,5,7,16,39
1995-02-06 00:00:00.000,Marseille France ATP World Tour,HARD,2,Gianluca Pozzi,Emilio Sanchez,Gianluca Pozzi,7-5; 6-3,R32,71,3,0,31,53,20,31,15,22,0,2,10,35,53,0,4,37,61,22,37,12,24,5,10,11,34,61
1995-02-06 00:00:00.000,Marseille France ATP World Tour,HARD,2,Lionel Roux,Andrei Olhovskiy,Lionel Roux,6-3; 6-2,R32,75,10,1,36,57,27,36,13,21,4,5,9,40,57,6,1,28,61,20,28,12,33,2,6,8,32,61
1995-02-06 00:00:00.000,Marseille France ATP World Tour,HARD,2,Slava Dosedel,Jean-Philippe Fleurian,Slava Dosedel,7-6(8); 6-0,R32,76,2,2,29,60,22,29,19,31,3,4,9,41,60,7,2,33,53,23,33,8,20,3,7,9,31,53
1995-02-06 00:00:00.000,Marseille France ATP World Tour,HARD,2,Daniel Vacek,Martin Damm,Daniel Vacek,2-6; 7-6(4); 7-6(4),R32,137,5,4,63,95,46,63,20,32,2,5,16,66,95,8,6,65,112,50,65,25,47,1,2,16,75,112
1995-02-06 00:00:00.000,Marseille France ATP World Tour,HARD,2,Paul Wekesa,Karim Alami,Paul Wekesa,7-6(8); 6-3,R32,79,1,2,50,69,38,50,11,19,3,4,11,49,69,4,1,31,64,24,31,17,33,2,4,10,41,64
1995-02-06 00:00:00.000,Marseille France ATP World Tour,HARD,2,Jakob Hlasek,Lars Jonsson,Jakob Hlasek,7-5; 6-2,R32,64,13,4,32,55,26,32,12,23,2,3,10,38,55,7,2,40,66,29,40,8,26,4,8,10,37,66
1995-02-06 00:00:00.000,Marseille France ATP World Tour,HARD,2,Yevgeny Kafelnikov,Kenneth Carlsen,Yevgeny Kafelnikov,7-5; 6-3,R32,72,5,3,37,67,27,37,19,30,3,4,11,46,67,8,4,38,62,26,38,11,24,1,4,10,37,62
1995-02-06 00:00:00.000,Marseille France ATP World Tour,HARD,2,Boris Becker,Henri Leconte,Boris Becker,6-0; 6-4,R16,57,10,5,26,47,24,26,7,21,1,2,8,31,47,2,4,22,39,11,22,6,17,1,6,8,17,39
1995-02-06 00:00:00.000,Marseille France ATP World Tour,HARD,2,Joern Renzenbrink,Carl-Uwe Steeb,Joern Renzenbrink,5-7; 7-6(9); 6-4,R16,131,25,4,67,96,55,67,16,29,2,4,17,71,96,7,2,90,135,69,90,17,45,7,9,17,86,135
1995-02-06 00:00:00.000,Marseille France ATP World Tour,HARD,2,Olivier Delaitre,Alexander Mronz,Olivier Delaitre,3-6; 6-3; 7-6(3),R16,117,10,5,42,82,34,42,25,40,2,4,15,59,82,16,3,60,102,46,60,21,42,6,8,15,67,102
1995-02-06 00:00:00.000,Marseille France ATP World Tour,HARD,2,David Rikl,Mikael Stadling,David Rikl,6-4; 6-2,R16,55,9,1,27,51,24,27,12,24,2,3,9,36,51,3,3,37,53,19,37,10,16,4,8,9,29,53
1995-02-06 00:00:00.000,Marseille France ATP World Tour,HARD,2,Karol Kucera,Gianluca Pozzi,Karol Kucera,6-3; 6-4,R16,78,0,1,34,57,31,34,11,23,2,2,10,42,57,1,2,53,83,35,53,12,30,8,10,9,47,83
1995-02-06 00:00:00.000,Marseille France ATP World Tour,HARD,2,Lionel Roux,Slava Dosedel,Lionel Roux,7-5; 6-3,R16,94,8,6,45,77,32,45,20,32,6,6,11,52,77,4,2,30,64,21,30,18,34,2,4,10,39,64
1995-02-06 00:00:00.000,Marseille France ATP World Tour,HARD,2,Daniel Vacek,Paul Wekesa,Daniel Vacek,6-4; 6-4,R16,77,7,4,38,68,34,38,13,30,6,6,10,47,68,1,3,40,66,31,40,9,26,4,6,10,40,66
1995-02-06 00:00:00.000,Marseille France ATP World Tour,HARD,2,Yevgeny Kafelnikov,Jakob Hlasek,Yevgeny Kafelnikov,6-4; 6-4,R16,62,4,1,26,53,22,26,19,27,0,0,10,41,53,6,1,35,57,29,35,8,22,0,2,10,37,57
1995-02-06 00:00:00.000,Marseille France ATP World Tour,HARD,2,Boris Becker,Joern Renzenbrink,Boris Becker,7-6(1); 6-7(11); 6-2,Q,127,21,4,61,101,56,61,20,40,2,2,16,76,101,18,4,81,113,58,81,18,32,5,7,16,76,113
1995-02-06 00:00:00.000,Marseille France ATP World Tour,HARD,2,Olivier Delaitre,David Rikl,Olivier Delaitre,6-2; 6-2,Q,60,5,1,25,49,21,25,15,24,2,2,8,36,49,2,3,19,53,11,19,16,34,6,10,8,27,53
1995-02-06 00:00:00.000,Marseille France ATP World Tour,HARD,2,Lionel Roux,Karol Kucera,Lionel Roux,3-6; 6-1; 6-2,Q,110,4,2,39,78,28,39,24,39,1,2,12,52,78,10,5,47,80,31,47,15,33,4,8,12,46,80
1995-02-06 00:00:00.000,Marseille France ATP World Tour,HARD,2,Daniel Vacek,Yevgeny Kafelnikov,Daniel Vacek,7-5; 7-6(4),Q,72,13,2,41,63,38,41,16,22,0,0,12,54,63,11,3,39,71,33,39,18,32,2,3,12,51,71
1995-02-06 00:00:00.000,Marseille France ATP World Tour,HARD,2,Boris Becker,Olivier Delaitre,Boris Becker,6-4; 6-2,S,62,12,2,27,52,24,27,15,25,1,1,9,39,52,4,5,31,51,24,31,6,20,1,4,9,30,51
1995-02-06 00:00:00.000,Marseille France ATP World Tour,HARD,2,Daniel Vacek,Lionel Roux,Daniel Vacek,6-1; 7-5,S,92,8,5,32,56,26,32,14,24,3,3,9,40,56,3,6,40,83,27,40,18,43,12,16,10,45,83
1995-02-06 00:00:00.000,Marseille France ATP World Tour,HARD,2,Boris Becker,Daniel Vacek,Boris Becker,6-7(2); 6-4; 7-5,F,132,21,5,53,97,46,53,28,44,0,0,17,74,97,16,7,52,103,45,52,28,51,4,6,17,73,103
1995-02-06 00:00:00.000,San Jose CA; U.S.A. ATP World Tour,HARD,2,Andre Agassi,Fernando Meligeni,Andre Agassi,6-0; 6-2,R32,53,2,1,30,43,23,30,8,13,2,2,7,31,43,3,1,33,46,19,33,1,13,2,7,7,20,46
1995-02-06 00:00:00.000,San Jose CA; U.S.A. ATP World Tour,HARD,2,Marc-Kevin Goellner,Christian Ruud,Marc-Kevin Goellner,7-6(12); 6-2,R32,89,13,6,38,70,34,38,18,32,3,3,10,52,70,5,2,43,83,29,43,23,40,7,9,10,52,83
1995-02-06 00:00:00.000,San Jose CA; U.S.A. ATP World Tour,HARD,2,Kenny Thorne,Jamie Morgan,Kenny Thorne,5-7; 7-5; 7-6(3),R32,148,7,2,102,136,72,102,12,34,12,15,18,84,136,5,4,57,106,43,57,27,49,2,5,18,70,106
1995-02-06 00:00:00.000,San Jose CA; U.S.A. ATP World Tour,HARD,2,Brian MacPhie,Marcelo Filippini,Brian MacPhie,6-2; 2-6; 6-3,R32,108,7,4,47,89,38,47,17,42,7,9,13,55,89,2,2,45,83,26,45,21,38,4,7,12,47,83
1995-02-06 00:00:00.000,San Jose CA; U.S.A. ATP World Tour,HARD,2,Bryan Shelton,Arnaud Boetsch,Bryan Shelton,6-4; 7-6(7),R32,86,7,3,43,71,37,43,15,28,1,1,11,52,71,8,3,45,76,32,45,19,31,5,6,11,51,76
1995-02-06 00:00:00.000,San Jose CA; U.S.A. ATP World Tour,HARD,2,Diego Nargiso,Scott Humphries,Diego Nargiso,6-3; 7-6(4),R32,82,7,0,35,63,27,35,17,28,5,6,10,44,63,5,4,39,63,30,39,10,24,0,3,11,40,63
1995-02-06 00:00:00.000,San Jose CA; U.S.A. ATP World Tour,HARD,2,Lars Rehmann,Richard Matuszewski,Lars Rehmann,6-4; 2-6; 6-4,R32,113,4,5,59,89,41,59,14,30,9,12,14,55,89,8,0,54,83,41,54,12,29,2,5,14,53,83
1995-02-06 00:00:00.000,San Jose CA; U.S.A. ATP World Tour,HARD,2,MaliVai Washington,Brad Gilbert,MaliVai Washington,7-6(2); 6-4,R32,80,4,0,45,59,37,45,12,14,0,0,11,49,59,3,4,40,70,31,40,15,30,1,2,11,46,70
1995-02-06 00:00:00.000,San Jose CA; U.S.A. ATP World Tour,HARD,2,Patrick McEnroe,Christo Van Rensburg,Patrick McEnroe,7-6(7); 6-4,R32,91,2,0,42,69,29,42,15,27,2,4,11,44,69,9,3,50,69,35,50,7,19,0,3,11,42,69
1995-02-06 00:00:00.000,San Jose CA; U.S.A. ATP World Tour,HARD,2,Jim Grabb,Jeff Tarango,Jim Grabb,7-5; 6-4,R32,88,8,3,52,72,38,52,13,20,2,2,11,51,72,1,3,51,73,36,51,11,22,6,8,11,47,73
1995-02-06 00:00:00.000,San Jose CA; U.S.A. ATP World Tour,HARD,2,Nicolas Pereira,Alex O'Brien,Nicolas Pereira,7-5; 6-4,R32,66,12,2,41,56,34,41,10,15,0,0,11,44,56,3,0,38,60,25,38,16,22,0,2,11,41,60
1995-02-06 00:00:00.000,San Jose CA; U.S.A. ATP World Tour,HARD,2,Jim Courier,Steve Campbell,Jim Courier,6-2; 6-4,R32,65,5,0,27,41,23,27,13,14,0,0,9,36,41,8,0,46,73,27,46,13,27,4,7,9,40,73
1995-02-06 00:00:00.000,San Jose CA; U.S.A. ATP World Tour,HARD,2,Greg Rusedski,Richey Reneberg,Greg Rusedski,6-3; 6-4,R32,63,20,2,40,62,32,40,9,22,2,3,10,41,62,3,4,25,49,18,25,12,24,1,4,9,30,49
1995-02-06 00:00:00.000,San Jose CA; U.S.A. ATP World Tour,HARD,2,Anders Jarryd,Luiz Mattar,Anders Jarryd,6-4; 6-2,R32,58,9,0,28,45,25,28,11,17,0,0,9,36,45,1,1,31,51,17,31,13,20,5,8,9,30,51
1995-02-06 00:00:00.000,San Jose CA; U.S.A. ATP World Tour,HARD,2,Jonathan Stark,Jeff Salzenstein,Jonathan Stark,6-1; 6-1,R32,48,4,1,26,42,20,26,10,16,2,2,7,30,42,2,4,28,45,14,28,5,17,5,10,7,19,45
1995-02-06 00:00:00.000,San Jose CA; U.S.A. ATP World Tour,HARD,2,Michael Chang,Marcelo Rios,Michael Chang,6-4; 7-5,R32,78,6,1,33,60,28,33,15,27,0,1,11,43,60,3,1,37,66,22,37,15,29,5,8,11,37,66
1995-02-06 00:00:00.000,San Jose CA; U.S.A. ATP World Tour,HARD,2,Andre Agassi,Marc-Kevin Goellner,Andre Agassi,7-6(4); 6-2,R16,75,1,1,40,60,34,40,12,20,2,2,10,46,60,12,6,40,76,31,40,15,36,6,8,10,46,76
1995-02-06 00:00:00.000,San Jose CA; U.S.A. ATP World Tour,HARD,2,Brian MacPhie,Kenny Thorne,Brian MacPhie,6-3; 6-4,R16,68,3,0,30,54,22,30,13,24,2,3,9,35,54,3,2,46,65,29,46,7,19,6,10,10,36,65
1995-02-06 00:00:00.000,San Jose CA; U.S.A. ATP World Tour,HARD,2,Bryan Shelton,Diego Nargiso,Bryan Shelton,7-6(9); 7-6(4),R16,117,7,1,44,82,35,44,27,38,3,4,12,62,82,14,4,58,97,43,58,22,39,6,7,12,65,97
1995-02-06 00:00:00.000,San Jose CA; U.S.A. ATP World Tour,HARD,2,MaliVai Washington,Lars Rehmann,MaliVai Washington,6-2; 6-2,R16,70,7,1,28,47,21,28,13,19,1,1,8,34,47,5,2,43,64,25,43,6,21,6,10,8,31,64
1995-02-06 00:00:00.000,San Jose CA; U.S.A. ATP World Tour,HARD,2,Jim Grabb,Patrick McEnroe,Jim Grabb,7-5; 6-7(6); 6-3,R16,148,26,1,75,112,59,75,20,37,3,3,17,79,112,4,3,69,103,51,69,19,34,2,4,16,70,103
1995-02-06 00:00:00.000,San Jose CA; U.S.A. ATP World Tour,HARD,2,Jim Courier,Nicolas Pereira,Jim Courier,6-4; 6-1,R16,62,4,0,29,47,22,29,10,18,2,3,8,32,47,7,2,37,57,23,37,5,20,3,8,9,28,57
1995-02-06 00:00:00.000,San Jose CA; U.S.A. ATP World Tour,HARD,2,Greg Rusedski,Anders Jarryd,Greg Rusedski,6-7(3); 6-0; 6-4,R16,102,10,3,52,81,43,52,20,29,5,5,14,63,81,5,5,56,93,42,56,15,37,5,9,14,57,93
1995-02-06 00:00:00.000,San Jose CA; U.S.A. ATP World Tour,HARD,2,Michael Chang,Jonathan Stark,Michael Chang,7-5; 6-4,R16,84,12,0,36,63,28,36,16,27,5,6,11,44,63,7,4,43,66,27,43,12,23,2,5,11,39,66
1995-02-06 00:00:00.000,San Jose CA; U.S.A. ATP World Tour,HARD,2,Andre Agassi,Brian MacPhie,Andre Agassi,6-4; 6-3,Q,75,4,1,38,58,32,38,9,20,3,3,9,41,58,4,0,35,67,23,35,14,32,4,7,10,37,67
1995-02-06 00:00:00.000,San Jose CA; U.S.A. ATP World Tour,HARD,2,MaliVai Washington,Bryan Shelton,MaliVai Washington,6-2; 6-1,Q,61,3,1,28,52,19,28,15,24,4,4,7,34,52,3,1,26,47,16,26,7,21,1,6,8,23,47
1995-02-06 00:00:00.000,San Jose CA; U.S.A. ATP World Tour,HARD,2,Jim Courier,Jim Grabb,Jim Courier,6-1; 7-6(5),Q,77,4,2,45,65,33,45,12,20,3,4,10,45,65,1,1,45,61,31,45,5,16,4,7,9,36,61
1995-02-06 00:00:00.000,San Jose CA; U.S.A. ATP World Tour,HARD,2,Michael Chang,Greg Rusedski,Michael Chang,7-6(6); 7-6(8),Q,121,4,0,43,86,35,43,28,43,4,4,12,63,86,17,3,59,97,46,59,21,38,8,8,12,67,97
1995-02-06 00:00:00.000,San Jose CA; U.S.A. ATP World Tour,HARD,2,Andre Agassi,MaliVai Washington,Andre Agassi,6-4; 6-2,S,68,4,0,37,53,29,37,8,16,2,3,9,37,53,4,3,20,49,15,20,12,29,2,6,9,27,49
1995-02-06 00:00:00.000,San Jose CA; U.S.A. ATP World Tour,HARD,2,Michael Chang,Jim Courier,Michael Chang,4-6; 7-6(5); 6-4,S,134,7,1,55,96,38,55,22,41,2,6,16,60,96,4,2,60,89,44,60,17,29,3,7,16,61,89
1995-02-06 00:00:00.000,San Jose CA; U.S.A. ATP World Tour,HARD,2,Andre Agassi,Michael Chang,Andre Agassi,6-2; 1-6; 6-3,F,92,8,3,44,67,33,44,11,23,1,3,12,44,67,9,0,46,73,27,46,17,27,3,6,12,44,73
1995-02-13 00:00:00.000,Memphis TN; U.S.A. ATP World Tour,HARD,2,Pete Sampras,N/A Bye,Pete Sampras,,R64,0,0,0,0,0,0,0,0,0,0,0,0,0,0,0,0,0,0,0,0,0,0,0,0,0,0,0
1995-02-13 00:00:00.000,Memphis TN; U.S.A. ATP World Tour,HARD,2,Grant Doyle,Marcos Ondruska,Grant Doyle,4-6; 7-6(5); 6-2,R64,150,3,5,57,113,36,57,34,56,9,12,15,70,113,4,5,47,107,35,47,27,60,8,12,15,62,107
1995-02-13 00:00:00.000,Memphis TN; U.S.A. ATP World Tour,HARD,2,Marcelo Rios,Andrew Sznajder,Marcelo Rios,6-1; 7-5,R64,69,7,2,34,57,26,34,11,23,4,5,9,37,57,1,1,41,67,22,41,11,26,2,7,10,33,67
1995-02-13 00:00:00.000,Memphis TN; U.S.A. ATP World Tour,HARD,2,Marcelo Filippini,N/A Bye,Marcelo Filippini,,R64,0,0,0,0,0,0,0,0,0,0,0,0,0,0,0,0,0,0,0,0,0,0,0,0,0,0,0
1995-02-13 00:00:00.000,Memphis TN; U.S.A. ATP World Tour,HARD,2,Thomas Enqvist,N/A Bye,Thomas Enqvist,,R64,0,0,0,0,0,0,0,0,0,0,0,0,0,0,0,0,0,0,0,0,0,0,0,0,0,0,0
1995-02-13 00:00:00.000,Memphis TN; U.S.A. ATP World Tour,HARD,2,Anders Jarryd,Nicolas Pereira,Anders Jarryd,6-4; 6-2,R64,68,1,2,28,56,23,28,18,28,6,6,9,41,56,3,2,33,61,26,33,10,28,2,5,9,36,61
1995-02-13 00:00:00.000,Memphis TN; U.S.A. ATP World Tour,HARD,2,Brett Steven,Christian Ruud,Brett Steven,6-2; 6-4,R64,87,11,5,56,83,39,56,11,27,9,10,9,50,83,2,5,30,62,15,30,16,32,7,11,9,31,62
1995-02-13 00:00:00.000,Memphis TN; U.S.A. ATP World Tour,HARD,2,Andrei Chesnokov,N/A Bye,Andrei Chesnokov,,R64,0,0,0,0,0,0,0,0,0,0,0,0,0,0,0,0,0,0,0,0,0,0,0,0,0,0,0
1995-02-13 00:00:00.000,Memphis TN; U.S.A. ATP World Tour,HARD,2,Todd Martin,N/A Bye,Todd Martin,,R64,0,0,0,0,0,0,0,0,0,0,0,0,0,0,0,0,0,0,0,0,0,0,0,0,0,0,0
1995-02-13 00:00:00.000,Memphis TN; U.S.A. ATP World Tour,HARD,2,Alexander Mronz,Luiz Mattar,Alexander Mronz,7-6(1); 6-3,R64,97,11,2,38,78,30,38,26,40,4,4,10,56,78,5,1,37,66,23,37,19,29,2,4,11,42,66
1995-02-13 00:00:00.000,Memphis TN; U.S.A. ATP World Tour,HARD,2,Jamie Morgan,Jeff Tarango,Jamie Morgan,7-6(5); 6-3,R64,80,9,7,34,68,29,34,15,34,1,3,10,44,68,3,4,44,68,30,44,9,24,3,7,11,39,68
1995-02-13 00:00:00.000,Memphis TN; U.S.A. ATP World Tour,HARD,2,Richey Reneberg,N/A Bye,Richey Reneberg,,R64,0,0,0,0,0,0,0,0,0,0,0,0,0,0,0,0,0,0,0,0,0,0,0,0,0,0,0
1995-02-13 00:00:00.000,Memphis TN; U.S.A. ATP World Tour,HARD,2,Patrick McEnroe,N/A Bye,Patrick McEnroe,,R64,0,0,0,0,0,0,0,0,0,0,0,0,0,0,0,0,0,0,0,0,0,0,0,0,0,0,0
1995-02-13 00:00:00.000,Memphis TN; U.S.A. ATP World Tour,HARD,2,Greg Rusedski,Murphy Jensen,Greg Rusedski,6-1; 6-3,R64,45,9,3,24,41,23,24,9,17,2,3,8,32,41,0,5,20,46,10,20,10,26,1,6,8,20,46
1995-02-13 00:00:00.000,Memphis TN; U.S.A. ATP World Tour,HARD,2,Brad Gilbert,Louis Gloria,Brad Gilbert,1-6; 6-4; 6-4,R64,115,4,9,33,93,25,33,26,60,3,8,14,51,93,2,1,42,72,30,42,12,30,3,7,13,42,72
1995-02-13 00:00:00.000,Memphis TN; U.S.A. ATP World Tour,HARD,2,Aaron Krickstein,N/A Bye,Aaron Krickstein,,R64,0,0,0,0,0,0,0,0,0,0,0,0,0,0,0,0,0,0,0,0,0,0,0,0,0,0,0
1995-02-13 00:00:00.000,Memphis TN; U.S.A. ATP World Tour,HARD,2,Jaime Yzaga,N/A Bye,Jaime Yzaga,,R64,0,0,0,0,0,0,0,0,0,0,0,0,0,0,0,0,0,0,0,0,0,0,0,0,0,0,0
1995-02-13 00:00:00.000,Memphis TN; U.S.A. ATP World Tour,HARD,2,Brian Dunn,Kenny Thorne,Brian Dunn,7-6(2); 6-7(5); 6-4,R64,144,11,7,68,118,55,68,25,50,7,9,17,80,118,5,5,76,110,55,76,16,34,4,7,17,71,110
1995-02-13 00:00:00.000,Memphis TN; U.S.A. ATP World Tour,HARD,2,Marc-Kevin Goellner,Guillaume Raoux,Marc-Kevin Goellner,1-6; 6-2; 6-4,R64,97,19,10,46,97,37,46,19,51,4,7,12,56,97,11,1,43,90,33,43,19,47,9,13,13,52,90
1995-02-13 00:00:00.000,Memphis TN; U.S.A. ATP World Tour,HARD,2,Paul Haarhuis,N/A Bye,Paul Haarhuis,,R64,0,0,0,0,0,0,0,0,0,0,0,0,0,0,0,0,0,0,0,0,0,0,0,0,0,0,0
1995-02-13 00:00:00.000,Memphis TN; U.S.A. ATP World Tour,HARD,2,Arnaud Boetsch,N/A Bye,Arnaud Boetsch,,R64,0,0,0,0,0,0,0,0,0,0,0,0,0,0,0,0,0,0,0,0,0,0,0,0,0,0,0
1995-02-13 00:00:00.000,Memphis TN; U.S.A. ATP World Tour,HARD,2,Bryan Shelton,Nicklas Kulti,Bryan Shelton,4-6; 6-3; 6-4,R64,107,13,3,55,84,44,55,16,29,3,4,15,60,84,11,7,49,89,38,49,19,40,3,5,14,57,89
1995-02-13 00:00:00.000,Memphis TN; U.S.A. ATP World Tour,HARD,2,Lars Rehmann,David Rikl,Lars Rehmann,2-6; 6-4; 6-4,R64,89,5,1,49,78,39,49,12,29,4,7,14,51,78,11,5,34,70,28,34,20,36,1,4,14,48,70
1995-02-13 00:00:00.000,Memphis TN; U.S.A. ATP World Tour,HARD,2,Jacco Eltingh,N/A Bye,Jacco Eltingh,,R64,0,0,0,0,0,0,0,0,0,0,0,0,0,0,0,0,0,0,0,0,0,0,0,0,0,0,0
1995-02-13 00:00:00.000,Memphis TN; U.S.A. ATP World Tour,HARD,2,MaliVai Washington,N/A Bye,MaliVai Washington,,R64,0,0,0,0,0,0,0,0,0,0,0,0,0,0,0,0,0,0,0,0,0,0,0,0,0,0,0
1995-02-13 00:00:00.000,Memphis TN; U.S.A. ATP World Tour,HARD,2,Jonathan Stark,Alex O'Brien,Jonathan Stark,6-4; 6-7(5); 6-1,R64,124,23,9,67,112,59,67,17,45,3,3,15,76,112,10,2,68,107,46,68,19,39,10,13,14,65,107
1995-02-13 00:00:00.000,Memphis TN; U.S.A. ATP World Tour,HARD,2,Jim Grabb,Mark Petchey,Jim Grabb,7-6(3); 6-3,R64,101,3,4,52,85,39,52,17,33,5,6,11,56,85,1,4,52,73,34,52,9,21,8,10,10,43,73
1995-02-13 00:00:00.000,Memphis TN; U.S.A. ATP World Tour,HARD,2,Jared Palmer,N/A Bye,Jared Palmer,,R64,0,0,0,0,0,0,0,0,0,0,0,0,0,0,0,0,0,0,0,0,0,0,0,0,0,0,0
1995-02-13 00:00:00.000,Memphis TN; U.S.A. ATP World Tour,HARD,2,Vincent Spadea,N/A Bye,Vincent Spadea,,R64,0,0,0,0,0,0,0,0,0,0,0,0,0,0,0,0,0,0,0,0,0,0,0,0,0,0,0
1995-02-13 00:00:00.000,Memphis TN; U.S.A. ATP World Tour,HARD,2,Michael Tebbutt,Fernando Meligeni,Michael Tebbutt,4-6; 6-3; 6-3,R64,106,21,5,45,85,36,45,22,40,5,7,14,58,85,3,1,61,98,39,61,17,37,7,11,14,56,98
1995-02-13 00:00:00.000,Memphis TN; U.S.A. ATP World Tour,HARD,2,Luke Jensen,Michael Joyce,Luke Jensen,6-4; 7-5,R64,72,5,1,33,62,26,33,17,29,1,2,11,43,62,4,2,35,58,24,35,13,23,1,4,11,37,58
1995-02-13 00:00:00.000,Memphis TN; U.S.A. ATP World Tour,HARD,2,Michael Chang,N/A Bye,Michael Chang,,R64,0,0,0,0,0,0,0,0,0,0,0,0,0,0,0,0,0,0,0,0,0,0,0,0,0,0,0
1995-02-13 00:00:00.000,Memphis TN; U.S.A. ATP World Tour,HARD,2,Pete Sampras,Grant Doyle,Pete Sampras,6-1; 6-0,R32,46,7,1,26,35,24,26,4,9,0,0,7,28,35,1,5,21,41,10,21,5,20,3,8,6,15,41
1995-02-13 00:00:00.000,Memphis TN; U.S.A. ATP World Tour,HARD,2,Marcelo Filippini,Marcelo Rios,Marcelo Filippini,6-4; 6-1,R32,62,3,2,19,47,15,19,18,28,4,5,8,33,47,0,5,40,71,25,40,9,31,3,8,9,34,71
1995-02-13 00:00:00.000,Memphis TN; U.S.A. ATP World Tour,HARD,2,Thomas Enqvist,Anders Jarryd,Thomas Enqvist,6-3; 6-1,R32,58,2,3,19,41,15,19,15,22,1,2,8,30,41,2,4,28,52,13,28,10,24,3,8,8,23,52
1995-02-13 00:00:00.000,Memphis TN; U.S.A. ATP World Tour,HARD,2,Brett Steven,Andrei Chesnokov,Brett Steven,4-6; 7-6(1); 6-2,R32,117,9,2,61,91,46,61,17,30,6,8,15,63,91,8,3,54,105,38,54,25,51,6,9,15,63,105
1995-02-13 00:00:00.000,Memphis TN; U.S.A. ATP World Tour,HARD,2,Todd Martin,Alexander Mronz,Todd Martin,7-5; 6-4,R32,72,9,2,36,62,30,36,16,26,2,2,11,46,62,9,1,36,57,28,36,11,21,2,4,11,39,57
1995-02-13 00:00:00.000,Memphis TN; U.S.A. ATP World Tour,HARD,2,Richey Reneberg,Jamie Morgan,Richey Reneberg,6-4; 6-1,R32,65,5,2,18,46,16,18,20,28,5,5,8,36,46,5,3,27,59,18,27,14,32,3,7,9,32,59
1995-02-13 00:00:00.000,Memphis TN; U.S.A. ATP World Tour,HARD,2,Greg Rusedski,Patrick McEnroe,Greg Rusedski,7-6(4); 7-6(4),R32,107,16,7,48,81,39,48,13,33,2,5,12,52,81,1,5,57,95,40,57,15,38,1,4,12,55,95
1995-02-13 00:00:00.000,Memphis TN; U.S.A. ATP World Tour,HARD,2,Aaron Krickstein,Brad Gilbert,Aaron Krickstein,6-1; 7-6(4),R32,88,5,1,35,64,27,35,15,29,0,1,10,42,64,8,6,34,74,28,34,13,40,10,13,9,41,74
1995-02-13 00:00:00.000,Memphis TN; U.S.A. ATP World Tour,HARD,2,Jaime Yzaga,Brian Dunn,Jaime Yzaga,6-4; 6-3,R32,75,0,3,37,58,28,37,13,21,1,1,9,41,58,6,5,33,69,28,33,11,36,3,6,10,39,69
1995-02-13 00:00:00.000,Memphis TN; U.S.A. ATP World Tour,HARD,2,Paul Haarhuis,Marc-Kevin Goellner,Paul Haarhuis,6-4; 6-4,R32,65,7,1,28,59,25,28,17,31,5,6,10,42,59,3,3,24,53,16,24,16,29,0,3,10,32,53
1995-02-13 00:00:00.000,Memphis TN; U.S.A. ATP World Tour,HARD,2,Arnaud Boetsch,Bryan Shelton,Arnaud Boetsch,W/O,R32,1,0,0,0,0,0,0,0,0,0,0,0,0,0,0,0,0,0,0,0,0,0,0,0,1,0,0
1995-02-13 00:00:00.000,Memphis TN; U.S.A. ATP World Tour,HARD,2,Lars Rehmann,Jacco Eltingh,Lars Rehmann,7-6(2); 4-6; 6-2,R32,108,7,2,59,86,48,59,14,27,1,3,15,62,86,13,6,59,101,45,59,20,42,5,8,15,65,101
1995-02-13 00:00:00.000,Memphis TN; U.S.A. ATP World Tour,HARD,2,Jonathan Stark,MaliVai Washington,Jonathan Stark,6-4; 3-6; 6-2,R32,108,10,4,47,84,40,47,17,37,1,2,13,57,84,7,4,57,88,37,57,17,31,7,10,14,54,88
1995-02-13 00:00:00.000,Memphis TN; U.S.A. ATP World Tour,HARD,2,Jared Palmer,Jim Grabb,Jared Palmer,6-7(7); 6-3; 6-3,R32,120,7,10,53,95,41,53,22,42,5,7,15,63,95,10,5,60,91,41,60,14,31,2,7,15,55,91
1995-02-13 00:00:00.000,Memphis TN; U.S.A. ATP World Tour,HARD,2,Vincent Spadea,Michael Tebbutt,Vincent Spadea,6-3; 6-4,R32,66,1,1,29,47,26,29,14,18,0,0,10,40,47,4,4,26,58,20,26,15,32,7,9,9,35,58
1995-02-13 00:00:00.000,Memphis TN; U.S.A. ATP World Tour,HARD,2,Michael Chang,Luke Jensen,Michael Chang,7-6(4); 7-5,R32,103,7,4,35,73,27,35,17,38,3,6,12,44,73,10,3,45,96,35,45,17,51,2,6,12,52,96
1995-02-13 00:00:00.000,Memphis TN; U.S.A. ATP World Tour,HARD,2,Pete Sampras,Marcelo Filippini,Pete Sampras,6-2; 6-2,R16,60,4,1,26,44,22,26,12,18,2,2,8,34,44,3,2,18,49,14,18,10,31,4,8,8,24,49
1995-02-13 00:00:00.000,Memphis TN; U.S.A. ATP World Tour,HARD,2,Thomas Enqvist,Brett Steven,Thomas Enqvist,6-4; 6-1,R16,54,3,0,22,38,20,22,12,16,0,0,8,32,38,3,1,31,53,16,31,11,22,2,6,9,27,53
1995-02-13 00:00:00.000,Memphis TN; U.S.A. ATP World Tour,HARD,2,Todd Martin,Richey Reneberg,Todd Martin,6-1; 6-4,R16,66,11,3,31,52,27,31,11,21,1,1,9,38,52,4,2,32,60,19,32,14,28,3,6,8,33,60
1995-02-13 00:00:00.000,Memphis TN; U.S.A. ATP World Tour,HARD,2,Greg Rusedski,Aaron Krickstein,Greg Rusedski,6-4; 7-6(4),R16,91,17,3,36,80,27,36,26,44,2,3,11,53,80,2,2,49,78,33,49,16,29,5,7,11,49,78
1995-02-13 00:00:00.000,Memphis TN; U.S.A. ATP World Tour,HARD,2,Paul Haarhuis,Jaime Yzaga,Paul Haarhuis,6-4; 3-6; 6-3,R16,129,6,0,52,95,34,52,24,43,2,5,14,58,95,0,3,54,99,34,54,23,45,6,10,14,57,99
1995-02-13 00:00:00.000,Memphis TN; U.S.A. ATP World Tour,HARD,2,Arnaud Boetsch,Lars Rehmann,Arnaud Boetsch,2-6; 7-6(6); 7-5,R16,115,9,5,54,97,42,54,18,43,2,6,16,60,97,1,5,71,103,52,71,13,32,9,12,16,65,103
1995-02-13 00:00:00.000,Memphis TN; U.S.A. ATP World Tour,HARD,2,Jonathan Stark,Jared Palmer,Jonathan Stark,6-4; 7-6(5),R16,91,6,3,42,73,29,42,14,31,6,10,11,43,73,5,9,48,80,33,48,9,32,8,13,11,42,80
1995-02-13 00:00:00.000,Memphis TN; U.S.A. ATP World Tour,HARD,2,Michael Chang,Vincent Spadea,Michael Chang,2-6; 6-1; 6-4,R16,99,6,3,43,82,30,43,21,39,9,12,13,51,82,2,2,40,73,26,40,16,33,3,7,12,42,73
1995-02-13 00:00:00.000,Memphis TN; U.S.A. ATP World Tour,HARD,2,Pete Sampras,Thomas Enqvist,Pete Sampras,7-5; 3-6; 6-3,Q,106,14,2,50,90,38,50,22,40,5,7,15,60,90,10,3,50,92,39,50,20,42,5,8,15,59,92
1995-02-13 00:00:00.000,Memphis TN; U.S.A. ATP World Tour,HARD,2,Todd Martin,Greg Rusedski,Todd Martin,6-7(8); 7-5; 6-4,Q,146,13,6,68,108,57,68,18,40,1,3,17,75,108,19,11,61,120,46,61,29,59,10,14,17,75,120
1995-02-13 00:00:00.000,Memphis TN; U.S.A. ATP World Tour,HARD,2,Paul Haarhuis,Arnaud Boetsch,Paul Haarhuis,6-2; 6-3,Q,54,1,0,31,44,22,31,12,13,1,1,8,34,44,3,0,25,47,13,25,10,22,0,4,9,23,47
1995-02-13 00:00:00.000,Memphis TN; U.S.A. ATP World Tour,HARD,2,Jonathan Stark,Michael Chang,Jonathan Stark,4-6; 6-3; 6-4,Q,101,17,2,56,93,46,56,20,37,8,9,15,66,93,13,5,44,71,36,44,15,27,0,2,14,51,71
1995-02-13 00:00:00.000,Memphis TN; U.S.A. ATP World Tour,HARD,2,Todd Martin,Pete Sampras,Todd Martin,4-6; 7-6(6); 6-4,S,136,15,3,70,117,53,70,24,47,8,10,16,77,117,17,6,64,110,52,64,20,46,6,8,16,72,110
1995-02-13 00:00:00.000,Memphis TN; U.S.A. ATP World Tour,HARD,2,Paul Haarhuis,Jonathan Stark,Paul Haarhuis,6-4; 7-5,S,89,4,0,50,72,39,50,12,22,4,4,11,51,72,6,3,35,70,25,35,19,35,7,9,11,44,70
1995-02-13 00:00:00.000,Memphis TN; U.S.A. ATP World Tour,HARD,2,Todd Martin,Paul Haarhuis,Todd Martin,7-6(2); 6-4,F,98,16,2,50,85,43,50,14,35,4,5,11,57,85,4,1,49,66,33,49,10,17,5,7,11,43,66
1995-02-13 00:00:00.000,Milan Italy ATP World Tour,HARD,2,Boris Becker,Lorenzo Manta,Boris Becker,6-3; 7-6(5),R32,73,8,4,34,57,31,34,16,23,1,1,10,47,57,5,6,40,70,30,40,17,30,4,6,11,47,70
1995-02-13 00:00:00.000,Milan Italy ATP World Tour,HARD,2,Ronald Agenor,Fabrice Santoro,Ronald Agenor,6-1; 7-6(5),R32,99,5,0,51,79,32,51,16,28,6,8,10,48,79,1,1,41,68,24,41,12,27,6,10,9,36,68
1995-02-13 00:00:00.000,Milan Italy ATP World Tour,HARD,2,Guy Forget,Francisco Clavet,Guy Forget,6-4; 7-5,R32,93,11,1,37,77,28,37,20,40,8,9,11,48,77,3,1,42,63,26,42,14,21,3,6,11,40,63
1995-02-13 00:00:00.000,Milan Italy ATP World Tour,HARD,2,Alexander Volkov,Jason Stoltenberg,Alexander Volkov,6-2; 7-5,R32,75,6,5,34,68,25,34,20,34,4,5,10,45,68,2,4,42,60,29,42,5,18,3,7,10,34,60
1995-02-13 00:00:00.000,Milan Italy ATP World Tour,HARD,2,Alberto Berasategui,David Wheaton,Alberto Berasategui,7-6(12); 3-6; 6-4,R32,135,5,5,73,103,53,73,17,30,6,9,16,70,103,12,3,74,105,51,74,19,31,2,4,15,70,105
1995-02-13 00:00:00.000,Milan Italy ATP World Tour,HARD,2,Slava Dosedel,Albert Costa,Slava Dosedel,6-4; 7-5,R32,83,6,2,37,69,28,37,17,32,5,7,11,45,69,1,5,52,91,30,52,18,39,14,18,11,48,91
1995-02-13 00:00:00.000,Milan Italy ATP World Tour,HARD,2,Tomas Carbonell,Markus Zoecke,Tomas Carbonell,7-5; 6-3,R32,75,6,1,33,52,26,33,14,19,0,0,10,40,52,12,2,50,74,32,50,11,24,4,7,11,43,74
1995-02-13 00:00:00.000,Milan Italy ATP World Tour,HARD,2,Petr Korda,Hendrik Jan Davids,Petr Korda,6-7(3); 6-2; 6-3,R32,114,4,6,45,90,36,45,27,45,6,7,14,63,90,4,2,62,99,48,62,11,37,8,13,15,59,99
1995-02-13 00:00:00.000,Milan Italy ATP World Tour,HARD,2,Yevgeny Kafelnikov,Karel Novacek,Yevgeny Kafelnikov,6-4; 6-2,R32,62,11,2,32,57,28,32,11,25,3,4,9,39,57,3,3,25,59,16,25,17,34,6,10,9,33,59
1995-02-13 00:00:00.000,Milan Italy ATP World Tour,HARD,2,Karol Kucera,Omar Camporese,Karol Kucera,7-5; 4-6; 6-3,R32,121,7,3,47,98,35,47,26,51,6,9,16,61,98,9,0,58,103,40,58,19,45,6,10,15,59,103
1995-02-13 00:00:00.000,Milan Italy ATP World Tour,HARD,2,Karsten Braasch,Stefano Pescosolido,Karsten Braasch,7-6(4); 6-1,R32,84,13,1,49,70,42,49,8,21,4,4,10,50,70,6,3,33,65,23,33,19,32,4,6,9,42,65
1995-02-13 00:00:00.000,Milan Italy ATP World Tour,HARD,2,Michael Stich,Gianluca Pozzi,Michael Stich,6-1; 7-5,R32,68,10,6,38,67,36,38,11,29,1,1,10,47,67,1,0,30,51,19,30,11,21,4,7,9,30,51
1995-02-13 00:00:00.000,Milan Italy ATP World Tour,HARD,2,Olivier Delaitre,Alex Corretja,Olivier Delaitre,6-3; 4-6; 6-1,R32,104,6,2,48,95,36,48,25,47,8,9,13,61,95,5,4,51,83,34,51,15,32,4,8,13,49,83
1995-02-13 00:00:00.000,Milan Italy ATP World Tour,HARD,2,Renzo Furlan,Radomir Vasek,Renzo Furlan,7-6(3); 6-2,R32,91,10,1,40,67,33,40,11,27,4,5,10,44,67,6,8,29,66,22,29,15,37,1,4,10,37,66
1995-02-13 00:00:00.000,Milan Italy ATP World Tour,HARD,2,Cedric Pioline,Javier Sanchez,Cedric Pioline,6-4; 6-3,R32,71,9,3,30,50,25,30,13,20,0,1,10,38,50,1,2,49,70,28,49,10,21,11,14,9,38,70
1995-02-13 00:00:00.000,Milan Italy ATP World Tour,HARD,2,Goran Ivanisevic,Daniel Vacek,Goran Ivanisevic,7-6(4); 7-6(5),R32,85,19,4,44,80,40,44,24,36,4,4,12,64,80,14,3,58,81,45,58,16,23,6,6,12,61,81
1995-02-13 00:00:00.000,Milan Italy ATP World Tour,HARD,2,Boris Becker,Ronald Agenor,Boris Becker,6-4; 6-4,R16,73,16,3,32,55,28,32,14,23,2,2,10,42,55,2,1,34,57,21,34,17,23,5,7,10,38,57
1995-02-13 00:00:00.000,Milan Italy ATP World Tour,HARD,2,Guy Forget,Alexander Volkov,Guy Forget,4-6; 7-6(3); 6-4,R16,127,15,2,56,101,46,56,23,45,6,8,16,69,101,15,3,53,106,38,53,30,53,5,7,16,68,106
1995-02-13 00:00:00.000,Milan Italy ATP World Tour,HARD,2,Slava Dosedel,Alberto Berasategui,Slava Dosedel,6-7(4); 6-2; 6-4,R16,114,10,5,50,106,41,50,30,56,5,5,15,71,106,3,2,70,100,48,70,18,30,7,10,15,66,100
1995-02-13 00:00:00.000,Milan Italy ATP World Tour,HARD,2,Petr Korda,Tomas Carbonell,Petr Korda,7-6(7); 6-3,R16,83,10,4,40,66,33,40,13,26,2,2,10,46,66,5,4,42,80,31,42,17,38,5,7,11,48,80
1995-02-13 00:00:00.000,Milan Italy ATP World Tour,HARD,2,Yevgeny Kafelnikov,Karol Kucera,Yevgeny Kafelnikov,W/O,R16,0,0,0,0,0,0,0,0,0,0,0,0,0,0,0,0,0,0,0,0,0,0,0,0,0,0,0
1995-02-13 00:00:00.000,Milan Italy ATP World Tour,HARD,2,Michael Stich,Karsten Braasch,Michael Stich,6-3; 7-6(3),R16,89,6,3,37,67,31,37,19,30,0,0,11,50,67,4,0,53,80,37,53,13,27,6,7,10,50,80
1995-02-13 00:00:00.000,Milan Italy ATP World Tour,HARD,2,Olivier Delaitre,Renzo Furlan,Olivier Delaitre,7-6(5); 6-2,R16,94,6,0,41,76,33,41,17,35,5,6,10,50,76,7,4,35,72,24,35,16,37,3,6,10,40,72
1995-02-13 00:00:00.000,Milan Italy ATP World Tour,HARD,2,Goran Ivanisevic,Cedric Pioline,Goran Ivanisevic,7-6(11); 6-4,R16,109,17,3,41,88,35,41,26,47,9,9,11,61,88,4,1,46,82,35,46,20,36,1,2,11,55,82
1995-02-13 00:00:00.000,Milan Italy ATP World Tour,HARD,2,Boris Becker,Guy Forget,Boris Becker,7-5; 6-2,Q,71,13,3,33,54,32,33,10,21,0,0,10,42,54,10,3,43,61,31,43,6,18,8,11,10,37,61
1995-02-13 00:00:00.000,Milan Italy ATP World Tour,HARD,2,Petr Korda,Slava Dosedel,Petr Korda,6-4; 6-3,Q,72,9,7,36,72,32,36,14,36,11,12,9,46,72,6,2,31,60,20,31,15,29,6,10,10,35,60
1995-02-13 00:00:00.000,Milan Italy ATP World Tour,HARD,2,Yevgeny Kafelnikov,Michael Stich,Yevgeny Kafelnikov,7-6(4); 4-6; 6-0,Q,99,8,5,48,87,36,48,25,39,3,4,14,61,87,8,6,48,87,38,48,18,39,4,7,14,56,87
1995-02-13 00:00:00.000,Milan Italy ATP World Tour,HARD,2,Goran Ivanisevic,Olivier Delaitre,Goran Ivanisevic,6-3; 6-3,Q,47,17,2,31,45,29,31,8,14,1,1,9,37,45,2,3,37,50,22,37,6,13,2,5,9,28,50
1995-02-13 00:00:00.000,Milan Italy ATP World Tour,HARD,2,Boris Becker,Petr Korda,Boris Becker,7-6(3); 6-7(3); 6-2,S,160,18,7,74,127,60,74,22,53,6,7,16,82,127,9,7,55,112,42,55,30,57,4,7,16,72,112
1995-02-13 00:00:00.000,Milan Italy ATP World Tour,HARD,2,Yevgeny Kafelnikov,Goran Ivanisevic,Yevgeny Kafelnikov,7-5; 6-7(4); 6-4,S,101,12,10,54,109,47,54,33,55,1,1,17,80,109,32,3,61,97,52,61,19,36,2,4,17,71,97
1995-02-13 00:00:00.000,Milan Italy ATP World Tour,HARD,2,Yevgeny Kafelnikov,Boris Becker,Yevgeny Kafelnikov,7-5; 5-7; 7-6(6),F,136,3,4,65,111,50,65,26,46,4,7,18,76,111,25,10,70,110,55,70,18,40,5,8,18,73,110
1995-02-20 00:00:00.000,Philadelphia PA; U.S.A. ATP World Tour,HARD,2,Pete Sampras,Marcelo Filippini,Pete Sampras,4-6; 6-4; 7-5,R32,128,10,2,50,100,34,50,29,50,5,9,16,63,100,9,2,41,101,28,41,32,60,6,11,16,60,101
1995-02-20 00:00:00.000,Philadelphia PA; U.S.A. ATP World Tour,HARD,2,Paul Haarhuis,MaliVai Washington,Paul Haarhuis,3-6; 6-4; 7-5,R32,117,7,2,60,103,43,60,19,43,6,11,16,62,103,6,4,41,81,32,41,17,40,3,8,15,49,81
1995-02-20 00:00:00.000,Philadelphia PA; U.S.A. ATP World Tour,HARD,2,Brett Steven,Fabrice Santoro,Brett Steven,5-7; 6-1; 7-6(4),R32,132,3,0,71,98,50,71,15,27,4,8,16,65,98,2,4,59,104,39,59,22,45,5,10,15,61,104
1995-02-20 00:00:00.000,Philadelphia PA; U.S.A. ATP World Tour,HARD,2,Mark Woodforde,Marco Cacopardo,Mark Woodforde,6-3; 6-3,R32,65,2,2,28,46,24,28,13,18,0,0,9,37,46,10,5,34,63,23,34,12,29,8,11,9,35,63
1995-02-20 00:00:00.000,Philadelphia PA; U.S.A. ATP World Tour,HARD,2,Michael Chang,Richard Fromberg,Michael Chang,6-3; 7-6(5),R32,92,6,0,32,73,28,32,22,41,4,5,11,50,73,8,5,38,73,30,38,15,35,6,8,10,45,73
1995-02-20 00:00:00.000,Philadelphia PA; U.S.A. ATP World Tour,HARD,2,Jim Grabb,Jonas Bjorkman,Jim Grabb,6-1; 6-4,R32,65,5,2,42,58,33,42,9,16,4,4,9,42,58,3,2,27,47,19,27,8,20,3,6,8,27,47
1995-02-20 00:00:00.000,Philadelphia PA; U.S.A. ATP World Tour,HARD,2,Jonathan Stark,David Dilucia,Jonathan Stark,6-4; 6-4,R32,91,3,0,34,59,26,34,14,25,0,1,10,40,59,1,6,47,83,31,47,15,36,10,13,10,46,83
1995-02-20 00:00:00.000,Philadelphia PA; U.S.A. ATP World Tour,HARD,2,Patrick Rafter,Vincent Spadea,Patrick Rafter,3-6; 7-6(1); 6-2,R32,127,8,4,62,96,45,62,16,34,4,7,14,61,96,2,6,64,113,38,64,26,49,10,14,15,64,113
1995-02-20 00:00:00.000,Philadelphia PA; U.S.A. ATP World Tour,HARD,2,Thomas Enqvist,Jaime Yzaga,Thomas Enqvist,2-6; 7-6(6); 7-5,R32,130,17,4,60,113,42,60,21,53,8,14,16,63,113,2,2,49,93,31,49,26,44,4,9,16,57,93
1995-02-20 00:00:00.000,Philadelphia PA; U.S.A. ATP World Tour,HARD,2,Luiz Mattar,Brad Gilbert,Luiz Mattar,6-0; 6-4,R32,63,3,0,34,45,26,34,8,11,2,2,8,34,45,1,2,27,56,19,27,11,29,1,5,8,30,56
1995-02-20 00:00:00.000,Philadelphia PA; U.S.A. ATP World Tour,HARD,2,Luke Jensen,Jared Palmer,Luke Jensen,6-2; 6-3,R32,58,5,0,26,42,23,26,13,16,0,0,9,36,42,2,5,34,56,21,34,9,22,5,8,8,30,56
1995-02-20 00:00:00.000,Philadelphia PA; U.S.A. ATP World Tour,HARD,2,Richey Reneberg,Jacco Eltingh,Richey Reneberg,6-4; 6-3,R32,67,9,2,22,56,16,22,21,34,4,6,10,37,56,1,1,35,59,22,35,11,24,8,12,9,33,59
1995-02-20 00:00:00.000,Philadelphia PA; U.S.A. ATP World Tour,HARD,2,Sebastien Lareau,Steve Bryan,Sebastien Lareau,6-4; 6-2,R32,63,5,4,31,51,26,31,10,20,2,3,9,36,51,4,3,39,57,20,39,10,18,4,8,9,30,57
1995-02-20 00:00:00.000,Philadelphia PA; U.S.A. ATP World Tour,HARD,2,Renzo Furlan,David Nainkin,Renzo Furlan,6-4; 6-3,R32,79,8,2,29,58,23,29,17,29,3,4,10,40,58,1,6,48,67,30,48,5,19,5,8,9,35,67
1995-02-20 00:00:00.000,Philadelphia PA; U.S.A. ATP World Tour,HARD,2,Jeff Tarango,Arnaud Boetsch,Jeff Tarango,6-7(3); 7-6(0); 6-2,R32,157,6,5,94,138,55,94,22,44,7,12,16,77,138,11,7,63,115,39,63,22,52,6,13,16,61,115
1995-02-20 00:00:00.000,Philadelphia PA; U.S.A. ATP World Tour,HARD,2,Andre Agassi,Jan Apell,Andre Agassi,6-4; 6-2,R32,51,6,1,24,46,19,24,17,22,0,0,9,36,46,2,2,30,54,24,30,7,24,2,5,9,31,54
1995-02-20 00:00:00.000,Philadelphia PA; U.S.A. ATP World Tour,HARD,2,Paul Haarhuis,Pete Sampras,Paul Haarhuis,6-4; 6-4,R16,71,9,1,44,62,32,44,9,18,2,3,10,41,62,6,1,34,66,26,34,14,32,4,7,10,40,66
1995-02-20 00:00:00.000,Philadelphia PA; U.S.A. ATP World Tour,HARD,2,Brett Steven,Mark Woodforde,Brett Steven,6-1; 6-4,R16,79,3,1,29,56,21,29,15,27,1,3,9,36,56,2,4,35,62,19,35,9,27,3,8,8,28,62
1995-02-20 00:00:00.000,Philadelphia PA; U.S.A. ATP World Tour,HARD,2,Michael Chang,Jim Grabb,Michael Chang,7-6(5); 7-5,R16,96,8,0,31,61,29,31,24,30,0,0,12,53,61,3,1,48,80,36,48,18,32,4,5,12,54,80
1995-02-20 00:00:00.000,Philadelphia PA; U.S.A. ATP World Tour,HARD,2,Jonathan Stark,Patrick Rafter,Jonathan Stark,6-3; 4-6; 6-2,R16,100,10,4,56,85,44,56,15,29,3,5,14,59,85,8,5,60,85,40,60,10,25,1,5,13,50,85
1995-02-20 00:00:00.000,Philadelphia PA; U.S.A. ATP World Tour,HARD,2,Thomas Enqvist,Luiz Mattar,Thomas Enqvist,6-3; 6-1,R16,60,7,6,24,39,23,24,7,15,0,1,8,30,39,1,0,32,59,17,32,11,27,5,10,8,28,59
1995-02-20 00:00:00.000,Philadelphia PA; U.S.A. ATP World Tour,HARD,2,Richey Reneberg,Luke Jensen,Richey Reneberg,7-5; 7-5,R16,92,6,1,39,73,27,39,24,34,1,2,12,51,73,5,5,38,75,23,38,23,37,4,7,12,46,75
1995-02-20 00:00:00.000,Philadelphia PA; U.S.A. ATP World Tour,HARD,2,Sebastien Lareau,Renzo Furlan,Sebastien Lareau,W/O,R16,0,0,0,0,0,0,0,0,0,0,0,0,0,0,0,0,0,0,0,0,0,0,0,0,0,0,0
1995-02-20 00:00:00.000,Philadelphia PA; U.S.A. ATP World Tour,HARD,2,Andre Agassi,Jeff Tarango,Andre Agassi,6-3; 6-4,R16,59,2,1,35,56,26,35,14,21,0,1,10,40,56,4,3,28,61,19,28,14,33,5,8,9,33,61
1995-02-20 00:00:00.000,Philadelphia PA; U.S.A. ATP World Tour,HARD,2,Paul Haarhuis,Brett Steven,Paul Haarhuis,6-2; 6-3,Q,62,1,0,28,46,23,28,10,18,2,2,8,33,46,2,3,30,52,20,30,8,22,2,6,9,28,52
1995-02-20 00:00:00.000,Philadelphia PA; U.S.A. ATP World Tour,HARD,2,Michael Chang,Jonathan Stark,Michael Chang,6-7(5); 6-1; 7-6(4),Q,132,8,5,47,101,40,47,33,54,3,5,16,73,101,11,5,65,103,47,65,15,38,2,6,15,62,103
1995-02-20 00:00:00.000,Philadelphia PA; U.S.A. ATP World Tour,HARD,2,Thomas Enqvist,Richey Reneberg,Thomas Enqvist,6-4; 6-3,Q,68,8,5,35,69,27,35,16,34,2,4,10,43,69,5,3,29,51,20,29,9,22,0,4,9,29,51
1995-02-20 00:00:00.000,Philadelphia PA; U.S.A. ATP World Tour,HARD,2,Andre Agassi,Sebastien Lareau,Andre Agassi,7-5; 6-2,Q,58,5,0,37,51,28,37,9,14,1,2,10,37,51,8,1,29,52,19,29,10,23,1,5,10,29,52
1995-02-20 00:00:00.000,Philadelphia PA; U.S.A. ATP World Tour,HARD,2,Michael Chang,Paul Haarhuis,Michael Chang,6-2; 6-0,S,51,4,0,18,38,15,18,13,20,0,0,7,28,38,0,0,28,40,12,28,4,12,4,9,7,16,40
1995-02-20 00:00:00.000,Philadelphia PA; U.S.A. ATP World Tour,HARD,2,Thomas Enqvist,Andre Agassi,Thomas Enqvist,7-6(5); 5-7; 6-2,S,129,18,7,62,117,41,62,26,55,6,11,16,67,117,9,1,68,102,45,68,16,34,8,14,16,61,102
1995-02-20 00:00:00.000,Philadelphia PA; U.S.A. ATP World Tour,HARD,2,Thomas Enqvist,Michael Chang,Thomas Enqvist,0-6; 6-4; 6-0,F,100,14,5,44,77,32,44,8,33,3,8,11,40,77,6,3,33,76,21,33,17,43,7,13,11,38,76
1995-02-20 00:00:00.000,Stuttgart Indoor Germany ATP World Tour,HARD,2,Boris Becker,Patrik Kuhnen,Boris Becker,6-3; 6-3,R32,67,12,3,24,54,21,24,17,30,1,1,9,38,54,10,2,26,49,20,26,7,23,2,5,9,27,49
1995-02-20 00:00:00.000,Stuttgart Indoor Germany ATP World Tour,HARD,2,Aaron Krickstein,Francisco Clavet,Aaron Krickstein,7-6(2); 6-1,R32,76,4,1,34,54,29,34,11,20,1,2,9,40,54,7,2,33,71,26,33,15,38,5,9,10,41,71
1995-02-20 00:00:00.000,Stuttgart Indoor Germany ATP World Tour,HARD,2,David Wheaton,Javier Sanchez,David Wheaton,6-4; 7-5,R32,68,7,0,47,58,36,47,8,11,3,4,11,44,58,3,1,44,64,30,44,8,20,4,7,11,38,64
1995-02-20 00:00:00.000,Stuttgart Indoor Germany ATP World Tour,HARD,2,Yevgeny Kafelnikov,Petr Korda,Yevgeny Kafelnikov,6-2; 6-1,R32,50,5,2,20,38,15,20,8,18,2,4,7,23,38,2,6,25,50,8,25,9,25,2,9,8,17,50
1995-02-20 00:00:00.000,Stuttgart Indoor Germany ATP World Tour,HARD,2,Alexander Volkov,Sergi Bruguera,Alexander Volkov,6-4; 2-3 RET,R32,67,5,1,26,59,22,26,16,33,7,7,8,38,59,2,2,25,45,20,25,11,20,3,4,8,31,45
1995-02-20 00:00:00.000,Stuttgart Indoor Germany ATP World Tour,HARD,2,Karel Novacek,Guy Forget,Karel Novacek,6-3; 7-5,R32,70,15,1,35,59,31,35,14,24,1,1,11,45,59,4,4,32,60,26,32,13,28,1,3,10,39,60
1995-02-20 00:00:00.000,Stuttgart Indoor Germany ATP World Tour,HARD,2,Daniel Vacek,Andrei Olhovskiy,Daniel Vacek,7-6(3); 6-2,R32,72,12,4,32,59,28,32,18,27,3,3,10,46,59,9,4,33,68,27,33,16,35,0,2,10,43,68
1995-02-20 00:00:00.000,Stuttgart Indoor Germany ATP World Tour,HARD,2,Michael Stich,Carlos Costa,Michael Stich,6-3; 6-4,R32,64,5,1,31,58,26,31,16,27,5,5,10,42,58,5,2,36,56,27,36,10,20,1,3,9,37,56
1995-02-20 00:00:00.000,Stuttgart Indoor Germany ATP World Tour,HARD,2,Jan Siemerink,Horst Skoff,Jan Siemerink,3-6; 6-4; 6-2,R32,99,10,5,48,86,37,48,22,38,7,9,14,59,86,3,3,60,92,37,60,17,32,6,9,13,54,92
1995-02-20 00:00:00.000,Stuttgart Indoor Germany ATP World Tour,HARD,2,Bernd Karbacher,Jason Stoltenberg,Bernd Karbacher,6-4; 6-1,R32,61,6,2,32,51,25,32,12,19,0,1,9,37,51,1,5,21,46,11,21,12,25,2,6,8,23,46
1995-02-20 00:00:00.000,Stuttgart Indoor Germany ATP World Tour,HARD,2,Martin Damm,Martin Sinner,Martin Damm,6-2; 6-2,R32,55,9,1,20,38,20,20,13,18,0,0,8,33,38,6,6,20,49,11,20,12,29,2,6,8,23,49
1995-02-20 00:00:00.000,Stuttgart Indoor Germany ATP World Tour,HARD,2,Alberto Berasategui,Olivier Delaitre,Alberto Berasategui,4-6; 6-3; 6-4,R32,98,5,7,60,95,43,60,19,35,5,7,15,62,95,9,2,48,84,36,48,16,36,1,4,14,52,84
1995-02-20 00:00:00.000,Stuttgart Indoor Germany ATP World Tour,HARD,2,Wayne Ferreira,Hendrik Dreekmann,Wayne Ferreira,2-6; 6-4; 6-3,R32,105,14,6,45,91,34,45,19,46,11,15,13,53,91,3,8,35,90,28,35,24,55,3,8,14,52,90
1995-02-20 00:00:00.000,Stuttgart Indoor Germany ATP World Tour,HARD,2,Richard Krajicek,Slava Dosedel,Richard Krajicek,6-4; 2-6; 6-2,R32,99,15,3,40,73,32,40,18,33,5,7,13,50,73,6,11,33,105,26,33,35,72,8,11,13,61,105
1995-02-20 00:00:00.000,Stuttgart Indoor Germany ATP World Tour,HARD,2,Thomas Muster,Andrea Gaudenzi,Thomas Muster,6-2; 5-1 RET,R32,48,5,0,28,46,21,28,12,18,5,5,8,33,46,1,2,24,41,13,24,7,17,3,7,7,20,41
1995-02-20 00:00:00.000,Stuttgart Indoor Germany ATP World Tour,HARD,2,Magnus Larsson,Goran Ivanisevic,Magnus Larsson,4-0 RET,R32,25,4,1,10,13,9,10,1,3,2,2,3,10,13,0,2,4,13,2,4,2,9,0,2,2,4,13
1995-02-20 00:00:00.000,Stuttgart Indoor Germany ATP World Tour,HARD,2,Boris Becker,Aaron Krickstein,Boris Becker,6-3; 6-3,R16,68,13,4,23,45,21,23,13,22,0,1,9,34,45,6,2,32,64,19,32,13,32,5,9,9,32,64
1995-02-20 00:00:00.000,Stuttgart Indoor Germany ATP World Tour,HARD,2,Yevgeny Kafelnikov,David Wheaton,Yevgeny Kafelnikov,7-5; 4-6; 6-4,R16,0,0,0,0,0,0,0,0,0,0,0,0,0,0,0,0,0,0,0,0,0,0,0,0,0,0,0
1995-02-20 00:00:00.000,Stuttgart Indoor Germany ATP World Tour,HARD,2,Alexander Volkov,Karel Novacek,Alexander Volkov,3-6; 6-3; 6-0,R16,88,6,2,40,73,32,40,18,33,5,6,12,50,73,11,2,43,77,28,43,17,34,7,11,12,45,77
1995-02-20 00:00:00.000,Stuttgart Indoor Germany ATP World Tour,HARD,2,Michael Stich,Daniel Vacek,Michael Stich,6-3; 6-4,R16,62,17,4,36,51,33,36,7,15,0,0,10,40,51,3,2,37,59,27,37,10,22,4,6,9,37,59
1995-02-20 00:00:00.000,Stuttgart Indoor Germany ATP World Tour,HARD,2,Jan Siemerink,Bernd Karbacher,Jan Siemerink,7-5; 6-2,R16,73,3,1,33,52,28,33,13,19,1,1,10,41,52,3,2,30,66,20,30,20,36,4,7,10,40,66
1995-02-20 00:00:00.000,Stuttgart Indoor Germany ATP World Tour,HARD,2,Martin Damm,Alberto Berasategui,Martin Damm,6-4; 6-4,R16,64,13,1,36,52,31,36,10,16,0,0,10,41,52,2,2,48,69,34,48,9,21,4,6,10,43,69
1995-02-20 00:00:00.000,Stuttgart Indoor Germany ATP World Tour,HARD,2,Richard Krajicek,Wayne Ferreira,Richard Krajicek,6-3; 7-6(0),R16,76,13,5,39,71,37,39,15,32,6,6,11,52,71,1,2,31,59,25,31,14,28,3,4,10,39,59
1995-02-20 00:00:00.000,Stuttgart Indoor Germany ATP World Tour,HARD,2,Magnus Larsson,Thomas Muster,Magnus Larsson,7-5; 5-7; 6-4,R16,123,16,9,72,113,54,72,19,41,4,6,17,73,113,6,3,68,115,41,68,29,47,9,12,17,70,115
1995-02-20 00:00:00.000,Stuttgart Indoor Germany ATP World Tour,HARD,2,Boris Becker,Yevgeny Kafelnikov,Boris Becker,7-6(4); 7-6(1),Q,105,16,2,37,69,32,37,21,32,1,2,12,53,69,7,6,44,93,35,44,24,49,6,7,12,59,93
1995-02-20 00:00:00.000,Stuttgart Indoor Germany ATP World Tour,HARD,2,Michael Stich,Alexander Volkov,Michael Stich,6-2; 7-5,Q,73,12,7,28,61,24,28,15,33,4,6,10,39,61,3,1,15,53,12,15,15,38,4,9,10,27,53
1995-02-20 00:00:00.000,Stuttgart Indoor Germany ATP World Tour,HARD,2,Martin Damm,Jan Siemerink,Martin Damm,6-4; 6-4,Q,68,6,2,32,59,24,32,16,27,1,2,10,40,59,7,4,30,53,23,30,11,23,1,4,10,34,53
1995-02-20 00:00:00.000,Stuttgart Indoor Germany ATP World Tour,HARD,2,Richard Krajicek,Magnus Larsson,Richard Krajicek,6-3; 6-7(9); 7-6(5),Q,114,29,4,61,105,56,61,26,44,0,0,17,82,105,6,2,72,113,57,72,25,41,4,5,16,82,113
1995-02-20 00:00:00.000,Stuttgart Indoor Germany ATP World Tour,HARD,2,Michael Stich,Boris Becker,Michael Stich,6-0; 6-3,S,64,9,4,24,54,24,24,14,30,6,6,8,38,54,2,6,22,44,15,22,6,22,3,7,7,21,44
1995-02-20 00:00:00.000,Stuttgart Indoor Germany ATP World Tour,HARD,2,Richard Krajicek,Martin Damm,Richard Krajicek,6-2; 6-3,S,53,12,0,24,45,20,24,17,21,1,1,9,37,45,3,2,29,47,20,29,7,18,1,4,8,27,47
1995-02-20 00:00:00.000,Stuttgart Indoor Germany ATP World Tour,HARD,2,Richard Krajicek,Michael Stich,Richard Krajicek,7-6(4); 6-3; 6-7(6); 1-6; 6-3,F,182,23,12,84,155,72,84,30,71,3,8,25,102,155,12,13,96,169,75,96,31,73,5,10,24,106,169
1995-02-27 00:00:00.000,Mexico City Mexico ATP World Tour,CLAY,2,Alberto Berasategui,David Rikl,Alberto Berasategui,7-6(1); 6-4,R32,77,3,4,45,83,34,45,21,38,4,5,11,55,83,3,6,33,66,23,33,21,33,1,3,11,44,66
1995-02-27 00:00:00.000,Mexico City Mexico ATP World Tour,CLAY,2,Mark Petchey,Gerard Solves,Mark Petchey,6-3; 4-6; 6-3,R32,123,4,12,51,107,36,51,31,56,8,10,14,67,107,6,3,54,92,35,54,19,38,10,14,14,54,92
1995-02-27 00:00:00.000,Mexico City Mexico ATP World Tour,CLAY,2,Fernando Meligeni,Mario Rincon,Fernando Meligeni,6-3; 6-3,R32,80,4,1,43,51,31,43,4,8,3,5,9,35,51,0,4,52,62,31,52,0,10,4,9,9,31,62
1995-02-27 00:00:00.000,Mexico City Mexico ATP World Tour,CLAY,2,Marc-Kevin Goellner,Albert Costa,Marc-Kevin Goellner,6-3; 6-4,R32,70,9,6,26,65,22,26,20,39,2,3,10,42,65,0,4,41,63,27,41,9,22,7,10,9,36,63
1995-02-27 00:00:00.000,Mexico City Mexico ATP World Tour,CLAY,2,Alex Corretja,Diego Nargiso,Alex Corretja,6-3; 7-5,R32,90,0,1,38,78,22,38,24,40,2,5,11,46,78,4,9,30,61,19,30,11,31,3,8,10,30,61
1995-02-27 00:00:00.000,Mexico City Mexico ATP World Tour,CLAY,2,Luis Herrera,Alejo Mancisidor,Luis Herrera,6-2; 6-4,R32,68,0,3,37,55,19,37,6,18,2,7,9,25,55,0,4,50,69,21,50,5,19,12,20,9,26,69
1995-02-27 00:00:00.000,Mexico City Mexico ATP World Tour,CLAY,2,Jordi Burillo,Paul Wekesa,Jordi Burillo,6-3; 6-0,R32,52,5,2,25,48,21,25,14,23,2,2,8,35,48,2,3,29,46,17,29,4,17,4,8,7,21,46
1995-02-27 00:00:00.000,Mexico City Mexico ATP World Tour,CLAY,2,Bohdan Ulihrach,Jaime Yzaga,Bohdan Ulihrach,6-4; 6-4,R32,83,3,6,25,72,20,25,20,47,4,8,10,40,72,0,7,29,62,20,29,9,33,2,8,10,29,62
1995-02-27 00:00:00.000,Mexico City Mexico ATP World Tour,CLAY,2,Francisco Clavet,Alex O'Brien,Francisco Clavet,7-5; 6-3,R32,82,2,3,41,59,27,41,11,18,3,5,10,38,59,1,6,48,84,32,48,14,36,11,16,11,46,84
1995-02-27 00:00:00.000,Mexico City Mexico ATP World Tour,CLAY,2,Bryan Shelton,Oscar Ortiz,Bryan Shelton,6-0; 1-6; 6-2,R32,92,4,11,39,79,29,39,17,40,4,7,11,46,79,3,8,29,71,21,29,15,42,5,10,10,36,71
1995-02-27 00:00:00.000,Mexico City Mexico ATP World Tour,CLAY,2,Mauricio Hadad,Agustin Moreno,Mauricio Hadad,6-3; 6-2,R32,67,2,4,35,58,26,35,14,23,6,7,9,40,58,1,2,36,51,20,36,4,15,4,8,8,24,51
1995-02-27 00:00:00.000,Mexico City Mexico ATP World Tour,CLAY,2,Carlos Costa,Javier Frana,Carlos Costa,3-6; 7-6(5); 7-5,R32,110,5,11,37,100,25,37,33,63,1,7,17,58,100,4,3,39,88,30,39,25,49,1,6,16,55,88
1995-02-27 00:00:00.000,Mexico City Mexico ATP World Tour,CLAY,2,Oscar Martinez,Kenny Thorne,Oscar Martinez,7-5; 6-4,R32,79,1,4,32,80,26,32,27,48,4,5,11,53,80,2,8,34,63,27,34,9,29,4,7,11,36,63
1995-02-27 00:00:00.000,Mexico City Mexico ATP World Tour,CLAY,2,Alejandro Hernandez,Hernan Gumy,Alejandro Hernandez,5-7; 6-4; 6-4,R32,156,3,0,108,108,61,108,0,0,11,16,16,61,108,5,0,113,113,63,113,0,0,9,15,16,63,113
1995-02-27 00:00:00.000,Mexico City Mexico ATP World Tour,CLAY,2,Leonardo Lavalle,Jordi Arrese,Leonardo Lavalle,1-6; 6-4; 6-3,R32,109,5,9,45,83,36,45,17,38,4,8,14,53,83,4,8,56,89,33,56,18,33,6,10,14,51,89
1995-02-27 00:00:00.000,Mexico City Mexico ATP World Tour,CLAY,2,Thomas Muster,Nicolas Pereira,Thomas Muster,6-2; 6-1,R32,59,2,3,25,49,22,25,13,24,2,2,8,35,49,2,7,24,61,15,24,15,37,7,11,7,30,61
1995-02-27 00:00:00.000,Mexico City Mexico ATP World Tour,CLAY,2,Mark Petchey,Alberto Berasategui,Mark Petchey,7-6(5); 6-4,R16,76,4,9,31,70,27,31,20,39,1,3,11,47,70,2,7,53,79,33,53,12,26,6,9,11,45,79
1995-02-27 00:00:00.000,Mexico City Mexico ATP World Tour,CLAY,2,Fernando Meligeni,Marc-Kevin Goellner,Fernando Meligeni,6-2; 6-7(5); 6-1,R16,86,3,1,48,89,41,48,24,41,2,2,14,65,89,9,8,31,73,26,31,19,42,3,7,13,45,73
1995-02-27 00:00:00.000,Mexico City Mexico ATP World Tour,CLAY,2,Alex Corretja,Luis Herrera,Alex Corretja,7-6(5); 6-2,R16,94,1,3,41,72,30,41,15,31,4,6,10,45,72,0,6,30,70,20,30,16,40,3,7,10,36,70
1995-02-27 00:00:00.000,Mexico City Mexico ATP World Tour,CLAY,2,Jordi Burillo,Bohdan Ulihrach,Jordi Burillo,5-7; 6-3; 6-3,R16,125,5,10,41,98,30,41,27,57,5,9,15,57,98,3,10,52,111,32,52,28,59,13,19,15,60,111
1995-02-27 00:00:00.000,Mexico City Mexico ATP World Tour,CLAY,2,Francisco Clavet,Bryan Shelton,Francisco Clavet,6-0; 6-4,R16,58,0,1,29,45,21,29,12,16,0,0,8,33,45,4,7,22,47,15,22,7,25,5,9,8,22,47
1995-02-27 00:00:00.000,Mexico City Mexico ATP World Tour,CLAY,2,Mauricio Hadad,Carlos Costa,Mauricio Hadad,6-1; 6-3,R16,51,0,3,31,47,24,31,9,16,3,4,8,33,47,0,10,20,48,13,20,8,28,5,10,8,21,48
1995-02-27 00:00:00.000,Mexico City Mexico ATP World Tour,CLAY,2,Oscar Martinez,Alejandro Hernandez,Oscar Martinez,6-2; 4-6; 7-5,R16,119,4,6,35,95,26,35,32,60,5,9,15,58,95,5,7,57,126,36,57,30,69,9,15,15,66,126
1995-02-27 00:00:00.000,Mexico City Mexico ATP World Tour,CLAY,2,Thomas Muster,Leonardo Lavalle,Thomas Muster,6-4; 6-1,R16,75,5,3,35,62,26,35,11,27,2,4,9,37,62,3,6,28,58,18,28,11,30,3,8,8,29,58
1995-02-27 00:00:00.000,Mexico City Mexico ATP World Tour,CLAY,2,Fernando Meligeni,Mark Petchey,Fernando Meligeni,3-6; 6-2; 7-6(3),Q,125,0,2,53,97,35,53,29,44,4,6,14,64,97,4,8,52,109,38,52,28,57,5,8,15,66,109
1995-02-27 00:00:00.000,Mexico City Mexico ATP World Tour,CLAY,2,Alex Corretja,Jordi Burillo,Alex Corretja,7-5; 3-6; 7-6(5),Q,135,1,2,72,117,41,72,20,45,11,18,16,61,117,8,12,43,110,29,43,31,67,5,12,17,60,110
1995-02-27 00:00:00.000,Mexico City Mexico ATP World Tour,CLAY,2,Francisco Clavet,Mauricio Hadad,Francisco Clavet,6-4; 6-1,Q,60,1,4,28,44,19,28,9,16,1,3,8,28,44,0,2,26,47,12,26,7,21,2,8,9,19,47
1995-02-27 00:00:00.000,Mexico City Mexico ATP World Tour,CLAY,2,Thomas Muster,Oscar Martinez,Thomas Muster,7-6(6); 6-1,Q,88,3,1,37,76,25,37,21,39,4,6,10,46,76,1,10,24,80,19,24,23,56,6,10,9,42,80
1995-02-27 00:00:00.000,Mexico City Mexico ATP World Tour,CLAY,2,Fernando Meligeni,Alex Corretja,Fernando Meligeni,6-1; 6-0,S,49,0,2,28,54,20,28,17,26,7,7,7,37,54,2,6,17,30,6,17,2,13,1,6,6,8,30
1995-02-27 00:00:00.000,Mexico City Mexico ATP World Tour,CLAY,2,Thomas Muster,Francisco Clavet,Thomas Muster,7-6(3); 1-6; 6-2,S,128,6,2,43,85,29,43,20,42,4,9,13,49,85,5,5,51,97,34,51,22,46,6,11,14,56,97
1995-02-27 00:00:00.000,Mexico City Mexico ATP World Tour,CLAY,2,Thomas Muster,Fernando Meligeni,Thomas Muster,7-6(4); 7-5,F,85,4,3,34,67,24,34,20,33,1,4,12,44,67,3,0,43,71,25,43,15,28,0,4,12,40,71
1995-02-27 00:00:00.000,Rotterdam The Netherlands ATP World Tour,HARD,2,Sjeng Schalken,Karol Kucera,Sjeng Schalken,6-4; 6-7(2); 6-3,R32,104,9,5,65,99,50,65,16,34,1,2,16,66,99,9,1,51,83,43,51,18,32,1,4,15,61,83
1995-02-27 00:00:00.000,Rotterdam The Netherlands ATP World Tour,HARD,2,Joost Winnink,Sander Groen,Joost Winnink,6-3; 6-1,R32,58,3,1,25,48,19,25,16,23,0,0,8,35,48,3,5,30,54,16,30,11,24,4,8,8,27,54
1995-02-27 00:00:00.000,Rotterdam The Netherlands ATP World Tour,HARD,2,Omar Camporese,Joern Renzenbrink,Omar Camporese,6-4; 7-6(2),R32,86,9,0,37,64,35,37,16,27,4,4,11,51,64,14,3,61,85,43,61,10,24,4,5,11,53,85
1995-02-27 00:00:00.000,Rotterdam The Netherlands ATP World Tour,HARD,2,Alexander Volkov,Karel Novacek,Alexander Volkov,6-7(4); 6-4; 6-2,R32,121,12,1,46,96,37,46,32,50,5,5,15,69,96,13,0,63,106,43,63,23,43,6,9,15,66,106
1995-02-27 00:00:00.000,Rotterdam The Netherlands ATP World Tour,HARD,2,Andrei Medvedev,Tomas Carbonell,Andrei Medvedev,6-4; 6-4,R32,67,5,3,43,61,32,43,10,18,2,2,10,42,61,7,2,31,62,22,31,18,31,2,4,10,40,62
1995-02-27 00:00:00.000,Rotterdam The Netherlands ATP World Tour,HARD,2,Andrei Olhovskiy,Jeremy Bates,Andrei Olhovskiy,6-3; 6-4,R32,58,9,1,31,46,28,31,9,15,1,2,10,37,46,5,3,25,54,17,25,14,29,2,5,9,31,54
1995-02-27 00:00:00.000,Rotterdam The Netherlands ATP World Tour,HARD,2,Jan Siemerink,Carl-Uwe Steeb,Jan Siemerink,7-5; 6-3,R32,81,7,1,30,57,25,30,18,27,1,2,11,43,57,0,5,41,79,22,41,19,38,5,8,10,41,79
1995-02-27 00:00:00.000,Rotterdam The Netherlands ATP World Tour,HARD,2,Richard Krajicek,Ronald Agenor,Richard Krajicek,6-1; 6-4,R32,65,21,2,38,59,34,38,7,21,1,1,9,41,59,1,0,25,48,16,25,11,23,3,6,8,27,48
1995-02-27 00:00:00.000,Rotterdam The Netherlands ATP World Tour,HARD,2,Kenneth Carlsen,Jacco Eltingh,Kenneth Carlsen,7-6(4); 7-6(3),R32,92,20,5,50,74,44,50,15,24,2,2,12,59,74,7,4,51,75,39,51,16,24,1,1,12,55,75
1995-02-27 00:00:00.000,Rotterdam The Netherlands ATP World Tour,HARD,2,Paul Haarhuis,Cristiano Caratti,Paul Haarhuis,3-6; 6-4; 6-1,R32,96,6,3,75,101,49,75,8,26,11,15,13,57,101,0,6,46,73,27,46,11,27,1,7,13,38,73
1995-02-27 00:00:00.000,Rotterdam The Netherlands ATP World Tour,HARD,2,Jeff Tarango,Patrick McEnroe,Jeff Tarango,6-2; 6-7(4); 6-2,R32,111,11,4,61,92,45,61,15,31,0,2,14,60,92,9,5,41,90,29,41,20,49,4,10,14,49,90
1995-02-27 00:00:00.000,Rotterdam The Netherlands ATP World Tour,HARD,2,Wayne Ferreira,Luiz Mattar,Wayne Ferreira,6-4; 6-3,R32,68,2,1,23,42,19,23,13,19,0,1,9,32,42,4,0,43,64,29,43,9,21,9,13,10,38,64
1995-02-27 00:00:00.000,Rotterdam The Netherlands ATP World Tour,HARD,2,Slava Dosedel,Christian Ruud,Slava Dosedel,6-4; 6-1,R32,60,9,0,25,51,23,25,12,26,1,2,9,35,51,1,0,22,46,13,22,12,24,2,6,8,25,46
1995-02-27 00:00:00.000,Rotterdam The Netherlands ATP World Tour,HARD,2,Martin Damm,Jakob Hlasek,Martin Damm,6-2; 6-7(5); 7-6(2),R32,123,12,4,57,99,48,57,26,42,0,1,16,74,99,19,5,60,106,50,60,19,46,3,6,16,69,106
1995-02-27 00:00:00.000,Rotterdam The Netherlands ATP World Tour,HARD,2,Mats Wilander,Daniel Vacek,Mats Wilander,6-4; 6-4,R32,68,5,1,33,55,26,33,13,22,2,3,10,39,55,4,4,30,50,22,30,10,20,0,3,10,32,50
1995-02-27 00:00:00.000,Rotterdam The Netherlands ATP World Tour,HARD,2,Yevgeny Kafelnikov,Danny Sapsford,Yevgeny Kafelnikov,6-1; 7-6(3),R32,81,7,5,37,67,31,37,17,30,1,1,10,48,67,3,1,36,62,27,36,12,26,2,4,9,39,62
1995-02-27 00:00:00.000,Rotterdam The Netherlands ATP World Tour,HARD,2,Sjeng Schalken,Joost Winnink,Sjeng Schalken,6-2; 6-2,R16,59,7,2,37,54,27,37,10,17,3,3,8,37,54,1,3,27,47,14,27,11,20,4,8,8,25,47
1995-02-27 00:00:00.000,Rotterdam The Netherlands ATP World Tour,HARD,2,Omar Camporese,Alexander Volkov,Omar Camporese,6-2; 6-3,R16,66,6,3,26,57,21,26,19,31,1,1,9,40,57,4,3,24,49,16,24,13,25,1,4,8,29,49
1995-02-27 00:00:00.000,Rotterdam The Netherlands ATP World Tour,HARD,2,Andrei Medvedev,Andrei Olhovskiy,Andrei Medvedev,6-4; 7-5,R16,73,13,1,42,58,35,42,11,16,3,3,11,46,58,8,4,35,74,27,35,19,39,6,8,11,46,74
1995-02-27 00:00:00.000,Rotterdam The Netherlands ATP World Tour,HARD,2,Richard Krajicek,Jan Siemerink,Richard Krajicek,7-5; 6-4,R16,75,12,4,43,65,38,43,11,22,5,5,11,49,65,3,1,49,74,33,49,16,25,6,8,11,49,74
1995-02-27 00:00:00.000,Rotterdam The Netherlands ATP World Tour,HARD,2,Paul Haarhuis,Kenneth Carlsen,Paul Haarhuis,6-7(8); 7-6(5); 7-6(4),R16,159,6,1,68,115,60,68,31,47,0,1,18,91,115,24,8,88,137,70,88,27,49,8,9,18,97,137
1995-02-27 00:00:00.000,Rotterdam The Netherlands ATP World Tour,HARD,2,Jeff Tarango,Wayne Ferreira,Jeff Tarango,6-3; 6-2,R16,73,4,1,49,72,36,49,13,23,7,7,9,49,72,11,1,29,55,20,29,9,26,5,8,8,29,55
1995-02-27 00:00:00.000,Rotterdam The Netherlands ATP World Tour,HARD,2,Martin Damm,Slava Dosedel,Martin Damm,3-6; 7-5; 7-5,R16,132,11,4,55,109,43,55,22,54,13,17,16,65,109,10,9,54,114,40,54,26,60,7,12,17,66,114
1995-02-27 00:00:00.000,Rotterdam The Netherlands ATP World Tour,HARD,2,Yevgeny Kafelnikov,Mats Wilander,Yevgeny Kafelnikov,6-4; 7-6(3),R16,97,11,2,43,80,35,43,17,37,0,1,11,52,80,4,0,51,73,36,51,9,22,3,5,11,45,73
1995-02-27 00:00:00.000,Rotterdam The Netherlands ATP World Tour,HARD,2,Omar Camporese,Sjeng Schalken,Omar Camporese,6-2; 6-3,Q,59,6,0,30,57,26,30,14,27,2,2,9,40,57,2,0,26,42,16,26,8,16,0,3,8,24,42
1995-02-27 00:00:00.000,Rotterdam The Netherlands ATP World Tour,HARD,2,Richard Krajicek,Andrei Medvedev,Richard Krajicek,7-6(5); 6-4,Q,80,10,1,31,58,27,31,18,27,1,2,11,45,58,8,1,36,69,28,36,15,33,1,3,11,43,69
1995-02-27 00:00:00.000,Rotterdam The Netherlands ATP World Tour,HARD,2,Paul Haarhuis,Jeff Tarango,Paul Haarhuis,6-4; 6-4,Q,71,11,0,44,61,35,44,8,17,0,0,10,43,61,6,0,41,59,29,41,10,18,4,6,10,39,59
1995-02-27 00:00:00.000,Rotterdam The Netherlands ATP World Tour,HARD,2,Yevgeny Kafelnikov,Martin Damm,Yevgeny Kafelnikov,6-0; 7-6(6),Q,68,11,0,28,51,25,28,15,23,0,0,9,40,51,10,3,28,58,20,28,15,30,2,5,9,35,58
1995-02-27 00:00:00.000,Rotterdam The Netherlands ATP World Tour,HARD,2,Richard Krajicek,Omar Camporese,Richard Krajicek,6-3; 7-5,S,76,19,2,36,63,31,36,14,27,4,5,11,45,63,3,2,29,65,24,29,13,36,3,6,10,37,65
1995-02-27 00:00:00.000,Rotterdam The Netherlands ATP World Tour,HARD,2,Paul Haarhuis,Yevgeny Kafelnikov,Paul Haarhuis,3-6; 6-3; 7-6(5),S,128,13,3,70,112,44,70,23,42,9,13,15,67,112,5,3,54,88,32,54,24,34,3,7,15,56,88
1995-02-27 00:00:00.000,Rotterdam The Netherlands ATP World Tour,HARD,2,Richard Krajicek,Paul Haarhuis,Richard Krajicek,7-6(5); 6-4,F,79,13,3,39,63,37,39,11,24,1,2,11,48,63,6,1,43,66,33,43,12,23,1,3,11,45,66
1995-02-27 00:00:00.000,Scottsdale AZ; U.S.A. ATP World Tour,HARD,2,Todd Martin,Markus Zoecke,Todd Martin,4-6; 6-3; 6-2,R32,99,9,5,60,90,43,60,16,30,2,4,14,59,90,10,3,47,78,35,47,13,31,3,7,13,48,78
1995-02-27 00:00:00.000,Scottsdale AZ; U.S.A. ATP World Tour,HARD,2,Byron Black,Andrew Sznajder,Byron Black,7-6(3); 6-2,R32,84,10,3,47,80,35,47,19,33,7,8,10,54,80,5,2,36,59,26,36,11,23,2,5,10,37,59
1995-02-27 00:00:00.000,Scottsdale AZ; U.S.A. ATP World Tour,HARD,2,Carsten Arriens,Fabrice Santoro,Carsten Arriens,6-3; 6-2,R32,79,1,0,44,59,33,44,6,15,9,11,9,39,59,0,5,39,75,18,39,17,36,9,14,8,35,75
1995-02-27 00:00:00.000,Scottsdale AZ; U.S.A. ATP World Tour,HARD,2,Michael Tebbutt,Javier Sanchez,Michael Tebbutt,7-6(4); 6-7(3); 7-6(6),R32,135,21,14,68,125,54,68,30,57,5,7,18,84,125,3,4,107,137,79,107,12,30,7,9,18,91,137
1995-02-27 00:00:00.000,Scottsdale AZ; U.S.A. ATP World Tour,HARD,2,Patrick Rafter,Gilbert Schaller,Patrick Rafter,6-3; 6-4,R32,72,10,1,34,60,29,34,15,26,3,3,10,44,60,1,2,36,51,24,36,8,15,1,3,9,32,51
1995-02-27 00:00:00.000,Scottsdale AZ; U.S.A. ATP World Tour,HARD,2,Jonas Bjorkman,Marcelo Filippini,Jonas Bjorkman,6-3; 6-1,R32,57,2,0,19,46,11,19,22,27,2,3,8,33,46,0,4,27,43,12,27,6,16,5,10,8,18,43
1995-02-27 00:00:00.000,Scottsdale AZ; U.S.A. ATP World Tour,HARD,2,Mark Philippoussis,Vincent Spadea,Mark Philippoussis,6-2; 6-1,R32,48,8,3,18,41,16,18,13,23,2,3,7,29,41,1,3,21,46,11,21,7,25,3,9,8,18,46
1995-02-27 00:00:00.000,Scottsdale AZ; U.S.A. ATP World Tour,HARD,2,Andrei Chesnokov,Aaron Krickstein,Andrei Chesnokov,7-6(4); 6-2,R32,78,7,1,37,71,27,37,17,34,3,5,10,44,71,4,2,36,63,24,36,10,27,3,7,10,34,63
1995-02-27 00:00:00.000,Scottsdale AZ; U.S.A. ATP World Tour,HARD,2,Bernd Karbacher,Richard Fromberg,Bernd Karbacher,6-2; 6-1,R32,55,3,1,26,50,21,26,16,24,1,1,8,37,50,1,5,18,38,12,18,7,20,2,6,7,19,38
1995-02-27 00:00:00.000,Scottsdale AZ; U.S.A. ATP World Tour,HARD,2,Brett Steven,Henrik Holm,Brett Steven,7-6(3); 7-6(4),R32,100,3,1,45,74,30,45,24,29,0,2,12,54,74,3,5,49,81,39,49,13,32,4,6,12,52,81
1995-02-27 00:00:00.000,Scottsdale AZ; U.S.A. ATP World Tour,HARD,2,Michael Geserer,Roger Smith,Michael Geserer,6-7(2); 6-2; 6-2,R32,124,5,1,74,107,48,74,19,33,20,21,14,67,107,3,3,47,83,32,47,20,36,3,8,14,52,83
1995-02-27 00:00:00.000,Scottsdale AZ; U.S.A. ATP World Tour,HARD,2,Stefan Edberg,Hendrik Dreekmann,Stefan Edberg,7-5; 3-6; 6-4,R32,120,5,4,52,109,33,52,34,57,4,8,16,67,109,4,5,45,88,32,45,22,43,5,9,15,54,88
1995-02-27 00:00:00.000,Scottsdale AZ; U.S.A. ATP World Tour,HARD,2,Mark Woodforde,Horst Skoff,Mark Woodforde,6-3; 6-4,R32,67,13,1,33,57,25,33,16,24,3,4,10,41,57,1,4,44,62,27,44,7,18,9,12,9,34,62
1995-02-27 00:00:00.000,Scottsdale AZ; U.S.A. ATP World Tour,HARD,2,Wade McGuire,Dennis Schmid,Wade McGuire,1-6; 6-3; 6-4,R32,95,1,8,44,77,30,44,14,33,7,11,13,44,77,4,8,38,72,29,38,16,34,1,5,13,45,72
1995-02-27 00:00:00.000,Scottsdale AZ; U.S.A. ATP World Tour,HARD,2,Renzo Furlan,Brian Dunn,Renzo Furlan,6-4; 6-4,R32,87,3,2,42,59,35,42,9,17,2,2,10,44,59,7,4,24,56,19,24,19,32,2,4,10,38,56
1995-02-27 00:00:00.000,Scottsdale AZ; U.S.A. ATP World Tour,HARD,2,Jim Courier,Lionel Roux,Jim Courier,7-6(2); 6-4,R32,104,3,3,42,67,33,42,13,25,2,4,11,46,67,4,3,44,80,27,44,18,36,2,5,11,45,80
1995-02-27 00:00:00.000,Scottsdale AZ; U.S.A. ATP World Tour,HARD,2,Todd Martin,Byron Black,Todd Martin,7-6(3); 6-1,R16,77,9,3,30,51,27,30,11,21,0,1,9,38,51,1,4,42,73,27,42,11,31,3,7,10,38,73
1995-02-27 00:00:00.000,Scottsdale AZ; U.S.A. ATP World Tour,HARD,2,Carsten Arriens,Michael Tebbutt,Carsten Arriens,2-6; 6-3; 6-3,R16,102,4,1,57,86,38,57,12,29,9,13,13,50,86,7,4,49,93,30,49,20,44,6,11,13,50,93
1995-02-27 00:00:00.000,Scottsdale AZ; U.S.A. ATP World Tour,HARD,2,Jonas Bjorkman,Patrick Rafter,Jonas Bjorkman,6-2; 6-3,R16,71,1,4,25,57,20,25,19,32,5,5,8,39,57,2,4,45,67,30,45,5,22,8,12,9,35,67
1995-02-27 00:00:00.000,Scottsdale AZ; U.S.A. ATP World Tour,HARD,2,Mark Philippoussis,Andrei Chesnokov,Mark Philippoussis,6-4; 6-3,R16,72,4,4,21,57,17,21,20,36,3,4,9,37,57,5,3,40,66,25,40,13,26,6,10,10,38,66
1995-02-27 00:00:00.000,Scottsdale AZ; U.S.A. ATP World Tour,HARD,2,Brett Steven,Bernd Karbacher,Brett Steven,6-1; 6-4,R16,78,3,3,52,69,35,52,8,17,8,9,9,43,69,3,2,29,48,20,29,4,19,3,7,8,24,48
1995-02-27 00:00:00.000,Scottsdale AZ; U.S.A. ATP World Tour,HARD,2,Stefan Edberg,Michael Geserer,Stefan Edberg,6-1; 6-1,R16,44,4,0,21,33,18,21,10,12,0,0,7,28,33,1,0,22,40,10,22,6,18,3,8,7,16,40
1995-02-27 00:00:00.000,Scottsdale AZ; U.S.A. ATP World Tour,HARD,2,Mark Woodforde,Wade McGuire,Mark Woodforde,6-4; 1-0 RET,R16,39,2,1,13,22,12,13,5,9,1,2,6,17,22,5,2,11,36,6,11,11,25,3,6,6,17,36
1995-02-27 00:00:00.000,Scottsdale AZ; U.S.A. ATP World Tour,HARD,2,Jim Courier,Renzo Furlan,Jim Courier,6-3; 6-4,R16,72,5,5,37,60,31,37,14,23,3,3,10,45,60,4,2,24,48,19,24,13,24,1,3,9,32,48
1995-02-27 00:00:00.000,Scottsdale AZ; U.S.A. ATP World Tour,HARD,2,Todd Martin,Carsten Arriens,Todd Martin,7-5; 7-6(1),Q,86,6,3,46,71,33,46,17,25,6,8,12,50,71,3,1,43,68,29,43,12,25,1,4,12,41,68
1995-02-27 00:00:00.000,Scottsdale AZ; U.S.A. ATP World Tour,HARD,2,Mark Philippoussis,Jonas Bjorkman,Mark Philippoussis,3-6; 6-4; 6-4,Q,124,13,3,63,107,48,63,18,44,11,14,15,66,107,8,4,45,100,32,45,29,55,5,8,14,61,100
1995-02-27 00:00:00.000,Scottsdale AZ; U.S.A. ATP World Tour,HARD,2,Stefan Edberg,Brett Steven,Stefan Edberg,6-3; 6-2,Q,64,3,2,28,45,20,28,11,17,3,4,8,31,45,0,3,38,54,20,38,6,16,4,9,9,26,54
1995-02-27 00:00:00.000,Scottsdale AZ; U.S.A. ATP World Tour,HARD,2,Jim Courier,Mark Woodforde,Jim Courier,6-3; 6-3,Q,75,6,5,31,61,20,31,17,30,5,7,9,37,61,5,1,32,54,22,32,5,22,6,11,9,27,54
1995-02-27 00:00:00.000,Scottsdale AZ; U.S.A. ATP World Tour,HARD,2,Mark Philippoussis,Todd Martin,Mark Philippoussis,7-6(3); 6-3,S,77,9,1,46,68,39,46,12,22,2,2,11,51,68,6,2,35,62,27,35,17,27,1,2,10,44,62
1995-02-27 00:00:00.000,Scottsdale AZ; U.S.A. ATP World Tour,HARD,2,Jim Courier,Stefan Edberg,Jim Courier,6-4; 6-7(5); 6-4,S,143,5,8,65,123,43,65,28,58,7,11,16,71,123,7,5,49,91,37,49,18,42,1,7,16,55,91
1995-02-27 00:00:00.000,Scottsdale AZ; U.S.A. ATP World Tour,HARD,2,Jim Courier,Mark Philippoussis,Jim Courier,7-6(2); 6-4,F,89,1,1,50,70,39,50,13,20,3,3,11,52,70,13,6,39,72,31,39,17,33,4,5,11,48,72
1995-03-06 00:00:00.000,ATP Masters Series Indian Wells CA; U.S.A. ATP World Tour,HARD,2,Pete Sampras,N/A Bye,Pete Sampras,,R64,0,0,0,0,0,0,0,0,0,0,0,0,0,0,0,0,0,0,0,0,0,0,0,0,0,0,0
1995-03-06 00:00:00.000,ATP Masters Series Indian Wells CA; U.S.A. ATP World Tour,HARD,2,Jonas Bjorkman,Karel Novacek,Jonas Bjorkman,7-5; 6-2,R64,76,4,3,40,65,33,40,9,25,5,7,10,42,65,1,1,45,69,25,45,10,24,10,15,10,35,69
1995-03-06 00:00:00.000,ATP Masters Series Indian Wells CA; U.S.A. ATP World Tour,HARD,2,Tommy Ho,Jaime Yzaga,Tommy Ho,6-4; 6-4,R64,85,6,2,38,63,25,38,14,25,3,5,10,39,63,2,7,43,82,26,43,18,39,3,7,10,44,82
1995-03-06 00:00:00.000,ATP Masters Series Indian Wells CA; U.S.A. ATP World Tour,HARD,2,Patrick Rafter,Alex Corretja,Patrick Rafter,2-6; 7-5; 6-2,R64,117,3,5,49,90,31,49,26,41,8,10,14,57,90,3,0,67,85,44,67,8,18,2,5,14,52,85
1995-03-06 00:00:00.000,ATP Masters Series Indian Wells CA; U.S.A. ATP World Tour,HARD,2,Andrei Medvedev,Oliver Gross,Andrei Medvedev,7-6(4); 6-2,R64,77,2,1,36,60,31,36,15,24,0,0,10,46,60,3,3,42,76,28,42,19,34,5,7,10,47,76
1995-03-06 00:00:00.000,ATP Masters Series Indian Wells CA; U.S.A. ATP World Tour,HARD,2,David Wheaton,Cedric Pioline,David Wheaton,6-3; 6-1,R64,56,3,0,30,50,23,30,13,20,4,4,8,36,50,1,1,25,41,16,25,7,16,1,5,8,23,41
1995-03-06 00:00:00.000,ATP Masters Series Indian Wells CA; U.S.A. ATP World Tour,HARD,2,Horst Skoff,Andrei Chesnokov,Horst Skoff,7-5; 6-3,R64,95,0,4,35,78,23,35,22,43,6,8,10,45,78,9,7,42,76,29,42,12,34,7,12,11,41,76
1995-03-06 00:00:00.000,ATP Masters Series Indian Wells CA; U.S.A. ATP World Tour,HARD,2,Todd Martin,N/A Bye,Todd Martin,,R64,0,0,0,0,0,0,0,0,0,0,0,0,0,0,0,0,0,0,0,0,0,0,0,0,0,0,0
1995-03-06 00:00:00.000,ATP Masters Series Indian Wells CA; U.S.A. ATP World Tour,HARD,2,Michael Chang,N/A Bye,Michael Chang,,R64,0,0,0,0,0,0,0,0,0,0,0,0,0,0,0,0,0,0,0,0,0,0,0,0,0,0,0
1995-03-06 00:00:00.000,ATP Masters Series Indian Wells CA; U.S.A. ATP World Tour,HARD,2,Guy Forget,Olivier Delaitre,Guy Forget,6-7(10); 6-1; 7-5,R64,124,12,1,54,92,41,54,25,38,4,7,15,66,92,9,2,60,107,37,60,23,47,7,14,16,60,107
1995-03-06 00:00:00.000,ATP Masters Series Indian Wells CA; U.S.A. ATP World Tour,HARD,2,Chuck Adams,Jim Grabb,Chuck Adams,7-6(3); 6-2,R64,100,1,3,40,61,35,40,12,21,1,1,10,47,61,6,7,55,90,41,55,11,35,8,10,10,52,90
1995-03-06 00:00:00.000,ATP Masters Series Indian Wells CA; U.S.A. ATP World Tour,HARD,2,Thomas Muster,Bernd Karbacher,Thomas Muster,6-4; 6-2,R64,62,1,3,27,47,20,27,12,20,0,1,9,32,47,4,0,37,62,24,37,9,25,7,11,9,33,62
1995-03-06 00:00:00.000,ATP Masters Series Indian Wells CA; U.S.A. ATP World Tour,HARD,2,Stefan Edberg,Davide Sanguinetti,Stefan Edberg,6-3; 4-6; 6-3,R64,108,0,3,41,83,32,41,26,42,5,6,14,58,83,4,1,60,96,45,60,14,36,4,7,14,59,96
1995-03-06 00:00:00.000,ATP Masters Series Indian Wells CA; U.S.A. ATP World Tour,HARD,2,Arnaud Boetsch,Adam Peterson,Arnaud Boetsch,6-1; 6-2,R64,48,2,0,25,45,18,25,14,20,0,0,8,32,45,0,0,28,40,12,28,7,12,1,5,7,19,40
1995-03-06 00:00:00.000,ATP Masters Series Indian Wells CA; U.S.A. ATP World Tour,HARD,2,Fabrice Santoro,Todd Woodbridge,Fabrice Santoro,6-4; 1-6; 6-1,R64,103,4,7,37,74,23,37,21,37,3,6,12,44,74,3,0,58,89,37,58,15,31,6,10,12,52,89
1995-03-06 00:00:00.000,ATP Masters Series Indian Wells CA; U.S.A. ATP World Tour,HARD,2,Alberto Berasategui,N/A Bye,Alberto Berasategui,,R64,0,0,0,0,0,0,0,0,0,0,0,0,0,0,0,0,0,0,0,0,0,0,0,0,0,0,0
1995-03-06 00:00:00.000,ATP Masters Series Indian Wells CA; U.S.A. ATP World Tour,HARD,2,Michael Stich,N/A Bye,Michael Stich,,R64,0,0,0,0,0,0,0,0,0,0,0,0,0,0,0,0,0,0,0,0,0,0,0,0,0,0,0
1995-03-06 00:00:00.000,ATP Masters Series Indian Wells CA; U.S.A. ATP World Tour,HARD,2,Richey Reneberg,Jerome Golmard,Richey Reneberg,6-3; 6-1,R64,58,14,0,28,48,23,28,13,20,3,3,8,36,48,1,2,36,58,19,36,11,22,5,9,8,30,58
1995-03-06 00:00:00.000,ATP Masters Series Indian Wells CA; U.S.A. ATP World Tour,HARD,2,Lionel Roux,Jason Stoltenberg,Lionel Roux,6-4; 6-3,R64,79,4,5,35,63,28,35,15,28,5,6,10,43,63,0,0,39,64,25,39,11,25,2,5,9,36,64
1995-03-06 00:00:00.000,ATP Masters Series Indian Wells CA; U.S.A. ATP World Tour,HARD,2,Magnus Larsson,Emilio Sanchez,Magnus Larsson,6-4; 6-2,R64,59,6,1,32,48,30,32,9,16,2,2,9,39,48,0,2,31,51,22,31,9,20,2,5,9,31,51
1995-03-06 00:00:00.000,ATP Masters Series Indian Wells CA; U.S.A. ATP World Tour,HARD,2,Andrea Gaudenzi,Richard Fromberg,Andrea Gaudenzi,2-6; 6-2; 7-6(2),R64,114,0,1,58,89,45,58,16,31,7,9,14,61,89,9,3,39,74,27,39,25,35,2,4,14,52,74
1995-03-06 00:00:00.000,ATP Masters Series Indian Wells CA; U.S.A. ATP World Tour,HARD,2,Marcelo Rios,Renzo Furlan,Marcelo Rios,6-1; 7-6(5),R64,89,3,1,49,84,31,49,15,35,9,12,10,46,84,3,5,26,54,13,26,11,28,1,6,9,24,54
1995-03-06 00:00:00.000,ATP Masters Series Indian Wells CA; U.S.A. ATP World Tour,HARD,2,Jared Palmer,Vincent Spadea,Jared Palmer,6-4; 6-4,R64,81,5,3,46,76,31,46,17,30,6,7,10,48,76,3,4,39,63,27,39,10,24,3,6,10,37,63
1995-03-06 00:00:00.000,ATP Masters Series Indian Wells CA; U.S.A. ATP World Tour,HARD,2,Boris Becker,N/A Bye,Boris Becker,,R64,0,0,0,0,0,0,0,0,0,0,0,0,0,0,0,0,0,0,0,0,0,0,0,0,0,0,0
1995-03-06 00:00:00.000,ATP Masters Series Indian Wells CA; U.S.A. ATP World Tour,HARD,2,Wayne Ferreira,N/A Bye,Wayne Ferreira,,R64,0,0,0,0,0,0,0,0,0,0,0,0,0,0,0,0,0,0,0,0,0,0,0,0,0,0,0
1995-03-06 00:00:00.000,ATP Masters Series Indian Wells CA; U.S.A. ATP World Tour,HARD,2,Francisco Clavet,MaliVai Washington,Francisco Clavet,6-2; 6-3,R64,74,0,1,40,59,30,40,11,19,2,2,9,41,59,3,3,30,56,19,30,12,26,6,9,8,31,56
1995-03-06 00:00:00.000,ATP Masters Series Indian Wells CA; U.S.A. ATP World Tour,HARD,2,Carlos Costa,Albert Costa,Carlos Costa,6-3; 6-3,R64,63,5,1,26,50,21,26,13,24,2,4,9,34,50,2,1,38,51,20,38,5,13,5,10,9,25,51
1995-03-06 00:00:00.000,ATP Masters Series Indian Wells CA; U.S.A. ATP World Tour,HARD,2,Jim Courier,Markus Zoecke,Jim Courier,6-3; 7-5,R64,74,5,1,32,50,29,32,12,18,0,0,10,41,50,8,3,47,73,30,47,14,26,2,5,11,44,73
1995-03-06 00:00:00.000,ATP Masters Series Indian Wells CA; U.S.A. ATP World Tour,HARD,2,Petr Korda,Aaron Krickstein,Petr Korda,6-2; 6-0,R64,62,8,4,31,55,23,31,13,24,6,6,7,36,55,3,1,37,60,17,37,10,23,8,13,7,27,60
1995-03-06 00:00:00.000,ATP Masters Series Indian Wells CA; U.S.A. ATP World Tour,HARD,2,Thomas Enqvist,Mark Woodforde,Thomas Enqvist,6-3; 6-4,R64,72,3,5,36,58,28,36,10,22,0,1,10,38,58,5,3,41,61,28,41,9,20,7,10,9,37,61
1995-03-06 00:00:00.000,ATP Masters Series Indian Wells CA; U.S.A. ATP World Tour,HARD,2,Mats Wilander,Javier Sanchez,Mats Wilander,6-4; 2-6; 7-5,R64,122,0,4,65,103,46,65,14,38,7,11,15,60,103,2,3,70,95,46,70,11,25,4,8,15,57,95
1995-03-06 00:00:00.000,ATP Masters Series Indian Wells CA; U.S.A. ATP World Tour,HARD,2,Andre Agassi,N/A Bye,Andre Agassi,,R64,0,0,0,0,0,0,0,0,0,0,0,0,0,0,0,0,0,0,0,0,0,0,0,0,0,0,0
1995-03-06 00:00:00.000,ATP Masters Series Indian Wells CA; U.S.A. ATP World Tour,HARD,2,Pete Sampras,Jonas Bjorkman,Pete Sampras,6-3; 7-6(5),R32,70,14,3,35,61,30,35,15,26,1,2,11,45,61,5,1,32,51,24,32,12,19,0,2,10,36,51
1995-03-06 00:00:00.000,ATP Masters Series Indian Wells CA; U.S.A. ATP World Tour,HARD,2,Patrick Rafter,Tommy Ho,Patrick Rafter,6-3; 2-6; 7-5,R32,103,8,4,49,86,39,49,19,37,2,5,15,58,86,3,3,46,73,34,46,15,27,1,4,14,49,73
1995-03-06 00:00:00.000,ATP Masters Series Indian Wells CA; U.S.A. ATP World Tour,HARD,2,David Wheaton,Andrei Medvedev,David Wheaton,4-6; 6-2; 7-6(4),R32,121,6,3,61,93,49,61,14,32,4,6,15,63,93,6,2,48,90,34,48,23,42,3,6,15,57,90
1995-03-06 00:00:00.000,ATP Masters Series Indian Wells CA; U.S.A. ATP World Tour,HARD,2,Todd Martin,Horst Skoff,Todd Martin,6-2; 6-2,R32,53,15,2,23,37,22,23,10,14,0,0,8,32,37,1,3,33,53,19,33,8,20,3,7,8,27,53
1995-03-06 00:00:00.000,ATP Masters Series Indian Wells CA; U.S.A. ATP World Tour,HARD,2,Michael Chang,Guy Forget,Michael Chang,6-3; 6-2,R32,83,3,1,42,68,32,42,14,26,6,6,9,46,68,1,1,38,59,22,38,11,21,8,11,8,33,59
1995-03-06 00:00:00.000,ATP Masters Series Indian Wells CA; U.S.A. ATP World Tour,HARD,2,Thomas Muster,Chuck Adams,Thomas Muster,6-2; 7-6(0),R32,81,7,2,37,67,32,37,15,30,1,2,10,47,67,2,7,31,61,23,31,11,30,1,4,10,34,61
1995-03-06 00:00:00.000,ATP Masters Series Indian Wells CA; U.S.A. ATP World Tour,HARD,2,Stefan Edberg,Arnaud Boetsch,Stefan Edberg,6-3; 6-4,R32,71,2,1,41,58,30,41,9,17,2,3,9,39,58,2,4,36,60,23,36,10,24,4,8,10,33,60
1995-03-06 00:00:00.000,ATP Masters Series Indian Wells CA; U.S.A. ATP World Tour,HARD,2,Alberto Berasategui,Fabrice Santoro,Alberto Berasategui,3-6; 6-3; 6-4,R32,87,3,2,62,78,45,62,9,16,4,5,14,54,78,1,5,55,80,41,55,11,25,4,6,14,52,80
1995-03-06 00:00:00.000,ATP Masters Series Indian Wells CA; U.S.A. ATP World Tour,HARD,2,Michael Stich,Richey Reneberg,Michael Stich,1-6; 7-6(4); 6-3,R32,111,7,4,50,99,38,50,22,49,6,10,15,60,99,1,1,36,80,30,36,24,44,0,2,13,54,80
1995-03-06 00:00:00.000,ATP Masters Series Indian Wells CA; U.S.A. ATP World Tour,HARD,2,Magnus Larsson,Lionel Roux,Magnus Larsson,6-2; 6-2,R32,53,5,2,28,43,23,28,10,15,1,1,8,33,43,3,0,25,43,15,25,8,18,3,7,8,23,43
1995-03-06 00:00:00.000,ATP Masters Series Indian Wells CA; U.S.A. ATP World Tour,HARD,2,Marcelo Rios,Andrea Gaudenzi,Marcelo Rios,6-3; 6-0,R32,61,6,2,34,57,24,34,12,23,4,5,8,36,57,1,3,29,50,13,29,8,21,6,11,7,21,50
1995-03-06 00:00:00.000,ATP Masters Series Indian Wells CA; U.S.A. ATP World Tour,HARD,2,Boris Becker,Jared Palmer,Boris Becker,6-4; 6-4,R32,74,7,4,32,61,25,32,18,29,2,3,10,43,61,2,1,28,49,21,28,11,21,0,3,10,32,49
1995-03-06 00:00:00.000,ATP Masters Series Indian Wells CA; U.S.A. ATP World Tour,HARD,2,Wayne Ferreira,Francisco Clavet,Wayne Ferreira,6-3; 3-6; 6-4,R32,119,9,2,48,90,36,48,19,42,6,8,14,55,90,0,1,71,96,43,71,16,25,2,5,14,59,96
1995-03-06 00:00:00.000,ATP Masters Series Indian Wells CA; U.S.A. ATP World Tour,HARD,2,Carlos Costa,Jim Courier,Carlos Costa,7-6(6); 6-3,R32,98,5,5,39,79,32,39,20,40,6,8,11,52,79,4,0,38,63,26,38,12,25,2,5,10,38,63
1995-03-06 00:00:00.000,ATP Masters Series Indian Wells CA; U.S.A. ATP World Tour,HARD,2,Thomas Enqvist,Petr Korda,Thomas Enqvist,6-2; 7-5,R32,75,2,7,33,67,28,33,16,34,3,4,10,44,67,6,4,40,68,27,40,12,28,4,8,10,39,68
1995-03-06 00:00:00.000,ATP Masters Series Indian Wells CA; U.S.A. ATP World Tour,HARD,2,Andre Agassi,Mats Wilander,Andre Agassi,6-0; 6-2,R32,58,2,2,21,40,17,21,10,19,1,2,7,27,40,1,2,33,53,16,33,4,20,4,10,7,20,53
1995-03-06 00:00:00.000,ATP Masters Series Indian Wells CA; U.S.A. ATP World Tour,HARD,2,Pete Sampras,Patrick Rafter,Pete Sampras,6-4; 6-7(8); 6-1,R16,117,8,3,46,83,41,46,23,37,0,1,15,64,83,7,7,63,109,48,63,18,46,6,10,14,66,109
1995-03-06 00:00:00.000,ATP Masters Series Indian Wells CA; U.S.A. ATP World Tour,HARD,2,Todd Martin,David Wheaton,Todd Martin,7-6(5); 4-6; 7-5,R16,139,19,2,65,112,50,65,27,47,3,4,17,77,112,14,2,83,113,64,83,11,30,3,4,17,75,113
1995-03-06 00:00:00.000,ATP Masters Series Indian Wells CA; U.S.A. ATP World Tour,HARD,2,Thomas Muster,Michael Chang,Thomas Muster,6-1; 5-7; 7-6(3),R16,151,5,2,56,101,33,56,33,45,7,10,16,66,101,7,3,40,100,30,40,29,60,9,13,15,59,100
1995-03-06 00:00:00.000,ATP Masters Series Indian Wells CA; U.S.A. ATP World Tour,HARD,2,Stefan Edberg,Alberto Berasategui,Stefan Edberg,6-1; 6-2,R16,55,4,4,30,50,27,30,9,20,1,1,8,36,50,3,2,49,64,25,49,6,15,9,13,7,31,64
1995-03-06 00:00:00.000,ATP Masters Series Indian Wells CA; U.S.A. ATP World Tour,HARD,2,Magnus Larsson,Michael Stich,Magnus Larsson,5-7; 7-6(6); 7-6(5),R16,143,6,7,83,128,55,83,24,45,6,10,18,79,128,16,7,61,124,51,61,33,63,4,7,18,84,124
1995-03-06 00:00:00.000,ATP Masters Series Indian Wells CA; U.S.A. ATP World Tour,HARD,2,Boris Becker,Marcelo Rios,Boris Becker,6-3; 3-2 RET,R16,58,5,2,26,43,25,26,6,17,1,1,8,31,43,3,2,38,56,23,38,9,18,3,5,7,32,56
1995-03-06 00:00:00.000,ATP Masters Series Indian Wells CA; U.S.A. ATP World Tour,HARD,2,Wayne Ferreira,Carlos Costa,Wayne Ferreira,6-3; 6-2,R16,62,8,1,38,55,32,38,7,17,0,0,9,39,55,1,3,28,52,17,28,13,24,4,7,8,30,52
1995-03-06 00:00:00.000,ATP Masters Series Indian Wells CA; U.S.A. ATP World Tour,HARD,2,Andre Agassi,Thomas Enqvist,Andre Agassi,6-1; 6-3,R16,65,4,1,33,44,23,33,8,11,1,2,8,31,44,2,1,40,60,22,40,5,20,6,11,8,27,60
1995-03-06 00:00:00.000,ATP Masters Series Indian Wells CA; U.S.A. ATP World Tour,HARD,2,Pete Sampras,Todd Martin,Pete Sampras,6-3; 6-4,Q,78,5,0,41,61,34,41,10,20,2,2,10,44,61,5,1,37,61,24,37,11,24,0,2,9,35,61
1995-03-06 00:00:00.000,ATP Masters Series Indian Wells CA; U.S.A. ATP World Tour,HARD,2,Stefan Edberg,Thomas Muster,Stefan Edberg,2-6; 6-4; 6-1,Q,93,2,6,43,75,33,43,16,32,5,7,12,49,75,2,2,44,72,29,44,16,28,3,7,13,45,72
1995-03-06 00:00:00.000,ATP Masters Series Indian Wells CA; U.S.A. ATP World Tour,HARD,2,Boris Becker,Magnus Larsson,Boris Becker,3-6; 6-1; 6-4,Q,89,10,2,40,69,35,40,17,29,0,1,13,52,69,3,2,47,79,31,47,18,32,7,10,13,49,79
1995-03-06 00:00:00.000,ATP Masters Series Indian Wells CA; U.S.A. ATP World Tour,HARD,2,Andre Agassi,Wayne Ferreira,Andre Agassi,6-3; 6-4,Q,75,1,1,35,57,28,35,14,22,2,3,10,42,57,4,2,29,56,20,29,12,27,3,6,9,32,56
1995-03-06 00:00:00.000,ATP Masters Series Indian Wells CA; U.S.A. ATP World Tour,HARD,2,Pete Sampras,Stefan Edberg,Pete Sampras,4-6; 6-3; 6-4,S,109,13,4,53,90,43,53,15,37,5,8,15,58,90,6,4,62,89,44,62,12,27,4,8,14,56,89
1995-03-06 00:00:00.000,ATP Masters Series Indian Wells CA; U.S.A. ATP World Tour,HARD,2,Andre Agassi,Boris Becker,Andre Agassi,6-4; 7-6(4),S,91,1,2,50,70,41,50,11,20,1,1,11,52,70,13,3,51,71,39,51,11,20,4,5,11,50,71
1995-03-06 00:00:00.000,ATP Masters Series Indian Wells CA; U.S.A. ATP World Tour,HARD,2,Pete Sampras,Andre Agassi,Pete Sampras,7-5; 6-3; 7-5,F,133,18,3,60,100,51,60,19,40,3,4,17,70,100,9,2,82,113,49,82,19,31,10,14,16,68,113
1995-03-06 00:00:00.000,Copenhagen Denmark ATP World Tour,HARD,2,Slava Dosedel,Patrik Langvardt,Slava Dosedel,6-4; 6-4,R32,72,1,5,35,61,26,35,19,26,2,2,10,45,61,3,2,39,57,27,39,10,18,3,5,10,37,57
1995-03-06 00:00:00.000,Copenhagen Denmark ATP World Tour,HARD,2,Andrei Olhovskiy,Lars Rehmann,Andrei Olhovskiy,7-6(4); 6-2,R32,83,9,1,38,62,31,38,14,24,2,3,10,45,62,7,3,53,78,31,53,15,25,6,9,10,46,78
1995-03-06 00:00:00.000,Copenhagen Denmark ATP World Tour,HARD,2,Sebastien Lareau,Kenneth Carlsen,Sebastien Lareau,7-6(5); 6-4,R32,89,11,6,42,75,36,42,16,33,2,3,11,52,75,13,6,43,72,33,43,11,29,0,2,11,44,72
1995-03-06 00:00:00.000,Copenhagen Denmark ATP World Tour,HARD,2,Jeremy Bates,Joern Renzenbrink,Jeremy Bates,6-2; 7-6(5),R32,83,2,3,35,59,28,35,14,24,0,1,10,42,59,9,11,54,89,37,54,10,35,11,14,10,47,89
1995-03-06 00:00:00.000,Copenhagen Denmark ATP World Tour,HARD,2,Jan Siemerink,David Prinosil,Jan Siemerink,6-4; 6-4,R32,70,4,3,42,70,33,42,16,28,6,6,10,49,70,9,4,32,64,26,32,15,32,3,5,10,41,64
1995-03-06 00:00:00.000,Copenhagen Denmark ATP World Tour,HARD,2,Jakob Hlasek,Cristiano Caratti,Jakob Hlasek,6-4; 7-6(6),R32,83,9,4,45,72,32,45,11,27,0,4,11,43,72,1,4,44,75,25,44,16,31,4,9,11,41,75
1995-03-06 00:00:00.000,Copenhagen Denmark ATP World Tour,HARD,2,Peter Lundgren,Joost Winnink,Peter Lundgren,6-4; 6-3,R32,60,6,2,32,54,27,32,15,22,1,1,10,42,54,4,3,34,60,24,34,12,26,2,4,9,36,60
1995-03-06 00:00:00.000,Copenhagen Denmark ATP World Tour,HARD,2,Karol Kucera,Stephane Simian,Karol Kucera,6-3; 6-4,R32,67,3,1,36,64,28,36,17,28,1,1,10,45,64,6,5,41,57,29,41,7,16,1,3,9,36,57
1995-03-06 00:00:00.000,Copenhagen Denmark ATP World Tour,HARD,2,Tomas Carbonell,Guillaume Raoux,Tomas Carbonell,6-0; 6-4,R32,58,4,2,30,46,23,30,10,16,1,2,8,33,46,0,2,28,54,16,28,9,26,5,10,8,25,54
1995-03-06 00:00:00.000,Copenhagen Denmark ATP World Tour,HARD,2,Anders Jarryd,Alexander Mronz,Anders Jarryd,6-4; 6-2,R32,67,6,3,34,55,31,34,9,21,2,2,9,40,55,7,2,29,52,19,29,12,23,4,7,9,31,52
1995-03-06 00:00:00.000,Copenhagen Denmark ATP World Tour,HARD,2,Greg Rusedski,Carl-Uwe Steeb,Greg Rusedski,7-6(3); 6-2,R32,82,13,7,35,72,30,35,23,37,3,3,10,53,72,1,2,35,68,27,35,16,33,2,4,10,43,68
1995-03-06 00:00:00.000,Copenhagen Denmark ATP World Tour,HARD,2,Pat Cash,Daniel Vacek,Pat Cash,7-6(1); 4-6; 7-6(6),R32,148,14,10,71,123,55,71,21,52,5,9,17,76,123,12,5,58,103,39,58,27,45,4,7,17,66,103
1995-03-06 00:00:00.000,Copenhagen Denmark ATP World Tour,HARD,2,Frederik Fetterlein,Gianluca Pozzi,Frederik Fetterlein,6-4; 7-6(5),R32,89,4,6,60,78,45,60,5,18,4,6,11,50,78,3,0,57,84,35,57,13,27,6,9,11,48,84
1995-03-06 00:00:00.000,Copenhagen Denmark ATP World Tour,HARD,2,Luiz Mattar,Paul Wekesa,Luiz Mattar,7-6(4); 6-3,R32,84,7,2,48,74,35,48,17,26,7,8,11,52,74,3,6,42,61,31,42,9,19,1,3,10,40,61
1995-03-06 00:00:00.000,Copenhagen Denmark ATP World Tour,HARD,2,Jean-Philippe Fleurian,Danny Sapsford,Jean-Philippe Fleurian,6-3; 6-4,R32,70,6,0,31,55,23,31,19,24,0,0,10,42,55,1,0,37,50,25,37,7,13,3,5,9,32,50
1995-03-06 00:00:00.000,Copenhagen Denmark ATP World Tour,HARD,2,Martin Sinner,Alexander Volkov,Martin Sinner,6-4; 6-7(5); 6-1,R32,91,14,7,52,85,44,52,17,33,1,2,15,61,85,5,5,43,83,32,43,15,40,0,4,14,47,83
1995-03-06 00:00:00.000,Copenhagen Denmark ATP World Tour,HARD,2,Andrei Olhovskiy,Slava Dosedel,Andrei Olhovskiy,6-3; 6-4,R16,57,9,0,38,53,32,38,9,15,2,2,10,41,53,11,2,27,54,21,27,13,27,1,3,9,34,54
1995-03-06 00:00:00.000,Copenhagen Denmark ATP World Tour,HARD,2,Jeremy Bates,Sebastien Lareau,Jeremy Bates,7-6(10); 7-5,R16,118,11,3,43,91,33,43,22,48,5,7,12,55,91,10,4,51,103,39,51,19,52,8,11,12,58,103
1995-03-06 00:00:00.000,Copenhagen Denmark ATP World Tour,HARD,2,Jan Siemerink,Jakob Hlasek,Jan Siemerink,7-6(5); 6-7(5); 6-1,R16,118,18,1,74,111,58,74,22,37,3,3,16,80,111,5,8,64,107,50,64,22,43,6,8,15,72,107
1995-03-06 00:00:00.000,Copenhagen Denmark ATP World Tour,HARD,2,Karol Kucera,Peter Lundgren,Karol Kucera,7-6(3); 6-3,R16,66,23,1,42,63,38,42,7,21,0,0,10,45,63,4,2,37,68,24,37,20,31,3,5,11,44,68
1995-03-06 00:00:00.000,Copenhagen Denmark ATP World Tour,HARD,2,Anders Jarryd,Tomas Carbonell,Anders Jarryd,6-3; 6-4,R16,76,8,1,34,57,25,34,15,23,2,3,10,40,57,11,2,35,71,24,35,14,36,3,6,9,38,71
1995-03-06 00:00:00.000,Copenhagen Denmark ATP World Tour,HARD,2,Pat Cash,Greg Rusedski,Pat Cash,3-6; 7-6(6); 7-6(3),R16,137,6,1,58,94,50,58,23,36,3,4,16,73,94,23,13,61,115,53,61,28,54,1,1,17,81,115
1995-03-06 00:00:00.000,Copenhagen Denmark ATP World Tour,HARD,2,Frederik Fetterlein,Luiz Mattar,Frederik Fetterlein,6-4; 6-4,R16,89,7,3,27,49,24,27,16,22,0,0,10,40,49,4,4,49,79,32,49,16,30,5,7,10,48,79
1995-03-06 00:00:00.000,Copenhagen Denmark ATP World Tour,HARD,2,Martin Sinner,Jean-Philippe Fleurian,Martin Sinner,6-4; 6-3,R16,79,8,2,31,52,23,31,15,21,1,1,9,38,52,7,1,45,74,29,45,14,29,6,9,10,43,74
1995-03-06 00:00:00.000,Copenhagen Denmark ATP World Tour,HARD,2,Andrei Olhovskiy,Jeremy Bates,Andrei Olhovskiy,6-1; 6-0,Q,50,6,2,25,43,21,25,9,18,0,0,7,30,43,5,4,26,50,14,26,6,24,9,14,6,20,50
1995-03-06 00:00:00.000,Copenhagen Denmark ATP World Tour,HARD,2,Karol Kucera,Jan Siemerink,Karol Kucera,6-4; 6-4,Q,64,7,1,32,58,24,32,20,26,4,4,10,44,58,7,1,33,55,27,33,10,22,2,4,10,37,55
1995-03-06 00:00:00.000,Copenhagen Denmark ATP World Tour,HARD,2,Anders Jarryd,Pat Cash,Anders Jarryd,6-1; 3-6; 6-2,Q,92,7,1,46,73,34,46,16,27,0,1,12,50,73,6,5,38,61,28,38,10,23,3,7,12,38,61
1995-03-06 00:00:00.000,Copenhagen Denmark ATP World Tour,HARD,2,Martin Sinner,Frederik Fetterlein,Martin Sinner,7-5; 7-5,Q,85,5,6,39,66,32,39,14,27,3,5,12,46,66,12,3,46,87,31,46,19,41,9,13,12,50,87
1995-03-06 00:00:00.000,Copenhagen Denmark ATP World Tour,HARD,2,Andrei Olhovskiy,Karol Kucera,Andrei Olhovskiy,6-2; 6-0,S,55,4,2,32,45,23,32,9,13,2,2,7,32,45,5,9,36,70,24,36,8,34,12,17,7,32,70
1995-03-06 00:00:00.000,Copenhagen Denmark ATP World Tour,HARD,2,Martin Sinner,Anders Jarryd,Martin Sinner,3-6; 6-4; 6-4,S,118,8,8,53,97,38,53,25,44,7,9,15,63,97,17,12,53,97,37,53,23,44,7,9,14,60,97
1995-03-06 00:00:00.000,Copenhagen Denmark ATP World Tour,HARD,2,Martin Sinner,Andrei Olhovskiy,Martin Sinner,6-7(3); 7-6(8); 6-3,F,115,17,5,57,102,46,57,30,45,1,1,16,76,102,23,3,80,111,61,80,18,31,4,6,17,79,111
1995-03-13 00:00:00.000,ATP Masters Series Miami FL; U.S.A. ATP World Tour,HARD,2,Pete Sampras,N/A Bye,Pete Sampras,,R128,0,0,0,0,0,0,0,0,0,0,0,0,0,0,0,0,0,0,0,0,0,0,0,0,0,0,0
1995-03-13 00:00:00.000,ATP Masters Series Miami FL; U.S.A. ATP World Tour,HARD,2,Derrick Rostagno,Mark Petchey,Derrick Rostagno,6-4; 3-6; 6-2,R128,115,4,4,51,87,34,51,20,36,6,9,13,54,87,1,3,67,106,42,67,18,39,7,12,14,60,106
1995-03-13 00:00:00.000,ATP Masters Series Miami FL; U.S.A. ATP World Tour,HARD,2,Mark Knowles,Brett Steven,Mark Knowles,7-5; 2-6; 6-4,R128,110,2,4,58,85,39,58,14,27,3,8,15,53,85,1,2,57,84,35,57,16,27,4,9,15,51,84
1995-03-13 00:00:00.000,ATP Masters Series Miami FL; U.S.A. ATP World Tour,HARD,2,Jared Palmer,N/A Bye,Jared Palmer,,R128,0,0,0,0,0,0,0,0,0,0,0,0,0,0,0,0,0,0,0,0,0,0,0,0,0,0,0
1995-03-13 00:00:00.000,ATP Masters Series Miami FL; U.S.A. ATP World Tour,HARD,2,Bernd Karbacher,N/A Bye,Bernd Karbacher,,R128,0,0,0,0,0,0,0,0,0,0,0,0,0,0,0,0,0,0,0,0,0,0,0,0,0,0,0
1995-03-13 00:00:00.000,ATP Masters Series Miami FL; U.S.A. ATP World Tour,HARD,2,Richey Reneberg,Fernando Meligeni,Richey Reneberg,6-2; 6-4,R128,82,6,2,34,62,24,34,14,28,7,9,9,38,62,7,0,46,67,28,46,5,21,6,11,9,33,67
1995-03-13 00:00:00.000,ATP Masters Series Miami FL; U.S.A. ATP World Tour,HARD,2,Marcos Ondruska,Alex Radulescu,Marcos Ondruska,7-6(5); 7-6(6),R128,113,8,3,47,91,33,47,31,44,3,3,12,64,91,6,0,50,87,35,50,24,37,2,2,12,59,87
1995-03-13 00:00:00.000,ATP Masters Series Miami FL; U.S.A. ATP World Tour,HARD,2,Alex Corretja,N/A Bye,Alex Corretja,,R128,0,0,0,0,0,0,0,0,0,0,0,0,0,0,0,0,0,0,0,0,0,0,0,0,0,0,0
1995-03-13 00:00:00.000,ATP Masters Series Miami FL; U.S.A. ATP World Tour,HARD,2,Andrei Medvedev,N/A Bye,Andrei Medvedev,,R128,0,0,0,0,0,0,0,0,0,0,0,0,0,0,0,0,0,0,0,0,0,0,0,0,0,0,0
1995-03-13 00:00:00.000,ATP Masters Series Miami FL; U.S.A. ATP World Tour,HARD,2,Lionel Roux,Markus Zoecke,Lionel Roux,6-3; 6-2,R128,58,1,0,21,41,18,21,18,20,0,0,9,36,41,3,0,24,43,19,24,6,19,0,3,8,25,43
1995-03-13 00:00:00.000,ATP Masters Series Miami FL; U.S.A. ATP World Tour,HARD,2,Patrick McEnroe,Horst Skoff,Patrick McEnroe,6-3; 7-6(6),R128,87,6,1,40,64,35,40,14,24,3,4,11,49,64,10,6,41,79,32,41,17,38,4,6,10,49,79
1995-03-13 00:00:00.000,ATP Masters Series Miami FL; U.S.A. ATP World Tour,HARD,2,Javier Sanchez,N/A Bye,Javier Sanchez,,R128,0,0,0,0,0,0,0,0,0,0,0,0,0,0,0,0,0,0,0,0,0,0,0,0,0,0,0
1995-03-13 00:00:00.000,ATP Masters Series Miami FL; U.S.A. ATP World Tour,HARD,2,Mark Woodforde,N/A Bye,Mark Woodforde,,R128,0,0,0,0,0,0,0,0,0,0,0,0,0,0,0,0,0,0,0,0,0,0,0,0,0,0,0
1995-03-13 00:00:00.000,ATP Masters Series Miami FL; U.S.A. ATP World Tour,HARD,2,Jan Apell,Steve Bryan,Jan Apell,6-0; 7-5,R128,62,12,0,27,45,22,27,10,18,0,1,9,32,45,0,4,30,55,18,30,7,25,4,9,9,25,55
1995-03-13 00:00:00.000,ATP Masters Series Miami FL; U.S.A. ATP World Tour,HARD,2,Jean-Philippe Fleurian,Emilio Sanchez,Jean-Philippe Fleurian,6-3; 7-5,R128,89,6,0,34,61,27,34,16,27,2,3,10,43,61,3,1,53,75,28,53,14,22,7,11,11,42,75
1995-03-13 00:00:00.000,ATP Masters Series Miami FL; U.S.A. ATP World Tour,HARD,2,Jim Courier,N/A Bye,Jim Courier,,R128,0,0,0,0,0,0,0,0,0,0,0,0,0,0,0,0,0,0,0,0,0,0,0,0,0,0,0
1995-03-13 00:00:00.000,ATP Masters Series Miami FL; U.S.A. ATP World Tour,HARD,2,Michael Chang,N/A Bye,Michael Chang,,R128,0,0,0,0,0,0,0,0,0,0,0,0,0,0,0,0,0,0,0,0,0,0,0,0,0,0,0
1995-03-13 00:00:00.000,ATP Masters Series Miami FL; U.S.A. ATP World Tour,HARD,2,Jim Grabb,Luiz Mattar,Jim Grabb,6-7(3); 6-4; 7-6(5),R128,169,7,3,79,108,60,79,17,29,5,7,17,77,108,1,2,91,142,59,91,28,51,13,16,17,87,142
1995-03-13 00:00:00.000,ATP Masters Series Miami FL; U.S.A. ATP World Tour,HARD,2,Jan Siemerink,Leander Paes,Jan Siemerink,6-4; 6-4,R128,74,6,1,30,48,27,30,14,18,1,1,10,41,48,3,2,37,65,25,37,16,28,5,7,10,41,65
1995-03-13 00:00:00.000,ATP Masters Series Miami FL; U.S.A. ATP World Tour,HARD,2,Olivier Delaitre,N/A Bye,Olivier Delaitre,,R128,0,0,0,0,0,0,0,0,0,0,0,0,0,0,0,0,0,0,0,0,0,0,0,0,0,0,0
1995-03-13 00:00:00.000,ATP Masters Series Miami FL; U.S.A. ATP World Tour,HARD,2,Karel Novacek,N/A Bye,Karel Novacek,,R128,0,0,0,0,0,0,0,0,0,0,0,0,0,0,0,0,0,0,0,0,0,0,0,0,0,0,0
1995-03-13 00:00:00.000,ATP Masters Series Miami FL; U.S.A. ATP World Tour,HARD,2,Mats Wilander,Louis Gloria,Mats Wilander,4-6; 6-3; 6-3,R128,134,1,3,59,95,39,59,21,36,5,8,14,60,95,3,7,62,97,37,62,17,35,7,12,14,54,97
1995-03-13 00:00:00.000,ATP Masters Series Miami FL; U.S.A. ATP World Tour,HARD,2,Jonathan Stark,Mauricio Hadad,Jonathan Stark,6-1; 7-6(8),R128,70,5,2,35,53,32,35,14,18,0,0,10,46,53,2,3,39,62,28,39,10,23,3,5,9,38,62
1995-03-13 00:00:00.000,ATP Masters Series Miami FL; U.S.A. ATP World Tour,HARD,2,Patrick Rafter,N/A Bye,Patrick Rafter,,R128,0,0,0,0,0,0,0,0,0,0,0,0,0,0,0,0,0,0,0,0,0,0,0,0,0,0,0
1995-03-13 00:00:00.000,ATP Masters Series Miami FL; U.S.A. ATP World Tour,HARD,2,Stefan Edberg,N/A Bye,Stefan Edberg,,R128,0,0,0,0,0,0,0,0,0,0,0,0,0,0,0,0,0,0,0,0,0,0,0,0,0,0,0
1995-03-13 00:00:00.000,ATP Masters Series Miami FL; U.S.A. ATP World Tour,HARD,2,Karsten Braasch,Daniel Vacek,Karsten Braasch,6-2; 3-6; 6-3,R128,79,13,1,47,72,36,47,15,25,3,4,13,51,72,3,6,48,80,35,48,14,32,4,7,13,49,80
1995-03-13 00:00:00.000,ATP Masters Series Miami FL; U.S.A. ATP World Tour,HARD,2,Michael Tebbutt,Jeff Tarango,Michael Tebbutt,6-7(7); 7-6(5); 7-6(4),R128,153,28,12,74,158,58,74,39,84,11,15,18,97,158,10,7,84,124,59,84,23,40,5,9,18,82,124
1995-03-13 00:00:00.000,ATP Masters Series Miami FL; U.S.A. ATP World Tour,HARD,2,Guy Forget,N/A Bye,Guy Forget,,R128,0,0,0,0,0,0,0,0,0,0,0,0,0,0,0,0,0,0,0,0,0,0,0,0,0,0,0
1995-03-13 00:00:00.000,ATP Masters Series Miami FL; U.S.A. ATP World Tour,HARD,2,Francisco Clavet,N/A Bye,Francisco Clavet,,R128,0,0,0,0,0,0,0,0,0,0,0,0,0,0,0,0,0,0,0,0,0,0,0,0,0,0,0
1995-03-13 00:00:00.000,ATP Masters Series Miami FL; U.S.A. ATP World Tour,HARD,2,Jonas Bjorkman,Gianluca Pozzi,Jonas Bjorkman,7-6(1); 6-3,R128,99,3,3,49,89,36,49,19,40,12,13,10,55,89,1,3,34,75,26,34,17,41,3,6,11,43,75
1995-03-13 00:00:00.000,ATP Masters Series Miami FL; U.S.A. ATP World Tour,HARD,2,Michael Joyce,Arnaud Boetsch,Michael Joyce,6-3; 6-2,R128,55,1,2,31,53,27,31,11,22,1,1,9,38,53,2,1,26,49,18,26,10,23,2,5,8,28,49
1995-03-13 00:00:00.000,ATP Masters Series Miami FL; U.S.A. ATP World Tour,HARD,2,Michael Stich,N/A Bye,Michael Stich,,R128,0,0,0,0,0,0,0,0,0,0,0,0,0,0,0,0,0,0,0,0,0,0,0,0,0,0,0
1995-03-13 00:00:00.000,ATP Masters Series Miami FL; U.S.A. ATP World Tour,HARD,2,Richard Krajicek,N/A Bye,Richard Krajicek,,R128,0,0,0,0,0,0,0,0,0,0,0,0,0,0,0,0,0,0,0,0,0,0,0,0,0,0,0
1995-03-13 00:00:00.000,ATP Masters Series Miami FL; U.S.A. ATP World Tour,HARD,2,Paul Kilderry,Kenny Thorne,Paul Kilderry,6-4; 7-5,R128,90,1,9,42,80,30,42,20,38,5,7,11,50,80,2,5,44,77,29,44,13,33,6,10,11,42,77
1995-03-13 00:00:00.000,ATP Masters Series Miami FL; U.S.A. ATP World Tour,HARD,2,Oliver Gross,Sergio Casal,Oliver Gross,6-3; 5-7; 6-4,R128,113,4,6,63,107,49,63,11,44,9,14,15,60,107,2,2,47,89,28,47,20,42,2,9,16,48,89
1995-03-13 00:00:00.000,ATP Masters Series Miami FL; U.S.A. ATP World Tour,HARD,2,Aaron Krickstein,N/A Bye,Aaron Krickstein,,R128,0,0,0,0,0,0,0,0,0,0,0,0,0,0,0,0,0,0,0,0,0,0,0,0,0,0,0
1995-03-13 00:00:00.000,ATP Masters Series Miami FL; U.S.A. ATP World Tour,HARD,2,Carlos Costa,N/A Bye,Carlos Costa,,R128,0,0,0,0,0,0,0,0,0,0,0,0,0,0,0,0,0,0,0,0,0,0,0,0,0,0,0
1995-03-13 00:00:00.000,ATP Masters Series Miami FL; U.S.A. ATP World Tour,HARD,2,Henrik Holm,Scott Humphries,Henrik Holm,4-6; 6-4; 7-5,R128,123,12,10,55,94,41,55,21,39,6,8,16,62,94,3,3,59,100,36,59,26,41,6,9,16,62,100
1995-03-13 00:00:00.000,ATP Masters Series Miami FL; U.S.A. ATP World Tour,HARD,2,Eyal Ran,Neville Godwin,Eyal Ran,1-6; 6-4; 6-3,R128,117,2,4,44,85,26,44,21,41,10,15,13,47,85,1,4,66,95,40,66,12,29,10,15,13,52,95
1995-03-13 00:00:00.000,ATP Masters Series Miami FL; U.S.A. ATP World Tour,HARD,2,Magnus Larsson,N/A Bye,Magnus Larsson,,R128,0,0,0,0,0,0,0,0,0,0,0,0,0,0,0,0,0,0,0,0,0,0,0,0,0,0,0
1995-03-13 00:00:00.000,ATP Masters Series Miami FL; U.S.A. ATP World Tour,HARD,2,Thomas Enqvist,N/A Bye,Thomas Enqvist,,R128,0,0,0,0,0,0,0,0,0,0,0,0,0,0,0,0,0,0,0,0,0,0,0,0,0,0,0
1995-03-13 00:00:00.000,ATP Masters Series Miami FL; U.S.A. ATP World Tour,HARD,2,Radomir Vasek,Diego Nargiso,Radomir Vasek,4-6; 6-4; 7-6(5),R128,141,1,10,69,108,49,69,15,39,7,12,16,64,108,18,6,53,104,38,53,22,51,5,10,16,60,104
1995-03-13 00:00:00.000,ATP Masters Series Miami FL; U.S.A. ATP World Tour,HARD,2,Alex O'Brien,Christian Ruud,Alex O'Brien,7-5; 6-4,R128,98,3,4,46,73,34,46,13,27,7,9,11,47,73,2,7,34,72,22,34,19,38,10,14,11,41,72
1995-03-13 00:00:00.000,ATP Masters Series Miami FL; U.S.A. ATP World Tour,HARD,2,David Wheaton,N/A Bye,David Wheaton,,R128,0,0,0,0,0,0,0,0,0,0,0,0,0,0,0,0,0,0,0,0,0,0,0,0,0,0,0
1995-03-13 00:00:00.000,ATP Masters Series Miami FL; U.S.A. ATP World Tour,HARD,2,Jaime Yzaga,N/A Bye,Jaime Yzaga,,R128,0,0,0,0,0,0,0,0,0,0,0,0,0,0,0,0,0,0,0,0,0,0,0,0,0,0,0
1995-03-13 00:00:00.000,ATP Masters Series Miami FL; U.S.A. ATP World Tour,HARD,2,Bryan Shelton,Hendrik Dreekmann,Bryan Shelton,4-6; 6-2; 6-4,R128,100,10,3,40,72,30,40,22,32,2,4,14,52,72,7,6,54,97,41,54,16,43,2,6,14,57,97
1995-03-13 00:00:00.000,ATP Masters Series Miami FL; U.S.A. ATP World Tour,HARD,2,Renzo Furlan,Maurice Ruah,Renzo Furlan,6-4; 6-3,R128,70,3,1,31,60,21,31,18,29,2,4,10,39,60,1,1,34,58,21,34,10,24,4,8,9,31,58
1995-03-13 00:00:00.000,ATP Masters Series Miami FL; U.S.A. ATP World Tour,HARD,2,Alberto Berasategui,N/A Bye,Alberto Berasategui,,R128,0,0,0,0,0,0,0,0,0,0,0,0,0,0,0,0,0,0,0,0,0,0,0,0,0,0,0
1995-03-13 00:00:00.000,ATP Masters Series Miami FL; U.S.A. ATP World Tour,HARD,2,Wayne Ferreira,N/A Bye,Wayne Ferreira,,R128,0,0,0,0,0,0,0,0,0,0,0,0,0,0,0,0,0,0,0,0,0,0,0,0,0,0,0
1995-03-13 00:00:00.000,ATP Masters Series Miami FL; U.S.A. ATP World Tour,HARD,2,Luis Herrera,Daniel Orsanic,Luis Herrera,6-2; 6-3,R128,66,1,0,41,51,32,41,5,10,0,0,9,37,51,2,5,31,60,20,31,12,29,9,12,8,32,60
1995-03-13 00:00:00.000,ATP Masters Series Miami FL; U.S.A. ATP World Tour,HARD,2,Mark Philippoussis,Christian Bergstrom,Mark Philippoussis,3-6; 7-6(3); 6-2,R128,115,18,5,47,85,41,47,19,38,1,2,14,60,85,1,0,64,100,42,64,22,36,1,3,15,64,100
1995-03-13 00:00:00.000,ATP Masters Series Miami FL; U.S.A. ATP World Tour,HARD,2,Paul Haarhuis,N/A Bye,Paul Haarhuis,,R128,0,0,0,0,0,0,0,0,0,0,0,0,0,0,0,0,0,0,0,0,0,0,0,0,0,0,0
1995-03-13 00:00:00.000,ATP Masters Series Miami FL; U.S.A. ATP World Tour,HARD,2,Petr Korda,N/A Bye,Petr Korda,,R128,0,0,0,0,0,0,0,0,0,0,0,0,0,0,0,0,0,0,0,0,0,0,0,0,0,0,0
1995-03-13 00:00:00.000,ATP Masters Series Miami FL; U.S.A. ATP World Tour,HARD,2,Marcelo Rios,Lars Jonsson,Marcelo Rios,6-3; 3-6; 7-6(7),R128,122,6,4,62,103,42,62,23,41,3,6,15,65,103,4,1,61,104,44,61,21,43,8,11,15,65,104
1995-03-13 00:00:00.000,ATP Masters Series Miami FL; U.S.A. ATP World Tour,HARD,2,Todd Woodbridge,Brad Gilbert,Todd Woodbridge,7-6(5); 7-5,R128,107,0,6,49,80,31,49,11,31,4,9,12,42,80,1,7,43,75,26,43,11,32,3,9,12,37,75
1995-03-13 00:00:00.000,ATP Masters Series Miami FL; U.S.A. ATP World Tour,HARD,2,Todd Martin,N/A Bye,Todd Martin,,R128,0,0,0,0,0,0,0,0,0,0,0,0,0,0,0,0,0,0,0,0,0,0,0,0,0,0,0
1995-03-13 00:00:00.000,ATP Masters Series Miami FL; U.S.A. ATP World Tour,HARD,2,Jacco Eltingh,N/A Bye,Jacco Eltingh,,R128,0,0,0,0,0,0,0,0,0,0,0,0,0,0,0,0,0,0,0,0,0,0,0,0,0,0,0
1995-03-13 00:00:00.000,ATP Masters Series Miami FL; U.S.A. ATP World Tour,HARD,2,MaliVai Washington,Claude N'Goran,MaliVai Washington,6-4; 6-2,R128,63,6,2,28,42,25,28,11,14,0,0,9,36,42,1,3,30,59,19,30,13,29,7,10,9,32,59
1995-03-13 00:00:00.000,ATP Masters Series Miami FL; U.S.A. ATP World Tour,HARD,2,Vincent Spadea,Byron Black,Vincent Spadea,6-1; 6-3,R128,73,5,0,41,67,28,41,13,26,11,12,8,41,67,0,5,36,61,20,36,8,25,4,9,8,28,61
1995-03-13 00:00:00.000,ATP Masters Series Miami FL; U.S.A. ATP World Tour,HARD,2,Jason Stoltenberg,N/A Bye,Jason Stoltenberg,,R128,0,0,0,0,0,0,0,0,0,0,0,0,0,0,0,0,0,0,0,0,0,0,0,0,0,0,0
1995-03-13 00:00:00.000,ATP Masters Series Miami FL; U.S.A. ATP World Tour,HARD,2,Richard Fromberg,N/A Bye,Richard Fromberg,,R128,0,0,0,0,0,0,0,0,0,0,0,0,0,0,0,0,0,0,0,0,0,0,0,0,0,0,0
1995-03-13 00:00:00.000,ATP Masters Series Miami FL; U.S.A. ATP World Tour,HARD,2,Tommy Ho,Andrei Olhovskiy,Tommy Ho,6-2; 6-3,R128,61,5,0,32,52,24,32,8,20,1,3,8,32,52,3,2,28,50,13,28,9,22,3,9,9,22,50
1995-03-13 00:00:00.000,ATP Masters Series Miami FL; U.S.A. ATP World Tour,HARD,2,Shuzo Matsuoka,David Rikl,Shuzo Matsuoka,6-4; 6-3,R128,73,8,1,33,57,27,33,11,24,0,1,10,38,57,2,3,29,54,19,29,14,25,2,5,9,33,54
1995-03-13 00:00:00.000,ATP Masters Series Miami FL; U.S.A. ATP World Tour,HARD,2,Andre Agassi,N/A Bye,Andre Agassi,,R128,0,0,0,0,0,0,0,0,0,0,0,0,0,0,0,0,0,0,0,0,0,0,0,0,0,0,0
1995-03-13 00:00:00.000,ATP Masters Series Miami FL; U.S.A. ATP World Tour,HARD,2,Pete Sampras,Derrick Rostagno,Pete Sampras,6-3; 6-2,R64,63,5,2,22,55,20,22,19,33,3,3,9,39,55,3,3,27,49,18,27,9,22,2,5,8,27,49
1995-03-13 00:00:00.000,ATP Masters Series Miami FL; U.S.A. ATP World Tour,HARD,2,Jared Palmer,Mark Knowles,Jared Palmer,6-4; 3-6; 6-4,R64,121,3,3,54,97,37,54,16,43,1,7,15,53,97,3,9,58,97,35,58,15,39,7,13,14,50,97
1995-03-13 00:00:00.000,ATP Masters Series Miami FL; U.S.A. ATP World Tour,HARD,2,Bernd Karbacher,Richey Reneberg,Bernd Karbacher,6-3; 6-3,R64,82,5,4,31,66,27,31,14,35,4,5,9,41,66,2,1,39,71,22,39,16,32,7,11,9,38,71
1995-03-13 00:00:00.000,ATP Masters Series Miami FL; U.S.A. ATP World Tour,HARD,2,Marcos Ondruska,Alex Corretja,Marcos Ondruska,6-7(2); 6-2; 6-1,R64,142,3,2,51,116,37,51,35,65,7,8,14,72,116,1,3,61,91,39,61,12,30,5,10,13,51,91
1995-03-13 00:00:00.000,ATP Masters Series Miami FL; U.S.A. ATP World Tour,HARD,2,Andrei Medvedev,Lionel Roux,Andrei Medvedev,6-4; 6-7(1); 6-3,R64,146,4,4,60,104,43,60,23,44,4,6,16,66,104,4,6,78,130,44,78,31,52,13,17,15,75,130
1995-03-13 00:00:00.000,ATP Masters Series Miami FL; U.S.A. ATP World Tour,HARD,2,Patrick McEnroe,Javier Sanchez,Patrick McEnroe,6-3; 7-6(5),R64,91,4,3,51,69,30,51,10,18,2,5,11,40,69,3,2,42,64,26,42,8,22,3,7,10,34,64
1995-03-13 00:00:00.000,ATP Masters Series Miami FL; U.S.A. ATP World Tour,HARD,2,Mark Woodforde,Jan Apell,Mark Woodforde,0-6; 6-1; 6-3,R64,82,3,4,37,65,28,37,12,28,1,4,11,40,65,7,5,40,71,28,40,13,31,2,6,11,41,71
1995-03-13 00:00:00.000,ATP Masters Series Miami FL; U.S.A. ATP World Tour,HARD,2,Jim Courier,Jean-Philippe Fleurian,Jim Courier,6-3; 6-4,R64,77,4,2,31,59,25,31,17,28,2,3,10,42,59,0,4,25,53,18,25,12,28,2,5,9,30,53
1995-03-13 00:00:00.000,ATP Masters Series Miami FL; U.S.A. ATP World Tour,HARD,2,Michael Chang,Jim Grabb,Michael Chang,6-0; 6-3,R64,73,4,5,31,58,26,31,13,27,3,3,8,39,58,1,4,33,51,15,33,10,18,4,8,7,25,51
1995-03-13 00:00:00.000,ATP Masters Series Miami FL; U.S.A. ATP World Tour,HARD,2,Jan Siemerink,Olivier Delaitre,Jan Siemerink,6-7(6); 6-3; 6-3,R64,115,7,3,59,110,41,59,31,51,7,9,15,72,110,2,7,73,105,47,73,13,32,5,10,15,60,105
1995-03-13 00:00:00.000,ATP Masters Series Miami FL; U.S.A. ATP World Tour,HARD,2,Mats Wilander,Karel Novacek,Mats Wilander,2-6; 7-6(1); 6-3,R64,107,5,2,62,85,40,62,13,23,2,6,14,53,85,6,3,55,94,39,55,14,39,6,10,15,53,94
1995-03-13 00:00:00.000,ATP Masters Series Miami FL; U.S.A. ATP World Tour,HARD,2,Patrick Rafter,Jonathan Stark,Patrick Rafter,1-6; 6-4; 7-5,R64,124,3,7,49,90,26,49,17,41,6,14,15,43,90,4,6,46,89,29,46,16,43,5,12,14,45,89
1995-03-13 00:00:00.000,ATP Masters Series Miami FL; U.S.A. ATP World Tour,HARD,2,Karsten Braasch,Stefan Edberg,Karsten Braasch,6-3; 7-6(1),R64,96,10,0,45,87,33,45,25,42,6,7,11,58,87,2,7,44,76,28,44,17,32,5,7,10,45,76
1995-03-13 00:00:00.000,ATP Masters Series Miami FL; U.S.A. ATP World Tour,HARD,2,Michael Tebbutt,Guy Forget,Michael Tebbutt,6-7(5); 7-6(2); 6-3,R64,123,13,4,49,101,40,49,30,52,5,7,17,70,101,7,2,64,103,47,64,20,39,3,6,16,67,103
1995-03-13 00:00:00.000,ATP Masters Series Miami FL; U.S.A. ATP World Tour,HARD,2,Jonas Bjorkman,Francisco Clavet,Jonas Bjorkman,6-3; 6-7(5); 6-2,R64,123,5,4,41,85,32,41,22,44,6,9,14,54,85,1,2,70,105,42,70,12,35,8,15,15,54,105
1995-03-13 00:00:00.000,ATP Masters Series Miami FL; U.S.A. ATP World Tour,HARD,2,Michael Joyce,Michael Stich,Michael Joyce,6-3; 6-2,R64,61,2,1,30,59,22,30,19,29,6,6,9,41,59,5,6,26,50,18,26,9,24,1,4,8,27,50
1995-03-13 00:00:00.000,ATP Masters Series Miami FL; U.S.A. ATP World Tour,HARD,2,Paul Kilderry,Richard Krajicek,Paul Kilderry,6-3; 3-6; 6-2,R64,80,1,1,38,64,31,38,20,26,3,4,13,51,64,8,5,33,72,22,33,24,39,2,5,13,46,72
1995-03-13 00:00:00.000,ATP Masters Series Miami FL; U.S.A. ATP World Tour,HARD,2,Aaron Krickstein,Oliver Gross,Aaron Krickstein,6-3; 6-2,R64,77,2,2,39,76,26,39,20,37,4,5,9,46,76,2,5,30,57,19,30,7,27,5,9,8,26,57
1995-03-13 00:00:00.000,ATP Masters Series Miami FL; U.S.A. ATP World Tour,HARD,2,Carlos Costa,Henrik Holm,Carlos Costa,7-6(5); 3-6; 6-2,R64,105,1,2,69,100,46,69,21,31,4,6,15,67,100,0,11,45,82,33,45,23,37,1,3,14,56,82
1995-03-13 00:00:00.000,ATP Masters Series Miami FL; U.S.A. ATP World Tour,HARD,2,Magnus Larsson,Eyal Ran,Magnus Larsson,6-4; 6-3,R64,68,9,1,28,44,25,28,11,16,0,0,9,36,44,2,0,37,65,22,37,14,28,7,10,10,36,65
1995-03-13 00:00:00.000,ATP Masters Series Miami FL; U.S.A. ATP World Tour,HARD,2,Thomas Enqvist,Radomir Vasek,Thomas Enqvist,6-3; 3-6; 6-0,R64,90,8,7,39,74,30,39,16,35,4,7,12,46,74,6,5,42,71,28,42,10,29,3,9,12,38,71
1995-03-13 00:00:00.000,ATP Masters Series Miami FL; U.S.A. ATP World Tour,HARD,2,David Wheaton,Alex O'Brien,David Wheaton,6-4; 6-2,R64,65,7,0,26,41,23,26,13,15,0,0,9,36,41,3,4,36,61,25,36,9,25,2,5,9,34,61
1995-03-13 00:00:00.000,ATP Masters Series Miami FL; U.S.A. ATP World Tour,HARD,2,Jaime Yzaga,Bryan Shelton,Jaime Yzaga,6-2; 7-6(5),R64,89,1,1,34,74,25,34,26,40,2,2,10,51,74,1,5,42,75,27,42,18,33,6,8,10,45,75
1995-03-13 00:00:00.000,ATP Masters Series Miami FL; U.S.A. ATP World Tour,HARD,2,Alberto Berasategui,Renzo Furlan,Alberto Berasategui,6-3; 6-3,R64,56,2,0,36,51,24,36,11,15,1,2,9,35,51,0,4,24,46,16,24,9,22,0,4,9,25,46
1995-03-13 00:00:00.000,ATP Masters Series Miami FL; U.S.A. ATP World Tour,HARD,2,Wayne Ferreira,Luis Herrera,Wayne Ferreira,6-4; 6-2,R64,65,2,1,24,52,19,24,16,28,1,3,9,35,52,1,2,43,60,25,43,4,17,3,8,9,29,60
1995-03-13 00:00:00.000,ATP Masters Series Miami FL; U.S.A. ATP World Tour,HARD,2,Mark Philippoussis,Paul Haarhuis,Mark Philippoussis,7-6(4); 6-3,R64,77,8,1,40,67,33,40,13,27,5,7,11,46,67,1,1,37,64,27,37,12,27,5,8,10,39,64
1995-03-13 00:00:00.000,ATP Masters Series Miami FL; U.S.A. ATP World Tour,HARD,2,Marcelo Rios,Petr Korda,Marcelo Rios,6-3; 7-6(5),R64,80,0,2,44,58,34,44,7,14,0,1,10,41,58,8,7,49,85,29,49,21,36,6,9,11,50,85
1995-03-13 00:00:00.000,ATP Masters Series Miami FL; U.S.A. ATP World Tour,HARD,2,Todd Woodbridge,Todd Martin,Todd Woodbridge,6-2; 7-6(8),R64,90,4,5,34,63,28,34,20,29,0,0,10,48,63,3,3,37,74,26,37,19,37,3,5,10,45,74
1995-03-13 00:00:00.000,ATP Masters Series Miami FL; U.S.A. ATP World Tour,HARD,2,MaliVai Washington,Jacco Eltingh,MaliVai Washington,7-6(3); 6-1,R64,88,10,2,40,67,31,40,16,27,2,3,10,47,67,4,7,32,75,21,32,21,43,9,12,9,42,75
1995-03-13 00:00:00.000,ATP Masters Series Miami FL; U.S.A. ATP World Tour,HARD,2,Vincent Spadea,Jason Stoltenberg,Vincent Spadea,7-6(2); 6-3,R64,89,1,0,56,92,35,56,22,36,6,8,10,57,92,2,1,47,63,32,47,6,16,3,7,11,38,63
1995-03-13 00:00:00.000,ATP Masters Series Miami FL; U.S.A. ATP World Tour,HARD,2,Tommy Ho,Richard Fromberg,Tommy Ho,7-6(3); 6-3,R64,86,0,0,44,71,34,44,18,27,0,1,11,52,71,5,1,36,56,26,36,10,20,0,2,10,36,56
1995-03-13 00:00:00.000,ATP Masters Series Miami FL; U.S.A. ATP World Tour,HARD,2,Andre Agassi,Shuzo Matsuoka,Andre Agassi,6-2; 6-4,R64,72,1,2,23,48,17,23,16,25,0,1,9,33,48,8,2,32,65,19,32,17,33,6,10,9,36,65
1995-03-13 00:00:00.000,ATP Masters Series Miami FL; U.S.A. ATP World Tour,HARD,2,Pete Sampras,Jared Palmer,Pete Sampras,6-4; 6-4,R32,77,7,2,26,56,22,26,18,30,2,3,10,40,56,8,6,51,77,31,51,11,26,3,6,10,42,77
1995-03-13 00:00:00.000,ATP Masters Series Miami FL; U.S.A. ATP World Tour,HARD,2,Bernd Karbacher,Marcos Ondruska,Bernd Karbacher,6-3; 6-0,R32,60,5,2,23,47,20,23,13,24,3,4,8,33,47,0,4,15,40,7,15,9,25,0,5,7,16,40
1995-03-13 00:00:00.000,ATP Masters Series Miami FL; U.S.A. ATP World Tour,HARD,2,Andrei Medvedev,Patrick McEnroe,Andrei Medvedev,6-4; 7-6(6),R32,44,4,4,28,59,22,28,14,31,1,4,11,36,59,1,4,39,82,20,39,22,43,8,12,11,42,82
1995-03-13 00:00:00.000,ATP Masters Series Miami FL; U.S.A. ATP World Tour,HARD,2,Mark Woodforde,Jim Courier,Mark Woodforde,6-3; 6-4,R32,90,2,0,45,60,30,45,12,15,1,2,10,42,60,2,3,40,74,25,40,15,34,8,11,9,40,74
1995-03-13 00:00:00.000,ATP Masters Series Miami FL; U.S.A. ATP World Tour,HARD,2,Jan Siemerink,Michael Chang,Jan Siemerink,6-4; 3-6; 6-2,R32,105,7,7,49,86,38,49,17,37,5,7,13,55,86,2,2,39,86,29,39,27,47,12,16,14,56,86
1995-03-13 00:00:00.000,ATP Masters Series Miami FL; U.S.A. ATP World Tour,HARD,2,Mats Wilander,Patrick Rafter,Mats Wilander,6-2; 6-2,R32,62,2,2,36,43,30,36,4,7,1,1,8,34,43,1,2,19,44,12,19,10,25,0,4,8,22,44
1995-03-13 00:00:00.000,ATP Masters Series Miami FL; U.S.A. ATP World Tour,HARD,2,Karsten Braasch,Michael Tebbutt,Karsten Braasch,6-4; 6-4,R32,72,7,1,41,64,29,41,14,23,4,5,10,43,64,4,2,36,57,24,36,11,21,5,8,10,35,57
1995-03-13 00:00:00.000,ATP Masters Series Miami FL; U.S.A. ATP World Tour,HARD,2,Jonas Bjorkman,Michael Joyce,Jonas Bjorkman,6-3; 6-1,R32,56,4,1,27,46,20,27,10,19,1,2,8,30,46,0,3,26,49,13,26,10,23,4,9,8,23,49
1995-03-13 00:00:00.000,ATP Masters Series Miami FL; U.S.A. ATP World Tour,HARD,2,Paul Kilderry,Aaron Krickstein,Paul Kilderry,6-2; 6-2,R32,54,7,1,22,42,20,22,13,20,2,2,8,33,42,4,4,33,54,18,33,9,21,3,7,8,27,54
1995-03-13 00:00:00.000,ATP Masters Series Miami FL; U.S.A. ATP World Tour,HARD,2,Magnus Larsson,Carlos Costa,Magnus Larsson,2-6; 6-3; 6-4,R32,108,7,1,43,87,36,43,22,44,2,4,14,58,87,3,3,50,91,36,50,22,41,7,9,13,58,91
1995-03-13 00:00:00.000,ATP Masters Series Miami FL; U.S.A. ATP World Tour,HARD,2,Thomas Enqvist,David Wheaton,Thomas Enqvist,7-5; 6-4,R32,81,11,6,37,64,35,37,13,27,4,4,11,48,64,5,2,46,75,30,46,19,29,5,7,11,49,75
1995-03-13 00:00:00.000,ATP Masters Series Miami FL; U.S.A. ATP World Tour,HARD,2,Jaime Yzaga,Alberto Berasategui,Jaime Yzaga,6-2; 4-6; 6-3,R32,101,1,2,51,87,35,51,17,36,7,11,14,52,87,3,4,57,88,33,57,13,31,5,11,13,46,88
1995-03-13 00:00:00.000,ATP Masters Series Miami FL; U.S.A. ATP World Tour,HARD,2,Wayne Ferreira,Mark Philippoussis,Wayne Ferreira,6-4; 7-5,R32,91,7,1,41,72,29,41,18,31,4,5,11,47,72,7,6,42,82,31,42,17,40,9,12,11,48,82
1995-03-13 00:00:00.000,ATP Masters Series Miami FL; U.S.A. ATP World Tour,HARD,2,Todd Woodbridge,Marcelo Rios,Todd Woodbridge,7-5; 6-3,R32,75,2,1,41,66,31,41,14,25,4,5,11,45,66,0,2,42,56,26,42,7,14,1,4,10,33,56
1995-03-13 00:00:00.000,ATP Masters Series Miami FL; U.S.A. ATP World Tour,HARD,2,MaliVai Washington,Vincent Spadea,MaliVai Washington,7-5; 7-5,R32,107,2,2,56,92,36,56,21,36,9,11,12,57,92,1,3,37,70,24,37,17,33,2,6,12,41,70
1995-03-13 00:00:00.000,ATP Masters Series Miami FL; U.S.A. ATP World Tour,HARD,2,Andre Agassi,Tommy Ho,Andre Agassi,6-0; 6-2,R32,53,2,1,12,35,10,12,18,23,0,0,7,28,35,1,1,27,45,14,27,5,18,3,8,7,19,45
1995-03-13 00:00:00.000,ATP Masters Series Miami FL; U.S.A. ATP World Tour,HARD,2,Pete Sampras,Bernd Karbacher,Pete Sampras,6-2; 6-3,R16,69,7,3,28,57,22,28,17,29,1,1,9,39,57,2,0,34,50,22,34,7,16,4,7,8,29,50
1995-03-13 00:00:00.000,ATP Masters Series Miami FL; U.S.A. ATP World Tour,HARD,2,Andrei Medvedev,Mark Woodforde,Andrei Medvedev,6-3; 5-7; 7-6(6),R16,141,9,10,56,112,42,56,25,56,4,9,16,67,112,5,3,66,112,40,66,27,46,6,12,17,67,112
1995-03-13 00:00:00.000,ATP Masters Series Miami FL; U.S.A. ATP World Tour,HARD,2,Mats Wilander,Jan Siemerink,Mats Wilander,6-4; 6-2,R16,70,0,2,42,57,29,42,10,15,4,5,9,39,57,2,4,28,52,19,28,10,24,3,7,9,29,52
1995-03-13 00:00:00.000,ATP Masters Series Miami FL; U.S.A. ATP World Tour,HARD,2,Jonas Bjorkman,Karsten Braasch,Jonas Bjorkman,3-6; 6-3; 6-1,R16,110,9,2,46,93,34,46,25,47,8,11,13,59,93,11,2,46,91,31,46,16,45,12,17,12,47,91
1995-03-13 00:00:00.000,ATP Masters Series Miami FL; U.S.A. ATP World Tour,HARD,2,Magnus Larsson,Paul Kilderry,Magnus Larsson,6-3; 7-6(6),R16,78,8,1,39,65,31,39,16,26,1,1,10,47,65,3,3,44,72,31,44,14,28,1,3,11,45,72
1995-03-13 00:00:00.000,ATP Masters Series Miami FL; U.S.A. ATP World Tour,HARD,2,Jaime Yzaga,Thomas Enqvist,Jaime Yzaga,6-2; 7-6(5),R16,89,1,2,37,67,27,37,17,30,3,4,10,44,67,5,11,39,77,28,39,13,38,1,4,10,41,77
1995-03-13 00:00:00.000,ATP Masters Series Miami FL; U.S.A. ATP World Tour,HARD,2,Wayne Ferreira,Todd Woodbridge,Wayne Ferreira,6-7(8); 6-4; 6-2,R16,132,10,1,58,92,46,58,13,34,1,4,15,59,92,1,5,72,106,46,72,13,34,9,15,15,59,106
1995-03-13 00:00:00.000,ATP Masters Series Miami FL; U.S.A. ATP World Tour,HARD,2,Andre Agassi,MaliVai Washington,Andre Agassi,6-3; 6-4,R16,76,1,2,36,55,29,36,10,19,2,3,10,39,55,8,1,39,59,25,39,8,20,4,7,9,33,59
1995-03-13 00:00:00.000,ATP Masters Series Miami FL; U.S.A. ATP World Tour,HARD,2,Pete Sampras,Andrei Medvedev,Pete Sampras,6-1; 6-7(5); 6-4,Q,120,11,7,54,106,38,54,28,52,3,6,15,66,106,5,3,52,96,32,52,18,44,7,13,14,50,96
1995-03-13 00:00:00.000,ATP Masters Series Miami FL; U.S.A. ATP World Tour,HARD,2,Jonas Bjorkman,Mats Wilander,Jonas Bjorkman,6-2; 1-6; 7-5,Q,126,2,6,44,97,24,44,29,53,7,12,13,53,97,1,0,69,86,36,69,9,17,2,8,14,45,86
1995-03-13 00:00:00.000,ATP Masters Series Miami FL; U.S.A. ATP World Tour,HARD,2,Magnus Larsson,Jaime Yzaga,Magnus Larsson,6-0; 6-3,Q,57,8,1,24,53,21,24,16,29,1,1,8,37,53,1,4,32,49,18,32,6,17,6,10,7,24,49
1995-03-13 00:00:00.000,ATP Masters Series Miami FL; U.S.A. ATP World Tour,HARD,2,Andre Agassi,Wayne Ferreira,Andre Agassi,6-2; 6-4,Q,73,6,3,34,54,28,34,10,20,0,0,9,38,54,7,2,40,61,30,40,6,21,9,12,9,36,61
1995-03-13 00:00:00.000,ATP Masters Series Miami FL; U.S.A. ATP World Tour,HARD,2,Pete Sampras,Jonas Bjorkman,Pete Sampras,4-6; 6-0; 6-1,S,84,9,3,33,74,29,33,21,41,4,6,12,50,74,2,2,32,68,17,32,15,36,4,10,11,32,68
1995-03-13 00:00:00.000,ATP Masters Series Miami FL; U.S.A. ATP World Tour,HARD,2,Andre Agassi,Magnus Larsson,Andre Agassi,7-5; 4-6; 7-6(1),S,132,8,4,79,121,50,79,29,42,3,6,17,79,121,13,4,60,99,43,60,20,39,2,5,17,63,99
1995-03-13 00:00:00.000,ATP Masters Series Miami FL; U.S.A. ATP World Tour,HARD,2,Andre Agassi,Pete Sampras,Andre Agassi,3-6; 6-2; 7-6(3),F,133,4,1,63,90,45,63,19,27,3,4,14,64,90,9,4,49,101,34,49,30,52,6,8,15,64,101
1995-03-13 00:00:00.000,St. Petersburg Russia ATP World Tour,HARD,2,Yevgeny Kafelnikov,Danny Sapsford,Yevgeny Kafelnikov,6-0; 6-3,R32,62,2,0,24,45,20,24,12,21,2,3,8,32,45,0,2,27,54,12,27,11,27,6,11,7,23,54
1995-03-13 00:00:00.000,St. Petersburg Russia ATP World Tour,HARD,2,Anders Jarryd,Cristiano Caratti,Anders Jarryd,6-2; 4-6; 6-3,R32,101,3,3,46,88,34,46,23,42,6,8,14,57,88,2,4,47,79,30,47,20,32,4,8,13,50,79
1995-03-13 00:00:00.000,St. Petersburg Russia ATP World Tour,HARD,2,Girts Dzelde,Lorenzo Manta,Girts Dzelde,6-2; 6-3,R32,74,0,9,32,56,24,32,13,24,4,4,8,37,56,5,6,39,69,29,39,9,30,6,10,9,38,69
1995-03-13 00:00:00.000,St. Petersburg Russia ATP World Tour,HARD,2,Jakob Hlasek,Tomas Carbonell,Jakob Hlasek,7-6(4); 3-6; 6-1,R32,116,1,2,74,102,50,74,14,28,6,8,14,64,102,4,6,50,96,32,50,27,46,4,7,14,59,96
1995-03-13 00:00:00.000,St. Petersburg Russia ATP World Tour,HARD,2,Sebastien Lareau,Slava Dosedel,Sebastien Lareau,6-2; 6-4,R32,72,7,8,31,57,27,31,12,26,3,4,9,39,57,6,6,30,62,20,30,12,32,4,8,9,32,62
1995-03-13 00:00:00.000,St. Petersburg Russia ATP World Tour,HARD,2,Alex Antonitsch,Rodolphe Gilbert,Alex Antonitsch,7-5; 6-1,R32,68,0,2,26,53,22,26,15,27,1,1,9,37,53,3,6,30,58,21,30,11,28,4,8,10,32,58
1995-03-13 00:00:00.000,St. Petersburg Russia ATP World Tour,HARD,2,Kenneth Carlsen,Joern Renzenbrink,Kenneth Carlsen,6-3; 6-3,R32,68,7,3,33,59,25,33,15,26,4,5,9,40,59,4,5,30,54,21,30,7,24,2,6,9,28,54
1995-03-13 00:00:00.000,St. Petersburg Russia ATP World Tour,HARD,2,Alexander Volkov,Razvan Sabau,Alexander Volkov,6-2; 6-4,R32,58,4,3,33,53,29,33,8,20,2,2,9,37,53,4,5,34,54,22,34,9,20,1,4,9,31,54
1995-03-13 00:00:00.000,St. Petersburg Russia ATP World Tour,HARD,2,Thierry Guardiola,Martin Damm,Thierry Guardiola,6-4; 7-5,R32,99,4,1,38,73,28,38,21,35,1,2,11,49,73,3,7,39,75,27,39,18,36,6,9,11,45,75
1995-03-13 00:00:00.000,St. Petersburg Russia ATP World Tour,HARD,2,Nicolas Kiefer,Martin Sinner,Nicolas Kiefer,6-1; 6-2,R32,60,4,1,35,47,30,35,6,12,1,1,8,36,47,3,3,29,47,17,29,5,18,4,8,7,22,47
1995-03-13 00:00:00.000,St. Petersburg Russia ATP World Tour,HARD,2,Arne Thoms,Paul Wekesa,Arne Thoms,6-4; 3-6; 6-4,R32,113,4,1,66,102,42,66,20,36,8,10,15,62,102,5,2,47,77,34,47,17,30,3,6,14,51,77
1995-03-13 00:00:00.000,St. Petersburg Russia ATP World Tour,HARD,2,Andrei Chesnokov,David Prinosil,Andrei Chesnokov,4-6; 7-6(4); 7-6(3),R32,127,8,6,65,128,46,65,30,63,7,12,17,76,128,11,3,49,108,39,49,25,59,6,10,17,64,108
1995-03-13 00:00:00.000,St. Petersburg Russia ATP World Tour,HARD,2,Pat Cash,Jeremy Bates,Pat Cash,6-3; 7-5,R32,96,6,0,31,62,28,31,14,31,0,1,11,42,62,4,8,27,74,18,27,25,47,8,11,10,43,74
1995-03-13 00:00:00.000,St. Petersburg Russia ATP World Tour,HARD,2,Guillaume Raoux,Alexander Mronz,Guillaume Raoux,6-3; 6-3,R32,72,5,0,17,47,13,17,23,30,0,0,9,36,47,4,3,25,56,21,25,12,31,1,4,9,33,56
1995-03-13 00:00:00.000,St. Petersburg Russia ATP World Tour,HARD,2,Andrei Cherkasov,Greg Rusedski,Andrei Cherkasov,6-4; 3-6; 6-2,R32,101,0,1,44,79,32,44,21,35,2,3,13,53,79,10,8,47,82,37,47,17,35,10,13,14,54,82
1995-03-13 00:00:00.000,St. Petersburg Russia ATP World Tour,HARD,2,T.J. Middleton,Thomas Muster,T.J. Middleton,7-5; 6-3,R32,94,14,9,40,83,31,40,24,43,5,5,11,55,83,0,5,25,50,17,25,18,25,0,2,10,35,50
1995-03-13 00:00:00.000,St. Petersburg Russia ATP World Tour,HARD,2,Yevgeny Kafelnikov,Anders Jarryd,Yevgeny Kafelnikov,6-1; 7-5,R16,70,3,0,29,58,20,29,18,29,1,3,10,38,58,6,10,31,58,22,31,6,27,1,6,9,28,58
1995-03-13 00:00:00.000,St. Petersburg Russia ATP World Tour,HARD,2,Jakob Hlasek,Girts Dzelde,Jakob Hlasek,6-2; 6-3,R16,61,5,1,36,51,25,36,9,15,1,2,9,34,51,1,8,30,55,21,30,6,25,2,6,8,27,55
1995-03-13 00:00:00.000,St. Petersburg Russia ATP World Tour,HARD,2,Sebastien Lareau,Alex Antonitsch,Sebastien Lareau,2-6; 6-4; 7-5,R16,115,11,6,51,90,43,51,15,39,9,12,15,58,90,9,2,60,96,41,60,18,36,6,9,15,59,96
1995-03-13 00:00:00.000,St. Petersburg Russia ATP World Tour,HARD,2,Alexander Volkov,Kenneth Carlsen,Alexander Volkov,6-2; 6-4,R16,72,4,3,29,62,26,29,12,33,3,5,9,38,62,6,1,22,48,14,22,8,26,1,6,9,22,48
1995-03-13 00:00:00.000,St. Petersburg Russia ATP World Tour,HARD,2,Nicolas Kiefer,Thierry Guardiola,Nicolas Kiefer,7-5; 6-4,R16,81,4,1,38,57,30,38,13,19,1,2,11,43,57,2,0,36,64,27,36,13,28,2,5,11,40,64
1995-03-13 00:00:00.000,St. Petersburg Russia ATP World Tour,HARD,2,Andrei Chesnokov,Arne Thoms,Andrei Chesnokov,6-2; 6-3,R16,56,0,2,28,48,21,28,14,20,2,3,9,35,48,1,5,28,54,18,28,11,26,5,9,8,29,54
1995-03-13 00:00:00.000,St. Petersburg Russia ATP World Tour,HARD,2,Guillaume Raoux,Pat Cash,Guillaume Raoux,7-6(4); 6-3,R16,110,4,4,30,70,24,30,27,40,3,4,11,51,70,7,5,45,82,34,45,14,37,7,9,10,48,82
1995-03-13 00:00:00.000,St. Petersburg Russia ATP World Tour,HARD,2,T.J. Middleton,Andrei Cherkasov,T.J. Middleton,4-6; 7-6(7); 6-4,R16,165,9,8,57,111,47,57,21,54,3,7,16,68,111,3,0,75,110,44,75,24,35,8,12,16,68,110
1995-03-13 00:00:00.000,St. Petersburg Russia ATP World Tour,HARD,2,Yevgeny Kafelnikov,Jakob Hlasek,Yevgeny Kafelnikov,6-2; 2-6; 6-2,Q,76,10,1,41,78,32,41,18,37,4,6,12,50,78,8,6,39,75,28,39,15,36,3,7,12,43,75
1995-03-13 00:00:00.000,St. Petersburg Russia ATP World Tour,HARD,2,Alexander Volkov,Sebastien Lareau,Alexander Volkov,6-2; 6-3,Q,56,5,2,29,53,23,29,13,24,1,1,8,36,53,9,3,30,47,21,30,5,17,3,7,9,26,47
1995-03-13 00:00:00.000,St. Petersburg Russia ATP World Tour,HARD,2,Andrei Chesnokov,Nicolas Kiefer,Andrei Chesnokov,6-4; 6-2,Q,73,2,0,23,45,18,23,14,22,0,1,9,32,45,4,3,35,71,20,35,17,36,7,11,9,37,71
1995-03-13 00:00:00.000,St. Petersburg Russia ATP World Tour,HARD,2,Guillaume Raoux,T.J. Middleton,Guillaume Raoux,6-1; 6-2,Q,61,4,0,25,40,23,25,9,15,0,0,8,32,40,2,5,23,46,15,23,7,23,4,8,7,22,46
1995-03-13 00:00:00.000,St. Petersburg Russia ATP World Tour,HARD,2,Yevgeny Kafelnikov,Alexander Volkov,Yevgeny Kafelnikov,6-3; 6-2,S,52,3,3,35,53,29,35,9,18,0,0,9,38,53,4,5,25,43,14,25,9,18,1,4,8,23,43
1995-03-13 00:00:00.000,St. Petersburg Russia ATP World Tour,HARD,2,Guillaume Raoux,Andrei Chesnokov,Guillaume Raoux,4-6; 6-3; 6-4,S,105,6,3,50,99,41,50,28,49,13,15,15,69,99,5,3,49,81,36,49,14,32,1,4,14,50,81
1995-03-13 00:00:00.000,St. Petersburg Russia ATP World Tour,HARD,2,Yevgeny Kafelnikov,Guillaume Raoux,Yevgeny Kafelnikov,6-2; 6-2,F,48,10,2,22,37,20,22,12,15,0,0,8,32,37,3,3,23,51,13,23,12,28,4,8,8,25,51
1995-03-20 00:00:00.000,Casablanca Morocco ATP World Tour,CLAY,2,Gilbert Schaller,Jordi Burillo,Gilbert Schaller,6-4; 6-3,R32,71,2,1,48,56,33,48,4,8,3,4,9,37,56,1,6,28,62,19,28,12,34,1,5,10,31,62
1995-03-20 00:00:00.000,Casablanca Morocco ATP World Tour,CLAY,2,Emilio Benfele Alvarez,Thierry Guardiola,Emilio Benfele Alvarez,7-6(2); 6-0,R32,77,1,1,28,50,22,28,13,22,0,1,9,35,50,1,3,41,72,26,41,10,31,8,12,9,36,72
1995-03-20 00:00:00.000,Casablanca Morocco ATP World Tour,CLAY,2,Felix Mantilla,Nuno Marques,Felix Mantilla,4-6; 6-1; 6-4,R32,108,0,0,85,99,58,85,6,14,11,12,14,64,99,1,1,49,77,31,49,18,28,3,6,13,49,77
1995-03-20 00:00:00.000,Casablanca Morocco ATP World Tour,CLAY,2,Ronald Agenor,Jordi Arrese,Ronald Agenor,6-3; 6-7(5); 6-4,R32,140,5,3,75,117,53,75,21,42,4,5,16,74,117,0,1,68,89,45,68,13,21,8,11,14,58,89
1995-03-20 00:00:00.000,Casablanca Morocco ATP World Tour,CLAY,2,Tomas Carbonell,Filip Dewulf,Tomas Carbonell,6-2; 6-4,R32,76,2,1,37,50,29,37,6,13,1,2,9,35,50,1,5,42,74,24,42,14,32,9,13,9,38,74
1995-03-20 00:00:00.000,Casablanca Morocco ATP World Tour,CLAY,2,Jose Francisco Altur,Mohamed Ridaoui,Jose Francisco Altur,7-5; 5-7; 6-3,R32,125,3,9,71,97,49,71,11,26,4,8,16,60,97,1,5,73,113,43,73,18,40,4,10,17,61,113
1995-03-20 00:00:00.000,Casablanca Morocco ATP World Tour,CLAY,2,Sjeng Schalken,Younes El Aynaoui,Sjeng Schalken,6-2; 6-3,R32,82,1,3,24,46,18,24,13,22,0,1,8,31,46,1,3,44,79,25,44,13,35,11,16,9,38,79
1995-03-20 00:00:00.000,Casablanca Morocco ATP World Tour,CLAY,2,Guillaume Raoux,Oscar Martinez,Guillaume Raoux,7-5; 4-6; 6-1,R32,89,3,3,44,86,31,44,21,42,5,9,14,52,86,2,0,54,94,27,54,22,40,5,12,15,49,94
1995-03-20 00:00:00.000,Casablanca Morocco ATP World Tour,CLAY,2,Franco Davin,Francisco Roig,Franco Davin,6-3; 6-2,R32,67,2,0,39,58,25,39,13,19,6,7,9,38,58,2,1,27,53,17,27,11,26,0,4,8,28,53
1995-03-20 00:00:00.000,Casablanca Morocco ATP World Tour,CLAY,2,Stefano Pescosolido,Dimitri Poliakov,Stefano Pescosolido,7-5; 1-6; 6-4,R32,132,3,6,54,112,34,54,29,58,11,16,14,63,112,4,3,59,94,39,59,17,35,6,11,15,56,94
1995-03-20 00:00:00.000,Casablanca Morocco ATP World Tour,CLAY,2,Alex Lopez Moron,Sandor Noszaly,Alex Lopez Moron,6-0; 6-4,R32,56,0,3,24,41,18,24,10,17,2,4,8,28,41,1,1,32,44,12,32,6,12,2,8,8,18,44
1995-03-20 00:00:00.000,Casablanca Morocco ATP World Tour,CLAY,2,Gerard Solves,Karol Kucera,Gerard Solves,6-3; 2-6; 6-1,R32,103,1,3,52,79,30,52,17,27,6,9,12,47,79,8,9,34,88,23,34,25,54,12,17,12,48,88
1995-03-20 00:00:00.000,Casablanca Morocco ATP World Tour,CLAY,2,Marc-Kevin Goellner,Bohdan Ulihrach,Marc-Kevin Goellner,6-3; 6-4,R32,88,6,5,32,76,23,32,20,44,4,7,10,43,76,2,3,23,55,11,23,15,32,6,11,9,26,55
1995-03-20 00:00:00.000,Casablanca Morocco ATP World Tour,CLAY,2,Emanuel Couto,Karim Alami,Emanuel Couto,2-6; 6-4; 6-2,R32,138,3,2,62,100,37,62,18,38,11,15,13,55,100,7,2,40,81,31,40,14,41,4,9,13,45,81
1995-03-20 00:00:00.000,Casablanca Morocco ATP World Tour,CLAY,2,Rodolphe Gilbert,Mehdi Tahiri,Rodolphe Gilbert,6-3; 6-2,R32,76,3,2,31,54,23,31,11,23,4,6,9,34,54,0,6,22,48,9,22,14,26,3,8,8,23,48
1995-03-20 00:00:00.000,Casablanca Morocco ATP World Tour,CLAY,2,Albert Costa,Hicham Arazi,Albert Costa,3-6; 6-3; 6-3,R32,92,0,4,48,74,31,48,10,26,0,5,13,41,74,4,4,40,75,23,40,15,35,0,7,14,38,75
1995-03-20 00:00:00.000,Casablanca Morocco ATP World Tour,CLAY,2,Gilbert Schaller,Emilio Benfele Alvarez,Gilbert Schaller,6-1; 7-5,R16,83,4,1,47,60,28,47,7,13,2,5,10,35,60,0,1,34,58,15,34,11,24,6,12,9,26,58
1995-03-20 00:00:00.000,Casablanca Morocco ATP World Tour,CLAY,2,Felix Mantilla,Ronald Agenor,Felix Mantilla,7-5; 3-6; 6-1,R16,131,2,0,65,85,42,65,12,20,3,7,14,54,85,6,3,60,106,35,60,20,46,7,13,14,55,106
1995-03-20 00:00:00.000,Casablanca Morocco ATP World Tour,CLAY,2,Tomas Carbonell,Jose Francisco Altur,Tomas Carbonell,6-4; 2-6; 6-4,R16,113,2,10,56,83,25,56,12,27,7,16,14,37,83,2,8,64,93,34,64,7,29,7,16,14,41,93
1995-03-20 00:00:00.000,Casablanca Morocco ATP World Tour,CLAY,2,Sjeng Schalken,Guillaume Raoux,Sjeng Schalken,7-6(3); 2-6; 6-1,R16,88,2,6,55,88,43,55,14,33,7,10,14,57,88,1,2,42,76,31,42,18,34,2,5,13,49,76
1995-03-20 00:00:00.000,Casablanca Morocco ATP World Tour,CLAY,2,Stefano Pescosolido,Franco Davin,Stefano Pescosolido,6-4; 6-4,R16,86,2,4,27,71,18,27,23,44,6,9,10,41,71,1,3,33,53,20,33,7,20,2,7,10,27,53
1995-03-20 00:00:00.000,Casablanca Morocco ATP World Tour,CLAY,2,Alex Lopez Moron,Gerard Solves,Alex Lopez Moron,4-6; 7-6(3); 6-1,R16,110,1,2,47,85,32,47,21,38,3,6,14,53,85,1,0,63,98,41,63,16,35,2,7,15,57,98
1995-03-20 00:00:00.000,Casablanca Morocco ATP World Tour,CLAY,2,Marc-Kevin Goellner,Emanuel Couto,Marc-Kevin Goellner,6-3; 2-6; 6-4,R16,106,6,9,39,79,35,39,18,40,2,4,14,53,79,7,5,40,77,34,40,18,37,2,4,13,52,77
1995-03-20 00:00:00.000,Casablanca Morocco ATP World Tour,CLAY,2,Albert Costa,Rodolphe Gilbert,Albert Costa,3-6; 6-2; 6-3,R16,101,2,2,67,81,48,67,5,14,6,8,13,53,81,1,1,31,74,23,31,21,43,2,6,13,44,74
1995-03-20 00:00:00.000,Casablanca Morocco ATP World Tour,CLAY,2,Gilbert Schaller,Felix Mantilla,Gilbert Schaller,6-7(2); 6-4; 6-4,Q,162,1,4,72,96,47,72,11,24,1,5,16,58,96,3,2,56,112,35,56,26,56,7,13,16,61,112
1995-03-20 00:00:00.000,Casablanca Morocco ATP World Tour,CLAY,2,Sjeng Schalken,Tomas Carbonell,Sjeng Schalken,6-4; 6-3,Q,79,4,4,37,70,25,37,17,33,3,5,9,42,70,1,5,29,52,17,29,8,23,0,5,10,25,52
1995-03-20 00:00:00.000,Casablanca Morocco ATP World Tour,CLAY,2,Alex Lopez Moron,Stefano Pescosolido,Alex Lopez Moron,6-4; 0-6; 6-1,Q,97,1,1,34,57,22,34,13,23,6,10,11,35,57,6,7,40,86,24,40,22,46,9,14,12,46,86
1995-03-20 00:00:00.000,Casablanca Morocco ATP World Tour,CLAY,2,Albert Costa,Marc-Kevin Goellner,Albert Costa,6-4; 6-7(3); 6-3,Q,114,1,0,66,91,43,66,15,25,0,3,15,58,91,5,10,47,98,35,47,22,51,3,9,16,57,98
1995-03-20 00:00:00.000,Casablanca Morocco ATP World Tour,CLAY,2,Gilbert Schaller,Sjeng Schalken,Gilbert Schaller,6-4; 6-4,S,74,0,1,47,56,28,47,4,9,1,5,10,32,56,2,3,38,62,20,38,9,24,3,9,10,29,62
1995-03-20 00:00:00.000,Casablanca Morocco ATP World Tour,CLAY,2,Albert Costa,Alex Lopez Moron,Albert Costa,6-3; 6-2,S,74,0,3,39,62,24,39,16,23,6,7,9,40,62,1,4,22,54,14,22,13,32,5,9,8,27,54
1995-03-20 00:00:00.000,Casablanca Morocco ATP World Tour,CLAY,2,Gilbert Schaller,Albert Costa,Gilbert Schaller,6-4; 6-2,F,72,0,0,46,51,27,46,3,5,2,5,9,30,51,0,1,38,53,16,38,5,15,3,9,9,21,53
1995-04-03 00:00:00.000,Estoril Portugal ATP World Tour,CLAY,2,Nuno Marques,Alberto Berasategui,Nuno Marques,6-4; 7-6,R32,73,5,2,46,65,36,46,8,19,1,2,11,44,65,4,2,55,72,34,55,9,17,8,11,11,43,72
1995-04-03 00:00:00.000,Estoril Portugal ATP World Tour,CLAY,2,Francisco Clavet,Jordi Burillo,Francisco Clavet,6-4; 6-4,R32,81,2,1,38,60,28,38,13,22,0,1,10,41,60,3,1,26,68,18,26,20,42,1,4,10,38,68
1995-04-03 00:00:00.000,Estoril Portugal ATP World Tour,CLAY,2,Emilio Sanchez,Jaime Yzaga,Emilio Sanchez,6-3; 6-7(3); 7-6(3),R32,171,3,1,68,129,47,68,35,61,10,12,17,82,129,4,3,63,118,44,63,30,55,6,9,16,74,118
1995-04-03 00:00:00.000,Estoril Portugal ATP World Tour,CLAY,2,Bryan Shelton,Carlos Costa,Bryan Shelton,6-4; 2-6; 7-6(3),R32,130,7,11,58,111,43,58,22,53,6,10,15,65,111,4,5,58,95,40,58,20,37,2,5,15,60,95
1995-04-03 00:00:00.000,Estoril Portugal ATP World Tour,CLAY,2,Thomas Muster,Oscar Martinez,Thomas Muster,6-4; 6-1,R32,74,1,1,38,65,24,38,14,27,5,7,8,38,65,1,6,28,56,14,28,9,28,3,9,9,23,56
1995-04-03 00:00:00.000,Estoril Portugal ATP World Tour,CLAY,2,Franco Davin,Cedric Pioline,Franco Davin,6-4; 7-5,R32,101,2,5,55,84,34,55,14,29,7,10,11,48,84,4,1,36,59,20,36,13,23,2,7,11,33,59
1995-04-03 00:00:00.000,Estoril Portugal ATP World Tour,CLAY,2,Javier Sanchez,Christian Ruud,Javier Sanchez,6-2; 6-1,R32,68,3,2,32,52,23,32,10,20,2,3,7,33,52,1,0,32,51,13,32,7,19,6,12,8,20,51
1995-04-03 00:00:00.000,Estoril Portugal ATP World Tour,CLAY,2,Karel Novacek,Emanuel Couto,Karel Novacek,6-2; 7-5,R32,89,3,1,42,69,25,42,17,27,7,9,10,42,69,0,5,29,60,17,29,13,31,3,8,10,30,60
1995-04-03 00:00:00.000,Estoril Portugal ATP World Tour,CLAY,2,Alex Corretja,Karol Kucera,Alex Corretja,6-0; 6-2,R32,75,1,0,44,65,31,44,11,21,6,6,7,42,65,2,5,16,44,6,16,11,28,6,11,7,17,44
1995-04-03 00:00:00.000,Estoril Portugal ATP World Tour,CLAY,2,Fabrice Santoro,Horst Skoff,Fabrice Santoro,6-4; 6-3,R32,80,7,4,36,59,26,36,12,23,4,5,9,38,59,2,1,37,63,22,37,10,26,5,9,10,32,63
1995-04-03 00:00:00.000,Estoril Portugal ATP World Tour,CLAY,2,Gilbert Schaller,Marc-Kevin Goellner,Gilbert Schaller,7-5; 6-1,R32,77,0,0,39,44,28,39,3,5,0,2,9,31,44,7,6,21,69,16,21,17,48,2,8,10,33,69
1995-04-03 00:00:00.000,Estoril Portugal ATP World Tour,CLAY,2,Andrea Gaudenzi,Henri Leconte,Andrea Gaudenzi,6-1; 7-5,R32,67,1,1,28,42,24,28,10,14,2,3,9,34,42,3,1,27,62,13,27,16,35,5,10,10,29,62
1995-04-03 00:00:00.000,Estoril Portugal ATP World Tour,CLAY,2,Slava Dosedel,Oliver Gross,Slava Dosedel,5-7; 6-1; 7-6(3),R32,137,4,11,49,120,38,49,26,71,9,15,16,64,120,2,3,64,103,41,64,11,39,3,10,15,52,103
1995-04-03 00:00:00.000,Estoril Portugal ATP World Tour,CLAY,2,Albert Costa,MaliVai Washington,Albert Costa,6-3; 6-4,R32,76,0,0,52,65,38,52,8,13,3,3,10,46,65,2,3,27,50,19,27,13,23,1,3,9,32,50
1995-04-03 00:00:00.000,Estoril Portugal ATP World Tour,CLAY,2,Bohdan Ulihrach,Tomas Carbonell,Bohdan Ulihrach,6-2; 6-4,R32,75,1,5,31,60,18,31,18,29,3,6,9,36,60,4,4,26,58,13,26,13,32,8,14,9,26,58
1995-04-03 00:00:00.000,Estoril Portugal ATP World Tour,CLAY,2,Andrei Medvedev,Jordi Arrese,Andrei Medvedev,4-6; 7-6(6); 6-3,R32,155,1,2,48,93,31,48,22,45,4,9,15,53,93,2,3,96,135,49,96,24,39,14,20,16,73,135
1995-04-03 00:00:00.000,Estoril Portugal ATP World Tour,CLAY,2,Nuno Marques,Francisco Clavet,Nuno Marques,5-7; 6-3; 6-3,R16,135,2,6,80,110,47,80,11,30,4,11,15,58,110,1,5,65,108,33,65,16,43,7,16,15,49,108
1995-04-03 00:00:00.000,Estoril Portugal ATP World Tour,CLAY,2,Emilio Sanchez,Bryan Shelton,Emilio Sanchez,7-6(1); 6-4,R16,91,1,0,56,73,43,56,10,17,4,4,11,53,73,10,4,41,72,31,41,17,31,3,4,11,48,72
1995-04-03 00:00:00.000,Estoril Portugal ATP World Tour,CLAY,2,Thomas Muster,Franco Davin,Thomas Muster,7-5; 6-1,R16,82,6,0,32,60,23,32,14,28,5,7,9,37,60,2,3,48,73,24,48,10,25,1,7,10,34,73
1995-04-03 00:00:00.000,Estoril Portugal ATP World Tour,CLAY,2,Javier Sanchez,Karel Novacek,Javier Sanchez,6-3; 6-4,R16,70,2,1,39,54,30,39,12,15,1,1,10,42,54,1,2,42,66,29,42,10,24,5,7,9,39,66
1995-04-03 00:00:00.000,Estoril Portugal ATP World Tour,CLAY,2,Fabrice Santoro,Alex Corretja,Fabrice Santoro,6-3; 6-4,R16,90,0,1,43,60,31,43,8,17,3,5,10,39,60,1,3,37,58,22,37,9,21,4,8,9,31,58
1995-04-03 00:00:00.000,Estoril Portugal ATP World Tour,CLAY,2,Gilbert Schaller,Andrea Gaudenzi,Gilbert Schaller,7-6(2); 6-2,R16,118,1,2,90,104,51,90,6,14,12,16,10,57,104,2,6,39,63,22,39,7,24,1,7,10,29,63
1995-04-03 00:00:00.000,Estoril Portugal ATP World Tour,CLAY,2,Albert Costa,Slava Dosedel,Albert Costa,6-1; 6-0,R16,43,3,1,37,42,27,37,3,5,1,1,7,30,42,0,5,13,39,8,13,6,26,6,11,6,14,39
1995-04-03 00:00:00.000,Estoril Portugal ATP World Tour,CLAY,2,Andrei Medvedev,Bohdan Ulihrach,Andrei Medvedev,6-3; 7-6(1),R16,88,2,3,40,81,24,40,21,41,7,11,11,45,81,3,4,39,64,22,39,10,25,3,8,10,32,64
1995-04-03 00:00:00.000,Estoril Portugal ATP World Tour,CLAY,2,Emilio Sanchez,Nuno Marques,Emilio Sanchez,4-6; 6-4; 6-3,Q,137,5,2,80,121,48,80,24,41,15,18,15,72,121,2,3,74,96,46,74,10,22,4,8,14,56,96
1995-04-03 00:00:00.000,Estoril Portugal ATP World Tour,CLAY,2,Thomas Muster,Javier Sanchez,Thomas Muster,4-6; 7-6(3); 6-4,Q,132,0,4,59,104,44,59,19,45,3,8,16,63,104,4,3,70,107,45,70,14,37,4,9,16,59,107
1995-04-03 00:00:00.000,Estoril Portugal ATP World Tour,CLAY,2,Fabrice Santoro,Gilbert Schaller,Fabrice Santoro,6-4; 6-3,Q,94,0,1,35,61,23,35,16,26,3,5,10,39,61,0,0,50,58,23,50,6,8,3,7,9,29,58
1995-04-03 00:00:00.000,Estoril Portugal ATP World Tour,CLAY,2,Albert Costa,Andrei Medvedev,Albert Costa,6-2; 6-3,Q,65,1,2,41,57,28,41,10,16,3,4,9,38,57,2,0,33,54,21,33,7,21,8,12,8,28,54
1995-04-03 00:00:00.000,Estoril Portugal ATP World Tour,CLAY,2,Thomas Muster,Emilio Sanchez,Thomas Muster,6-2; 6-4,S,68,1,1,36,51,28,36,8,15,4,5,9,36,51,4,1,30,58,19,30,10,28,2,6,9,29,58
1995-04-03 00:00:00.000,Estoril Portugal ATP World Tour,CLAY,2,Albert Costa,Fabrice Santoro,Albert Costa,6-1; 6-0,S,56,2,1,30,39,24,30,6,9,1,1,7,30,39,3,4,21,44,10,21,9,23,5,10,6,19,44
1995-04-03 00:00:00.000,Estoril Portugal ATP World Tour,CLAY,2,Thomas Muster,Albert Costa,Thomas Muster,6-4; 6-2,F,76,2,1,25,54,19,25,17,29,0,1,9,36,54,1,0,48,54,26,48,3,6,6,10,9,29,54
1995-04-03 00:00:00.000,Johannesburg South Africa ATP World Tour,HARD,2,Lionel Roux,Christo Van Rensburg,Lionel Roux,6-2; 6-3,R32,70,1,2,27,55,21,27,16,28,1,2,9,37,55,2,5,20,47,14,20,11,27,2,6,8,25,47
1995-04-03 00:00:00.000,Johannesburg South Africa ATP World Tour,HARD,2,Alex Radulescu,Adrian Voinea,Alex Radulescu,6-2; 6-2,R32,43,11,2,26,42,24,26,8,16,0,1,8,32,42,0,3,34,54,19,34,7,20,3,8,8,26,54
1995-04-03 00:00:00.000,Johannesburg South Africa ATP World Tour,HARD,2,Dimitri Poliakov,Laurence Tieleman,Dimitri Poliakov,6-4; 6-2,R32,59,1,3,20,46,18,20,19,26,2,2,9,37,46,3,6,19,58,13,19,19,39,5,8,9,32,58
1995-04-03 00:00:00.000,Johannesburg South Africa ATP World Tour,HARD,2,Guillaume Raoux,Tomas Nydahl,Guillaume Raoux,6-3; 6-2,R32,51,11,1,21,44,20,21,16,23,0,0,9,36,44,3,2,28,40,17,28,5,12,1,4,8,22,40
1995-04-03 00:00:00.000,Johannesburg South Africa ATP World Tour,HARD,2,Jakob Hlasek,Alex Antonitsch,Jakob Hlasek,6-3; 7-5,R32,82,7,2,37,66,29,37,18,29,5,6,11,47,66,1,2,39,79,25,39,19,40,5,8,10,44,79
1995-04-03 00:00:00.000,Johannesburg South Africa ATP World Tour,HARD,2,Patrick Baur,Jan Kroslak,Patrick Baur,6-4; 6-3,R32,67,3,1,41,57,34,41,9,16,5,5,10,43,57,6,4,35,63,23,35,15,28,5,7,9,38,63
1995-04-03 00:00:00.000,Johannesburg South Africa ATP World Tour,HARD,2,Paul Wekesa,Davide Sanguinetti,Paul Wekesa,7-5; 6-4,R32,61,4,2,44,61,36,44,11,17,1,1,11,47,61,8,3,34,57,26,34,13,23,0,2,11,39,57
1995-04-03 00:00:00.000,Johannesburg South Africa ATP World Tour,HARD,2,Byron Black,Joost Winnink,Byron Black,6-2; 2-6; 7-6(8),R32,98,3,5,53,82,38,53,15,29,1,5,14,53,82,7,13,53,94,42,53,15,41,3,7,14,57,94
1995-04-03 00:00:00.000,Johannesburg South Africa ATP World Tour,HARD,2,Joern Renzenbrink,Mario Rincon,Joern Renzenbrink,7-6(1); 6-7(4); 6-4,R32,124,14,7,61,104,50,61,24,43,0,1,17,74,104,5,8,71,106,52,71,20,35,5,7,17,72,106
1995-04-03 00:00:00.000,Johannesburg South Africa ATP World Tour,HARD,2,Howard Joffe,David Nainkin,Howard Joffe,3-6; 6-3; 7-6(5),R32,112,7,3,46,98,40,46,26,52,2,4,15,66,98,2,6,56,96,43,56,22,40,7,9,15,65,96
1995-04-03 00:00:00.000,Johannesburg South Africa ATP World Tour,HARD,2,Filip Dewulf,Brent Haygarth,Filip Dewulf,6-2; 3-6; 7-6,R32,89,9,6,41,80,34,41,21,39,2,3,13,55,80,7,5,43,83,32,43,20,40,3,6,14,52,83
1995-04-03 00:00:00.000,Johannesburg South Africa ATP World Tour,HARD,2,Martin Sinner,Alexander Mronz,Martin Sinner,7-6(6); 6-3,R32,80,7,6,34,66,28,34,19,32,3,4,11,47,66,12,4,30,63,23,30,17,33,3,5,10,40,63
1995-04-03 00:00:00.000,Johannesburg South Africa ATP World Tour,HARD,2,Mark Petchey,David Adams,Mark Petchey,6-3; 6-2,R32,106,7,4,48,83,40,48,20,35,3,5,15,60,83,8,5,41,89,31,41,22,48,6,10,14,53,89
1995-04-03 00:00:00.000,Johannesburg South Africa ATP World Tour,HARD,2,Neville Godwin,Gary Muller,Neville Godwin,6-7(4); 7-5; 6-3,R32,136,7,8,60,108,51,60,25,48,5,6,17,76,108,11,4,59,110,45,59,24,51,4,7,16,69,110
1995-04-03 00:00:00.000,Johannesburg South Africa ATP World Tour,HARD,2,Kevin Ullyett,Grant Stafford,Kevin Ullyett,7-6(7); 2-6; 6-3,R32,160,6,10,56,112,36,56,24,56,10,16,15,60,112,8,15,78,127,46,78,22,49,16,21,14,68,127
1995-04-03 00:00:00.000,Johannesburg South Africa ATP World Tour,HARD,2,Jeremy Bates,Rodolphe Gilbert,Jeremy Bates,7-6(5); 0-6; 6-4,R32,105,3,6,47,92,34,47,18,45,3,7,14,52,92,3,2,39,77,30,39,22,38,3,5,14,52,77
1995-04-03 00:00:00.000,Johannesburg South Africa ATP World Tour,HARD,2,Lionel Roux,Alex Radulescu,Lionel Roux,6-4; 6-3,R16,69,4,2,35,62,28,35,14,27,4,4,9,42,62,8,4,32,59,22,32,12,27,5,8,9,34,59
1995-04-03 00:00:00.000,Johannesburg South Africa ATP World Tour,HARD,2,Guillaume Raoux,Dimitri Poliakov,Guillaume Raoux,7-6(2); 7-5,R16,91,10,3,32,73,29,32,22,41,4,6,12,51,73,7,5,50,90,35,50,19,40,13,16,12,54,90
1995-04-03 00:00:00.000,Johannesburg South Africa ATP World Tour,HARD,2,Patrick Baur,Jakob Hlasek,Patrick Baur,7-6(4); 6-7(5); 6-3,R16,128,12,7,68,111,57,68,22,43,7,9,17,79,111,14,9,55,101,46,55,24,46,5,8,16,70,101
1995-04-03 00:00:00.000,Johannesburg South Africa ATP World Tour,HARD,2,Byron Black,Paul Wekesa,Byron Black,7-6(6); 6-3,R16,87,4,1,40,65,30,40,19,25,1,1,10,49,65,10,5,57,85,46,57,7,28,2,4,11,53,85
1995-04-03 00:00:00.000,Johannesburg South Africa ATP World Tour,HARD,2,Joern Renzenbrink,Howard Joffe,Joern Renzenbrink,6-4; 7-6(3),R16,83,9,4,49,77,37,49,13,28,4,6,11,50,77,6,2,34,77,25,34,19,43,5,8,11,44,77
1995-04-03 00:00:00.000,Johannesburg South Africa ATP World Tour,HARD,2,Martin Sinner,Filip Dewulf,Martin Sinner,4-6; 7-6(6); 6-2,R16,100,11,7,47,86,40,47,23,39,0,1,15,63,86,8,10,48,97,40,48,24,49,4,6,15,64,97
1995-04-03 00:00:00.000,Johannesburg South Africa ATP World Tour,HARD,2,Neville Godwin,Mark Petchey,Neville Godwin,4-6; 6-4; 7-5,R16,131,1,4,60,100,43,60,25,40,8,10,16,68,100,10,5,64,108,46,64,23,44,7,10,16,69,108
1995-04-03 00:00:00.000,Johannesburg South Africa ATP World Tour,HARD,2,Jeremy Bates,Kevin Ullyett,Jeremy Bates,7-6(4); 2-6; 6-4,R16,121,7,9,43,100,34,43,22,57,3,9,15,56,100,6,6,42,97,24,42,31,55,6,11,15,55,97
1995-04-03 00:00:00.000,Johannesburg South Africa ATP World Tour,HARD,2,Guillaume Raoux,Lionel Roux,Guillaume Raoux,4-6; 7-5; 7-6(5),Q,152,8,7,43,109,33,43,42,66,5,7,17,75,109,3,7,66,114,49,66,28,48,5,7,17,77,114
1995-04-03 00:00:00.000,Johannesburg South Africa ATP World Tour,HARD,2,Byron Black,Patrick Baur,Byron Black,6-2; 6-3,Q,76,2,2,43,67,33,43,10,24,5,6,9,43,67,2,1,24,49,11,24,13,25,2,6,8,24,49
1995-04-03 00:00:00.000,Johannesburg South Africa ATP World Tour,HARD,2,Martin Sinner,Joern Renzenbrink,Martin Sinner,4-1 RET,Q,15,6,1,7,16,6,7,6,9,0,0,3,12,16,0,0,6,12,2,6,4,6,0,1,3,6,12
1995-04-03 00:00:00.000,Johannesburg South Africa ATP World Tour,HARD,2,Jeremy Bates,Neville Godwin,Jeremy Bates,6-3; 6-2,Q,67,6,5,37,62,26,37,14,25,4,5,9,40,62,4,5,30,57,17,30,12,27,6,10,8,29,57
1995-04-03 00:00:00.000,Johannesburg South Africa ATP World Tour,HARD,2,Guillaume Raoux,Byron Black,Guillaume Raoux,7-6(5); 6-4,S,83,7,2,33,68,25,33,17,35,3,6,11,42,68,4,2,48,70,35,48,9,22,3,7,11,44,70
1995-04-03 00:00:00.000,Johannesburg South Africa ATP World Tour,HARD,2,Martin Sinner,Jeremy Bates,Martin Sinner,6-1; 7-6(3),S,70,7,3,29,62,26,29,20,33,2,2,10,46,62,4,5,31,57,22,31,12,26,2,4,9,34,57
1995-04-03 00:00:00.000,Johannesburg South Africa ATP World Tour,HARD,2,Martin Sinner,Guillaume Raoux,Martin Sinner,6-1; 6-4,F,58,6,0,27,45,20,27,14,18,0,1,9,34,45,1,1,21,52,11,21,17,31,3,7,8,28,52
1995-04-10 00:00:00.000,Barcelona Spain ATP World Tour,CLAY,2,Pete Sampras,N/A Bye,Pete Sampras,,R64,0,0,0,0,0,0,0,0,0,0,0,0,0,0,0,0,0,0,0,0,0,0,0,0,0,0,0
1995-04-10 00:00:00.000,Barcelona Spain ATP World Tour,CLAY,2,Oliver Gross,David Wheaton,Oliver Gross,6-2; 4-6; 6-2,R64,107,5,0,49,78,28,49,17,29,3,6,13,45,78,5,2,49,79,33,49,9,30,8,14,13,42,79
1995-04-10 00:00:00.000,Barcelona Spain ATP World Tour,CLAY,2,Carlos Costa,Olivier Delaitre,Carlos Costa,6-4; 6-4,R64,90,6,2,30,63,20,30,17,33,5,8,10,37,63,1,4,42,77,21,42,18,35,6,11,10,39,77
1995-04-10 00:00:00.000,Barcelona Spain ATP World Tour,CLAY,2,Paul Haarhuis,Slava Dosedel,Paul Haarhuis,0-6; 6-2; 6-2,R64,102,4,3,52,74,29,52,12,22,2,6,11,41,74,0,7,48,74,28,48,11,26,5,10,11,39,74
1995-04-10 00:00:00.000,Barcelona Spain ATP World Tour,CLAY,2,Thomas Muster,Jordi Burillo,Thomas Muster,4-6; 7-6(2); 6-2,R64,111,1,1,52,82,32,52,17,30,2,8,15,49,82,5,1,40,87,27,40,18,47,3,10,15,45,87
1995-04-10 00:00:00.000,Barcelona Spain ATP World Tour,CLAY,2,Andrei Cherkasov,Gerard Solves,Andrei Cherkasov,6-4; 6-4,R64,86,3,0,32,59,20,32,16,27,0,3,10,36,59,1,1,43,71,27,43,9,28,2,7,10,36,71
1995-04-10 00:00:00.000,Barcelona Spain ATP World Tour,CLAY,2,Javier Sanchez,Bohdan Ulihrach,Javier Sanchez,5-7; 6-0; 6-1,R64,116,1,2,62,87,38,62,14,25,8,11,12,52,87,3,9,44,105,30,44,20,61,16,24,13,50,105
1995-04-10 00:00:00.000,Barcelona Spain ATP World Tour,CLAY,2,Andrei Medvedev,N/A Bye,Andrei Medvedev,,R64,0,0,0,0,0,0,0,0,0,0,0,0,0,0,0,0,0,0,0,0,0,0,0,0,0,0,0
1995-04-10 00:00:00.000,Barcelona Spain ATP World Tour,CLAY,2,Yevgeny Kafelnikov,N/A Bye,Yevgeny Kafelnikov,,R64,0,0,0,0,0,0,0,0,0,0,0,0,0,0,0,0,0,0,0,0,0,0,0,0,0,0,0
1995-04-10 00:00:00.000,Barcelona Spain ATP World Tour,CLAY,2,Richard Fromberg,Horst Skoff,Richard Fromberg,6-3; 6-1,R64,66,10,0,27,40,24,27,8,13,0,0,8,32,40,1,3,50,69,29,50,7,19,4,8,8,36,69
1995-04-10 00:00:00.000,Barcelona Spain ATP World Tour,CLAY,2,Marcelo Rios,Marcelo Filippini,Marcelo Rios,6-2; 6-0,R64,54,0,1,21,40,15,21,12,19,1,2,7,27,40,0,1,25,42,9,25,7,17,3,9,7,16,42
1995-04-10 00:00:00.000,Barcelona Spain ATP World Tour,CLAY,2,Bernd Karbacher,Juan Albert Viloca-Puig,Bernd Karbacher,4-6; 6-3; 7-5,R64,138,9,2,56,99,39,56,23,43,0,4,16,62,99,3,2,54,93,32,54,20,39,1,6,15,52,93
1995-04-10 00:00:00.000,Barcelona Spain ATP World Tour,CLAY,2,Thierry Champion,Alex Corretja,Thierry Champion,6-4; 5-7; 6-3,R64,144,2,4,52,88,36,52,18,36,4,8,15,54,88,2,2,59,94,33,59,18,35,2,8,16,51,94
1995-04-10 00:00:00.000,Barcelona Spain ATP World Tour,CLAY,2,Jerome Golmard,Marc-Kevin Goellner,Jerome Golmard,6-2; 3-6; 7-6(7),R64,146,4,5,60,116,42,60,32,56,10,12,14,74,116,12,8,71,129,49,71,28,58,10,13,15,77,129
1995-04-10 00:00:00.000,Barcelona Spain ATP World Tour,CLAY,2,Roberto Carretero,Francisco Roig,Roberto Carretero,3-6; 6-4; 6-4,R64,109,1,7,61,89,37,61,13,28,4,8,14,50,89,2,2,49,87,33,49,18,38,2,7,15,51,87
1995-04-10 00:00:00.000,Barcelona Spain ATP World Tour,CLAY,2,Richard Krajicek,N/A Bye,Richard Krajicek,,R64,0,0,0,0,0,0,0,0,0,0,0,0,0,0,0,0,0,0,0,0,0,0,0,0,0,0,0
1995-04-10 00:00:00.000,Barcelona Spain ATP World Tour,CLAY,2,Goran Ivanisevic,N/A Bye,Goran Ivanisevic,,R64,0,0,0,0,0,0,0,0,0,0,0,0,0,0,0,0,0,0,0,0,0,0,0,0,0,0,0
1995-04-10 00:00:00.000,Barcelona Spain ATP World Tour,CLAY,2,Fabrice Santoro,Sandor Noszaly,Fabrice Santoro,5-7; 6-1; 6-2,R64,116,3,2,45,74,34,45,17,29,5,7,13,51,74,0,2,73,91,42,73,6,18,5,11,14,48,91
1995-04-10 00:00:00.000,Barcelona Spain ATP World Tour,CLAY,2,Christian Ruud,Franco Davin,Christian Ruud,6-1; 6-1,R64,52,2,1,34,41,24,34,2,7,0,1,7,26,41,0,3,25,35,5,25,5,10,3,9,7,10,35
1995-04-10 00:00:00.000,Barcelona Spain ATP World Tour,CLAY,2,Emilio Sanchez,Jacco Eltingh,Emilio Sanchez,6-4; 6-4,R64,72,7,0,42,56,33,42,9,14,1,1,10,42,56,6,6,31,56,22,31,14,25,0,2,10,36,56
1995-04-10 00:00:00.000,Barcelona Spain ATP World Tour,CLAY,2,Karel Novacek,Karol Kucera,Karel Novacek,6-4; 6-3,R64,84,8,1,50,75,32,50,11,25,6,9,9,43,75,0,2,43,62,20,43,10,19,3,9,10,30,62
1995-04-10 00:00:00.000,Barcelona Spain ATP World Tour,CLAY,2,Andrei Chesnokov,Andrei Olhovskiy,Andrei Chesnokov,7-6(4); 7-5,R64,90,1,3,72,86,46,72,8,14,5,8,12,54,86,5,1,40,78,29,40,18,38,4,8,12,47,78
1995-04-10 00:00:00.000,Barcelona Spain ATP World Tour,CLAY,2,Jaime Yzaga,Albert Costa,Jaime Yzaga,6-2; 6-3,R64,66,6,2,33,50,25,33,9,17,1,1,8,34,50,0,0,43,57,23,43,6,14,2,6,9,29,57
1995-04-10 00:00:00.000,Barcelona Spain ATP World Tour,CLAY,2,Alberto Berasategui,N/A Bye,Alberto Berasategui,,R64,0,0,0,0,0,0,0,0,0,0,0,0,0,0,0,0,0,0,0,0,0,0,0,0,0,0,0
1995-04-10 00:00:00.000,Barcelona Spain ATP World Tour,CLAY,2,Magnus Larsson,N/A Bye,Magnus Larsson,,R64,0,0,0,0,0,0,0,0,0,0,0,0,0,0,0,0,0,0,0,0,0,0,0,0,0,0,0
1995-04-10 00:00:00.000,Barcelona Spain ATP World Tour,CLAY,2,Oscar Martinez,Radomir Vasek,Oscar Martinez,6-4; 6-3,R64,75,5,3,33,58,23,33,11,25,4,7,10,34,58,1,5,36,64,21,36,10,28,7,12,9,31,64
1995-04-10 00:00:00.000,Barcelona Spain ATP World Tour,CLAY,2,Tomas Carbonell,Bryan Shelton,Tomas Carbonell,3-6; 6-4; 7-6(3),R64,122,2,6,77,102,52,77,11,25,9,13,15,63,102,6,10,60,108,42,60,21,48,2,6,16,63,108
1995-04-10 00:00:00.000,Barcelona Spain ATP World Tour,CLAY,2,Henri Leconte,Andrea Gaudenzi,Henri Leconte,6-2; 3-6; 6-4,R64,95,8,6,36,85,26,36,21,49,5,10,14,47,85,2,5,41,70,26,41,12,29,3,9,13,38,70
1995-04-10 00:00:00.000,Barcelona Spain ATP World Tour,CLAY,2,Guy Forget,Arnaud Boetsch,Guy Forget,7-6(4); 6-3,R64,102,7,2,43,74,32,43,19,31,4,5,11,51,74,1,1,43,76,29,43,17,33,2,4,10,46,76
1995-04-10 00:00:00.000,Barcelona Spain ATP World Tour,CLAY,2,Jordi Arrese,Francisco Clavet,Jordi Arrese,6-2; 4-6; 7-6(4),R64,188,3,1,77,116,47,77,20,39,11,16,15,67,116,1,2,85,137,47,85,25,52,19,25,15,72,137
1995-04-10 00:00:00.000,Barcelona Spain ATP World Tour,CLAY,2,Gilbert Schaller,MaliVai Washington,Gilbert Schaller,6-2; 6-4,R64,91,2,0,42,55,25,42,10,13,3,5,9,35,55,5,4,41,71,23,41,12,30,11,16,9,35,71
1995-04-10 00:00:00.000,Barcelona Spain ATP World Tour,CLAY,2,Sergi Bruguera,N/A Bye,Sergi Bruguera,,R64,0,0,0,0,0,0,0,0,0,0,0,0,0,0,0,0,0,0,0,0,0,0,0,0,0,0,0
1995-04-10 00:00:00.000,Barcelona Spain ATP World Tour,CLAY,2,Oliver Gross,Pete Sampras,Oliver Gross,1-6; 6-2; 6-3,R32,103,2,1,51,85,35,51,13,34,7,11,12,48,85,4,5,43,87,26,43,20,44,13,18,12,46,87
1995-04-10 00:00:00.000,Barcelona Spain ATP World Tour,CLAY,2,Carlos Costa,Paul Haarhuis,Carlos Costa,6-3; 6-2,R32,74,3,2,31,56,26,31,13,25,0,0,9,39,56,2,1,29,56,16,29,16,27,6,9,8,32,56
1995-04-10 00:00:00.000,Barcelona Spain ATP World Tour,CLAY,2,Thomas Muster,Andrei Cherkasov,Thomas Muster,6-3; 6-2,R32,62,6,1,29,53,22,29,16,24,1,1,9,38,53,2,1,28,47,17,28,9,19,1,4,8,26,47
1995-04-10 00:00:00.000,Barcelona Spain ATP World Tour,CLAY,2,Javier Sanchez,Andrei Medvedev,Javier Sanchez,6-1; 1-6; 6-0,R32,76,0,2,47,62,25,47,10,15,6,10,10,35,62,3,2,30,64,13,30,14,34,3,10,10,27,64
1995-04-10 00:00:00.000,Barcelona Spain ATP World Tour,CLAY,2,Yevgeny Kafelnikov,Richard Fromberg,Yevgeny Kafelnikov,6-2; 6-7(7); 6-2,R32,120,5,4,52,86,36,52,20,34,6,9,14,56,86,6,5,49,97,32,49,19,48,7,14,14,51,97
1995-04-10 00:00:00.000,Barcelona Spain ATP World Tour,CLAY,2,Marcelo Rios,Bernd Karbacher,Marcelo Rios,6-3; 6-3,R32,62,0,1,27,48,20,27,15,21,3,4,9,35,48,9,0,27,51,17,27,11,24,2,6,9,28,51
1995-04-10 00:00:00.000,Barcelona Spain ATP World Tour,CLAY,2,Thierry Champion,Jerome Golmard,Thierry Champion,6-4; 6-3,R32,86,4,0,43,61,30,43,12,18,1,1,9,42,61,1,3,39,68,25,39,16,29,5,8,10,41,68
1995-04-10 00:00:00.000,Barcelona Spain ATP World Tour,CLAY,2,Roberto Carretero,Richard Krajicek,Roberto Carretero,7-5; 6-2,R32,67,1,1,43,56,32,43,8,13,3,4,10,40,56,6,3,37,63,25,37,10,26,5,9,10,35,63
1995-04-10 00:00:00.000,Barcelona Spain ATP World Tour,CLAY,2,Goran Ivanisevic,Fabrice Santoro,Goran Ivanisevic,6-4; 6-1,R32,68,8,2,41,67,30,41,16,26,6,6,9,46,67,1,6,33,53,20,33,10,20,4,7,8,30,53
1995-04-10 00:00:00.000,Barcelona Spain ATP World Tour,CLAY,2,Christian Ruud,Emilio Sanchez,Christian Ruud,6-0; 6-4,R32,70,3,3,26,47,20,26,11,21,2,3,8,31,47,2,0,33,52,18,33,7,19,3,8,8,25,52
1995-04-10 00:00:00.000,Barcelona Spain ATP World Tour,CLAY,2,Karel Novacek,Andrei Chesnokov,Karel Novacek,6-4; 2-6; 6-2,R32,105,6,4,49,83,35,49,16,34,8,11,13,51,83,4,1,57,93,36,57,17,36,10,14,13,53,93
1995-04-10 00:00:00.000,Barcelona Spain ATP World Tour,CLAY,2,Alberto Berasategui,Jaime Yzaga,Alberto Berasategui,7-6(2); 6-2,R32,86,1,3,41,66,27,41,11,25,4,7,10,38,66,6,4,40,71,24,40,11,31,5,10,10,35,71
1995-04-10 00:00:00.000,Barcelona Spain ATP World Tour,CLAY,2,Magnus Larsson,Oscar Martinez,Magnus Larsson,3-6; 7-5; 6-4,R32,97,6,1,56,80,44,56,13,24,2,4,15,57,80,0,2,47,91,33,47,28,44,6,9,16,61,91
1995-04-10 00:00:00.000,Barcelona Spain ATP World Tour,CLAY,2,Tomas Carbonell,Henri Leconte,Tomas Carbonell,6-3; 3-6; 6-4,R32,94,2,5,54,74,40,54,11,20,3,5,14,51,74,9,6,33,85,26,33,27,52,3,6,14,53,85
1995-04-10 00:00:00.000,Barcelona Spain ATP World Tour,CLAY,2,Jordi Arrese,Guy Forget,Jordi Arrese,2-6; 6-2; 7-5,R32,134,3,2,56,80,37,56,14,24,2,6,14,51,80,2,0,50,84,35,50,16,34,7,12,14,51,84
1995-04-10 00:00:00.000,Barcelona Spain ATP World Tour,CLAY,2,Gilbert Schaller,Sergi Bruguera,Gilbert Schaller,7-5; 6-1,R32,79,1,0,44,49,29,44,4,5,0,2,9,33,49,4,2,41,75,25,41,11,34,8,14,10,36,75
1995-04-10 00:00:00.000,Barcelona Spain ATP World Tour,CLAY,2,Carlos Costa,Oliver Gross,Carlos Costa,6-3; 7-6(2),R16,82,7,3,46,72,37,46,12,26,3,5,11,49,72,1,3,35,62,26,35,11,27,0,3,10,37,62
1995-04-10 00:00:00.000,Barcelona Spain ATP World Tour,CLAY,2,Thomas Muster,Javier Sanchez,Thomas Muster,7-6(5); 6-4,R16,102,2,2,36,66,28,36,17,30,3,5,11,45,66,1,3,64,97,36,64,18,33,4,7,11,54,97
1995-04-10 00:00:00.000,Barcelona Spain ATP World Tour,CLAY,2,Yevgeny Kafelnikov,Marcelo Rios,Yevgeny Kafelnikov,6-4; 6-3,R16,80,4,2,39,66,29,39,9,27,1,4,10,38,66,4,3,48,71,26,48,10,23,7,12,9,36,71
1995-04-10 00:00:00.000,Barcelona Spain ATP World Tour,CLAY,2,Thierry Champion,Roberto Carretero,Thierry Champion,6-3; 5-7; 6-2,R16,118,12,3,48,83,30,48,16,35,1,6,14,46,83,0,0,61,95,26,61,19,34,11,19,15,45,95
1995-04-10 00:00:00.000,Barcelona Spain ATP World Tour,CLAY,2,Goran Ivanisevic,Christian Ruud,Goran Ivanisevic,7-5; 6-1,R16,69,9,3,28,55,24,28,11,27,1,3,10,35,55,2,2,25,52,12,25,12,27,4,9,9,24,52
1995-04-10 00:00:00.000,Barcelona Spain ATP World Tour,CLAY,2,Alberto Berasategui,Karel Novacek,Alberto Berasategui,6-3; 7-6(3),R16,74,0,2,50,64,38,50,9,14,3,4,10,47,64,3,2,46,71,31,46,11,25,4,7,11,42,71
1995-04-10 00:00:00.000,Barcelona Spain ATP World Tour,CLAY,2,Magnus Larsson,Tomas Carbonell,Magnus Larsson,6-2; 6-1,R16,49,4,4,32,49,22,32,9,17,2,3,8,31,49,0,4,29,42,15,29,3,13,2,7,7,18,42
1995-04-10 00:00:00.000,Barcelona Spain ATP World Tour,CLAY,2,Jordi Arrese,Gilbert Schaller,Jordi Arrese,6-3; 7-6(4),R16,127,2,2,69,90,42,69,11,21,11,14,11,53,90,0,2,50,71,29,50,9,21,8,12,10,38,71
1995-04-10 00:00:00.000,Barcelona Spain ATP World Tour,CLAY,2,Thomas Muster,Carlos Costa,Thomas Muster,6-3; 3-6; 7-5,Q,119,2,2,53,86,41,53,18,33,2,4,15,59,86,6,1,41,86,35,41,20,45,3,6,15,55,86
1995-04-10 00:00:00.000,Barcelona Spain ATP World Tour,CLAY,2,Yevgeny Kafelnikov,Thierry Champion,Yevgeny Kafelnikov,6-4; 6-3,Q,83,3,4,29,67,24,29,20,38,7,8,10,44,67,1,2,33,60,19,33,16,27,1,4,9,35,60
1995-04-10 00:00:00.000,Barcelona Spain ATP World Tour,CLAY,2,Goran Ivanisevic,Alberto Berasategui,Goran Ivanisevic,1-6; 6-4; 6-4,Q,92,17,5,46,97,35,46,26,51,5,8,14,61,97,0,2,58,73,39,58,9,15,1,3,13,48,73
1995-04-10 00:00:00.000,Barcelona Spain ATP World Tour,CLAY,2,Magnus Larsson,Jordi Arrese,Magnus Larsson,6-3; 6-1,Q,60,5,1,28,42,25,28,7,14,0,0,8,32,42,0,2,32,55,20,32,7,23,6,10,8,27,55
1995-04-10 00:00:00.000,Barcelona Spain ATP World Tour,CLAY,2,Thomas Muster,Yevgeny Kafelnikov,Thomas Muster,6-3; 6-3,S,77,1,0,38,66,26,38,14,28,5,7,9,40,66,2,2,30,54,16,30,9,24,4,9,9,25,54
1995-04-10 00:00:00.000,Barcelona Spain ATP World Tour,CLAY,2,Magnus Larsson,Goran Ivanisevic,Magnus Larsson,6-4; 4-6; 6-4,S,95,9,3,63,94,47,63,18,31,3,4,15,65,94,14,2,54,88,38,54,20,34,4,6,15,58,88
1995-04-10 00:00:00.000,Barcelona Spain ATP World Tour,CLAY,2,Thomas Muster,Magnus Larsson,Thomas Muster,6-2; 6-1; 6-4,F,93,1,0,50,70,39,50,14,20,2,2,12,53,70,5,4,52,100,34,52,16,48,10,16,13,50,100
1995-04-10 00:00:00.000,Tokyo Outdoor Japan ATP World Tour,HARD,2,Andre Agassi,N/A Bye,Andre Agassi,,R64,0,0,0,0,0,0,0,0,0,0,0,0,0,0,0,0,0,0,0,0,0,0,0,0,0,0,0
1995-04-10 00:00:00.000,Tokyo Outdoor Japan ATP World Tour,HARD,2,Tommy Ho,Marcos Ondruska,Tommy Ho,6-3; 6-3,R64,90,0,0,35,56,25,35,13,21,0,1,9,38,56,2,0,35,72,20,35,17,37,9,13,9,37,72
1995-04-10 00:00:00.000,Tokyo Outdoor Japan ATP World Tour,HARD,2,Carsten Arriens,Leander Paes,Carsten Arriens,7-5; 6-3,R64,82,4,1,43,70,32,43,15,27,1,2,11,47,70,2,2,46,65,31,46,8,19,2,5,10,39,65
1995-04-10 00:00:00.000,Tokyo Outdoor Japan ATP World Tour,HARD,2,Sebastien Lareau,Roger Smith,Sebastien Lareau,6-3; 6-3,R64,82,4,4,33,55,29,33,10,22,1,2,9,39,55,4,10,49,84,31,49,12,35,10,14,9,43,84
1995-04-10 00:00:00.000,Tokyo Outdoor Japan ATP World Tour,HARD,2,Scott Draper,Jonathan Stark,Scott Draper,6-3; 7-6(5),R64,93,5,0,41,72,31,41,23,31,3,3,11,54,72,8,2,48,77,38,48,11,29,2,3,10,49,77
1995-04-10 00:00:00.000,Tokyo Outdoor Japan ATP World Tour,HARD,2,David Prinosil,Patrick Baur,David Prinosil,6-1; 6-2,R64,48,2,0,22,45,18,22,17,23,4,4,8,35,45,0,0,24,37,12,24,4,13,1,5,7,16,37
1995-04-10 00:00:00.000,Tokyo Outdoor Japan ATP World Tour,HARD,2,Michael Joyce,Dick Norman,Michael Joyce,7-6(5); 6-3,R64,81,4,2,46,73,37,46,16,27,1,1,11,53,73,15,2,43,66,33,43,12,23,7,8,10,45,66
1995-04-10 00:00:00.000,Tokyo Outdoor Japan ATP World Tour,HARD,2,Hendrik Jan Davids,N/A Bye,Hendrik Jan Davids,,R64,0,0,0,0,0,0,0,0,0,0,0,0,0,0,0,0,0,0,0,0,0,0,0,0,0,0,0
1995-04-10 00:00:00.000,Tokyo Outdoor Japan ATP World Tour,HARD,2,Wayne Ferreira,N/A Bye,Wayne Ferreira,,R64,0,0,0,0,0,0,0,0,0,0,0,0,0,0,0,0,0,0,0,0,0,0,0,0,0,0,0
1995-04-10 00:00:00.000,Tokyo Outdoor Japan ATP World Tour,HARD,2,Dimitri Poliakov,Guillaume Raoux,Dimitri Poliakov,6-2; 6-3,R64,58,4,2,34,52,24,34,11,18,0,1,9,35,52,3,1,29,60,20,29,9,31,10,14,8,29,60
1995-04-10 00:00:00.000,Tokyo Outdoor Japan ATP World Tour,HARD,2,Sule Ladipo,Nicolas Pereira,Sule Ladipo,4-6; 6-4; 6-1,R64,97,1,1,74,97,52,74,13,23,4,5,14,65,97,9,1,58,81,42,58,10,23,4,7,13,52,81
1995-04-10 00:00:00.000,Tokyo Outdoor Japan ATP World Tour,HARD,2,Jeff Tarango,Satoshi Iwabuchi,Jeff Tarango,6-1; 6-3,R64,47,6,2,33,46,25,33,8,13,1,1,8,33,46,1,4,19,43,13,19,11,24,2,6,8,24,43
1995-04-10 00:00:00.000,Tokyo Outdoor Japan ATP World Tour,HARD,2,Lionel Roux,Takao Suzuki,Lionel Roux,6-4; 6-4,R64,74,1,1,42,62,29,42,10,20,3,5,10,39,62,4,1,37,61,24,37,11,24,6,10,10,35,61
1995-04-10 00:00:00.000,Tokyo Outdoor Japan ATP World Tour,HARD,2,Steve Campbell,Laurence Tieleman,Steve Campbell,6-1; 6-4,R64,53,3,0,25,53,19,25,20,28,0,0,9,39,53,5,4,32,56,19,32,12,24,3,6,8,31,56
1995-04-10 00:00:00.000,Tokyo Outdoor Japan ATP World Tour,HARD,2,Libor Nemecek,Paul Wekesa,Libor Nemecek,6-3; 7-5,R64,72,0,2,53,63,39,53,5,10,2,3,11,44,63,1,0,41,64,24,41,13,23,5,8,10,37,64
1995-04-10 00:00:00.000,Tokyo Outdoor Japan ATP World Tour,HARD,2,Jonas Bjorkman,N/A Bye,Jonas Bjorkman,,R64,0,0,0,0,0,0,0,0,0,0,0,0,0,0,0,0,0,0,0,0,0,0,0,0,0,0,0
1995-04-10 00:00:00.000,Tokyo Outdoor Japan ATP World Tour,HARD,2,Thomas Enqvist,N/A Bye,Thomas Enqvist,,R64,0,0,0,0,0,0,0,0,0,0,0,0,0,0,0,0,0,0,0,0,0,0,0,0,0,0,0
1995-04-10 00:00:00.000,Tokyo Outdoor Japan ATP World Tour,HARD,2,Gouichi Motomura,Toshiaki Sakai,Gouichi Motomura,6-4; 6-2,R64,73,1,1,31,54,20,31,14,23,4,6,9,34,54,4,3,28,59,15,28,13,31,5,10,9,28,59
1995-04-10 00:00:00.000,Tokyo Outdoor Japan ATP World Tour,HARD,2,Lionel Barthez,Lars Rehmann,Lionel Barthez,7-6(3); 6-3,R64,98,3,4,45,67,34,45,13,22,1,2,11,47,67,0,0,58,82,32,58,15,24,12,14,10,47,82
1995-04-10 00:00:00.000,Tokyo Outdoor Japan ATP World Tour,HARD,2,Wally Masur,Patrick McEnroe,Wally Masur,6-2; 6-4,R64,85,8,1,36,55,28,36,7,19,1,2,9,35,55,0,1,51,77,27,51,13,26,4,8,9,40,77
1995-04-10 00:00:00.000,Tokyo Outdoor Japan ATP World Tour,HARD,2,Greg Rusedski,Paul Kilderry,Greg Rusedski,6-3; 6-3,R64,56,9,3,34,49,29,34,10,15,3,3,9,39,49,1,1,24,50,17,24,13,26,3,6,9,30,50
1995-04-10 00:00:00.000,Tokyo Outdoor Japan ATP World Tour,HARD,2,Jan Kroslak,Alexander Mronz,Jan Kroslak,7-6(5); 6-2,R64,89,6,5,51,86,38,51,18,35,8,9,10,56,86,3,0,38,67,24,38,15,29,3,6,10,39,67
1995-04-10 00:00:00.000,Tokyo Outdoor Japan ATP World Tour,HARD,2,Anders Jarryd,Luis Herrera,Anders Jarryd,6-2; 5-7; 6-1,R64,102,0,2,52,83,40,52,18,31,3,4,14,58,83,0,1,68,91,33,68,17,23,6,10,13,50,91
1995-04-10 00:00:00.000,Tokyo Outdoor Japan ATP World Tour,HARD,2,Jim Courier,N/A Bye,Jim Courier,,R64,0,0,0,0,0,0,0,0,0,0,0,0,0,0,0,0,0,0,0,0,0,0,0,0,0,0,0
1995-04-10 00:00:00.000,Tokyo Outdoor Japan ATP World Tour,HARD,2,Jan Siemerink,N/A Bye,Jan Siemerink,,R64,0,0,0,0,0,0,0,0,0,0,0,0,0,0,0,0,0,0,0,0,0,0,0,0,0,0,0
1995-04-10 00:00:00.000,Tokyo Outdoor Japan ATP World Tour,HARD,2,Jan Apell,Jim Grabb,Jan Apell,7-6(3); 7-6(3),R64,97,3,0,50,72,41,50,16,22,1,1,12,57,72,10,4,60,81,48,60,8,21,3,3,12,56,81
1995-04-10 00:00:00.000,Tokyo Outdoor Japan ATP World Tour,HARD,2,Kotaro Miyachi,David Pate,Kotaro Miyachi,6-2; 2-6; 6-3,R64,106,5,3,53,94,34,53,23,41,8,11,13,57,94,10,1,67,94,40,67,13,27,13,17,12,53,94
1995-04-10 00:00:00.000,Tokyo Outdoor Japan ATP World Tour,HARD,2,Stephen Noteboom,Martin Damm,Stephen Noteboom,6-3; 6-1,R64,49,2,0,26,46,23,26,11,20,3,3,8,34,46,1,4,26,40,15,26,4,14,0,4,8,19,40
1995-04-10 00:00:00.000,Tokyo Outdoor Japan ATP World Tour,HARD,2,Kenneth Carlsen,Tomas Nydahl,Kenneth Carlsen,6-4; 6-2,R64,69,13,2,35,56,28,35,12,21,2,2,9,40,56,3,2,44,64,28,44,10,20,3,6,9,38,64
1995-04-10 00:00:00.000,Tokyo Outdoor Japan ATP World Tour,HARD,2,Jakob Hlasek,Mark Petchey,Jakob Hlasek,7-5; 6-1,R64,102,4,6,56,100,38,56,23,44,6,9,14,61,100,5,1,46,81,30,46,15,35,1,5,13,45,81
1995-04-10 00:00:00.000,Tokyo Outdoor Japan ATP World Tour,HARD,2,Shuzo Matsuoka,Henrik Holm,Shuzo Matsuoka,4-6; 6-3; 7-6(5),R64,146,12,2,64,97,46,64,15,33,1,6,16,61,97,9,12,46,106,34,46,27,60,5,10,15,61,106
1995-04-10 00:00:00.000,Tokyo Outdoor Japan ATP World Tour,HARD,2,Michael Chang,N/A Bye,Michael Chang,,R64,0,0,0,0,0,0,0,0,0,0,0,0,0,0,0,0,0,0,0,0,0,0,0,0,0,0,0
1995-04-10 00:00:00.000,Tokyo Outdoor Japan ATP World Tour,HARD,2,Andre Agassi,Tommy Ho,Andre Agassi,6-3; 6-2,R32,64,4,1,38,60,30,38,11,22,0,0,9,41,60,2,1,29,58,21,29,12,29,10,13,8,33,58
1995-04-10 00:00:00.000,Tokyo Outdoor Japan ATP World Tour,HARD,2,Sebastien Lareau,Carsten Arriens,Sebastien Lareau,7-5; 6-1,R32,72,6,3,32,60,25,32,16,28,5,6,10,41,60,3,3,34,55,23,34,6,21,4,8,9,29,55
1995-04-10 00:00:00.000,Tokyo Outdoor Japan ATP World Tour,HARD,2,Scott Draper,David Prinosil,Scott Draper,7-6(5); 6-4,R32,68,3,1,40,61,33,40,15,21,2,3,11,48,61,4,6,44,78,31,44,18,34,6,8,11,49,78
1995-04-10 00:00:00.000,Tokyo Outdoor Japan ATP World Tour,HARD,2,Michael Joyce,Hendrik Jan Davids,Michael Joyce,7-5; 6-3,R32,67,1,4,35,59,29,35,11,24,2,4,11,40,59,4,2,26,55,19,26,13,29,2,6,10,32,55
1995-04-10 00:00:00.000,Tokyo Outdoor Japan ATP World Tour,HARD,2,Wayne Ferreira,Dimitri Poliakov,Wayne Ferreira,6-1; 6-3,R32,55,5,0,24,40,21,24,12,16,0,0,8,33,40,0,6,34,64,21,34,11,30,8,12,8,32,64
1995-04-10 00:00:00.000,Tokyo Outdoor Japan ATP World Tour,HARD,2,Jeff Tarango,Sule Ladipo,Jeff Tarango,6-2; 6-3,R32,53,4,3,26,47,21,26,12,21,1,2,9,33,47,5,4,35,51,22,35,4,16,2,6,8,26,51
1995-04-10 00:00:00.000,Tokyo Outdoor Japan ATP World Tour,HARD,2,Steve Campbell,Lionel Roux,Steve Campbell,6-4; 5-7; 6-2,R32,133,4,6,46,96,33,46,29,50,7,10,15,62,96,5,5,54,106,39,54,23,52,7,12,15,62,106
1995-04-10 00:00:00.000,Tokyo Outdoor Japan ATP World Tour,HARD,2,Jonas Bjorkman,Libor Nemecek,Jonas Bjorkman,6-3; 6-3,R32,62,0,3,31,54,23,31,11,23,2,4,9,34,54,0,0,42,47,22,42,1,5,1,6,9,23,47
1995-04-10 00:00:00.000,Tokyo Outdoor Japan ATP World Tour,HARD,2,Thomas Enqvist,Gouichi Motomura,Thomas Enqvist,6-2; 6-3,R32,66,1,2,24,50,21,24,14,26,2,3,9,35,50,1,4,25,51,15,25,9,26,1,5,8,24,51
1995-04-10 00:00:00.000,Tokyo Outdoor Japan ATP World Tour,HARD,2,Wally Masur,Lionel Barthez,Wally Masur,6-3; 3-6; 6-2,R32,103,5,0,62,82,41,62,14,20,5,7,13,55,82,0,7,50,89,31,50,18,39,3,7,13,49,89
1995-04-10 00:00:00.000,Tokyo Outdoor Japan ATP World Tour,HARD,2,Greg Rusedski,Jan Kroslak,Greg Rusedski,6-3; 7-6(2),R32,70,15,4,34,57,29,34,13,23,0,1,11,42,57,3,3,57,76,35,57,7,19,9,11,10,42,76
1995-04-10 00:00:00.000,Tokyo Outdoor Japan ATP World Tour,HARD,2,Jim Courier,Anders Jarryd,Jim Courier,4-6; 6-4; 7-5,R32,128,8,1,62,96,46,62,19,34,4,6,16,65,96,5,1,49,84,34,49,21,35,0,3,16,55,84
1995-04-10 00:00:00.000,Tokyo Outdoor Japan ATP World Tour,HARD,2,Jan Apell,Jan Siemerink,Jan Apell,6-4; 6-4,R32,65,2,1,36,57,29,36,13,21,1,1,10,42,57,10,4,40,61,31,40,10,21,4,6,10,41,61
1995-04-10 00:00:00.000,Tokyo Outdoor Japan ATP World Tour,HARD,2,Kotaro Miyachi,Stephen Noteboom,Kotaro Miyachi,6-3; 7-6(4),R32,102,4,9,50,88,38,50,15,38,7,10,11,53,88,2,1,48,79,31,48,12,31,6,10,10,43,79
1995-04-10 00:00:00.000,Tokyo Outdoor Japan ATP World Tour,HARD,2,Kenneth Carlsen,Jakob Hlasek,Kenneth Carlsen,6-4; 7-5,R32,79,6,0,42,67,32,42,12,25,3,4,11,44,67,1,3,46,74,33,46,11,28,5,8,11,44,74
1995-04-10 00:00:00.000,Tokyo Outdoor Japan ATP World Tour,HARD,2,Michael Chang,Shuzo Matsuoka,Michael Chang,6-4; 6-2,R32,90,2,0,33,59,21,33,18,26,2,3,9,39,59,3,0,39,59,22,39,11,20,5,9,9,33,59
1995-04-10 00:00:00.000,Tokyo Outdoor Japan ATP World Tour,HARD,2,Andre Agassi,Sebastien Lareau,Andre Agassi,6-3; 7-5,R16,75,2,0,38,60,28,38,15,22,1,2,11,43,60,9,3,36,65,27,36,11,29,3,6,10,38,65
1995-04-10 00:00:00.000,Tokyo Outdoor Japan ATP World Tour,HARD,2,Scott Draper,Michael Joyce,Scott Draper,6-1; 6-4,R16,52,4,1,27,46,21,27,12,19,0,0,8,33,46,2,1,29,52,16,29,12,23,1,5,9,28,52
1995-04-10 00:00:00.000,Tokyo Outdoor Japan ATP World Tour,HARD,2,Wayne Ferreira,Jeff Tarango,Wayne Ferreira,6-3; 3-6; 6-3,R16,84,14,1,42,69,34,42,18,27,0,1,14,52,69,3,2,44,70,30,44,18,26,1,3,13,48,70
1995-04-10 00:00:00.000,Tokyo Outdoor Japan ATP World Tour,HARD,2,Jonas Bjorkman,Steve Campbell,Jonas Bjorkman,6-1; 6-4,R16,55,6,3,22,41,18,22,11,19,4,4,6,29,41,1,0,30,50,11,30,9,20,5,11,7,20,50
1995-04-10 00:00:00.000,Tokyo Outdoor Japan ATP World Tour,HARD,2,Thomas Enqvist,Wally Masur,Thomas Enqvist,6-4; 6-0,R16,47,7,1,27,40,27,27,6,13,1,1,8,33,40,5,0,36,50,20,36,5,14,4,8,8,25,50
1995-04-10 00:00:00.000,Tokyo Outdoor Japan ATP World Tour,HARD,2,Jim Courier,Greg Rusedski,Jim Courier,4-6; 7-6(7); 6-4,R16,124,4,0,72,98,53,72,13,26,1,3,16,66,98,21,8,54,102,42,54,29,48,3,5,16,71,102
1995-04-10 00:00:00.000,Tokyo Outdoor Japan ATP World Tour,HARD,2,Jan Apell,Kotaro Miyachi,Jan Apell,6-2; 6-3,R16,63,7,2,30,46,24,30,7,16,3,4,8,31,46,0,2,38,58,17,38,10,20,2,7,9,27,58
1995-04-10 00:00:00.000,Tokyo Outdoor Japan ATP World Tour,HARD,2,Michael Chang,Kenneth Carlsen,Michael Chang,6-7(7); 6-3; 6-4,R16,127,1,0,66,98,51,66,20,32,1,2,16,71,98,9,3,66,108,47,66,22,42,5,8,15,69,108
1995-04-10 00:00:00.000,Tokyo Outdoor Japan ATP World Tour,HARD,2,Andre Agassi,Scott Draper,Andre Agassi,6-4; 6-3,Q,73,3,0,34,51,25,34,13,17,1,1,9,38,51,6,1,50,82,32,50,14,32,2,5,10,46,82
1995-04-10 00:00:00.000,Tokyo Outdoor Japan ATP World Tour,HARD,2,Wayne Ferreira,Jonas Bjorkman,Wayne Ferreira,6-3; 6-2,Q,57,8,2,33,56,30,33,8,23,2,3,9,38,56,0,2,26,43,16,26,6,17,0,4,8,22,43
1995-04-10 00:00:00.000,Tokyo Outdoor Japan ATP World Tour,HARD,2,Jim Courier,Thomas Enqvist,Jim Courier,7-6(4); 6-0,Q,75,11,1,31,47,25,31,11,16,0,1,9,36,47,7,2,31,66,19,31,16,35,2,6,9,35,66
1995-04-10 00:00:00.000,Tokyo Outdoor Japan ATP World Tour,HARD,2,Michael Chang,Jan Apell,Michael Chang,4-6; 7-6(7); 6-3,Q,139,4,1,61,93,46,61,19,32,1,3,15,65,93,9,6,80,128,57,80,20,48,7,10,16,77,128
1995-04-10 00:00:00.000,Tokyo Outdoor Japan ATP World Tour,HARD,2,Andre Agassi,Wayne Ferreira,Andre Agassi,7-5; 6-2,S,67,3,0,44,61,37,44,7,17,3,3,10,44,61,7,4,35,63,26,35,11,28,1,4,10,37,63
1995-04-10 00:00:00.000,Tokyo Outdoor Japan ATP World Tour,HARD,2,Jim Courier,Michael Chang,Jim Courier,6-4; 7-5,S,90,4,1,42,65,34,42,13,23,1,1,11,47,65,3,1,39,64,28,39,12,25,2,4,11,40,64
1995-04-10 00:00:00.000,Tokyo Outdoor Japan ATP World Tour,HARD,2,Jim Courier,Andre Agassi,Jim Courier,6-4; 6-3,F,76,4,4,32,55,25,32,11,23,1,3,10,36,55,5,6,42,68,24,42,11,26,5,9,9,35,68
1995-04-17 00:00:00.000,Bermuda Bermuda ATP World Tour,CLAY,2,Todd Martin,Kenny Thorne,Todd Martin,2-6; 6-3; 6-4,R32,102,3,2,47,68,32,47,9,21,1,6,14,41,68,2,2,58,77,36,58,8,19,3,8,13,44,77
1995-04-17 00:00:00.000,Bermuda Bermuda ATP World Tour,CLAY,2,Michael Tebbutt,Hernan Gumy,Michael Tebbutt,4-6; 7-6(4); 6-4,R32,132,17,1,63,100,46,63,24,37,5,7,16,70,100,3,2,63,93,47,63,17,30,2,4,16,64,93
1995-04-17 00:00:00.000,Bermuda Bermuda ATP World Tour,CLAY,2,Bryan Shelton,Alejo Mancisidor,Bryan Shelton,6-2; 7-5,R32,73,2,1,34,54,23,34,13,20,1,3,10,36,54,1,1,60,74,33,60,6,14,9,14,10,39,74
1995-04-17 00:00:00.000,Bermuda Bermuda ATP World Tour,CLAY,2,Bohdan Ulihrach,Christian Ruud,Bohdan Ulihrach,3-6; 7-5; 6-2,R32,129,2,2,57,92,38,57,16,35,5,9,14,54,92,7,8,48,96,32,48,21,48,5,11,15,53,96
1995-04-17 00:00:00.000,Bermuda Bermuda ATP World Tour,CLAY,2,Mauricio Hadad,Brett Steven,Mauricio Hadad,0-6; 6-4; 6-3,R32,109,1,2,54,82,29,54,11,28,6,13,12,40,82,0,4,53,88,31,53,13,35,9,16,13,44,88
1995-04-17 00:00:00.000,Bermuda Bermuda ATP World Tour,CLAY,2,Lars Jonsson,Alex O'Brien,Lars Jonsson,1-6; 6-2; 7-5,R32,106,1,2,58,87,38,58,13,29,2,6,14,51,87,7,4,55,78,37,55,10,23,3,7,13,47,78
1995-04-17 00:00:00.000,Bermuda Bermuda ATP World Tour,CLAY,2,Jamie Morgan,David Witt,Jamie Morgan,6-2; 6-4,R32,63,6,4,27,46,25,27,12,19,3,3,9,37,46,8,1,28,53,20,28,11,25,6,9,9,31,53
1995-04-17 00:00:00.000,Bermuda Bermuda ATP World Tour,CLAY,2,Radomir Vasek,Fernando Meligeni,Radomir Vasek,1-6; 6-4; 6-3,R32,120,2,7,63,101,38,63,16,38,5,10,13,54,101,4,5,42,82,27,42,20,40,5,10,13,47,82
1995-04-17 00:00:00.000,Bermuda Bermuda ATP World Tour,CLAY,2,Vincent Spadea,Stefano Pescosolido,Vincent Spadea,7-5; 6-2,R32,93,4,1,57,78,35,57,11,21,8,10,10,46,78,5,6,29,58,18,29,9,29,1,6,10,27,58
1995-04-17 00:00:00.000,Bermuda Bermuda ATP World Tour,CLAY,2,Christian Bergstrom,Mats Wilander,Christian Bergstrom,6-2; 7-5,R32,108,1,0,39,62,25,39,16,23,1,2,10,41,62,2,2,56,72,34,56,6,16,7,11,10,40,72
1995-04-17 00:00:00.000,Bermuda Bermuda ATP World Tour,CLAY,2,Marcio Carlsson,Mark Merklein,Marcio Carlsson,6-4; 6-1,R32,79,1,1,44,58,24,44,11,14,5,7,9,35,58,2,2,28,50,13,28,10,22,2,7,8,23,50
1995-04-17 00:00:00.000,Bermuda Bermuda ATP World Tour,CLAY,2,Karsten Braasch,Martin Sinner,Karsten Braasch,5-7; 6-1; 6-2,R32,127,8,0,49,87,35,49,15,38,4,8,14,50,87,5,4,51,102,32,51,18,51,12,19,13,50,102
1995-04-17 00:00:00.000,Bermuda Bermuda ATP World Tour,CLAY,2,Karim Alami,Patrick McEnroe,Karim Alami,6-2; 7-6(5),R32,86,5,0,36,57,27,36,10,21,2,4,10,37,57,1,2,52,74,31,52,9,22,7,11,10,40,74
1995-04-17 00:00:00.000,Bermuda Bermuda ATP World Tour,CLAY,2,Javier Frana,Wade McGuire,Javier Frana,6-2; 6-2,R32,66,8,0,28,44,23,28,7,16,0,1,8,30,44,2,3,29,55,15,29,11,26,4,9,8,26,55
1995-04-17 00:00:00.000,Bermuda Bermuda ATP World Tour,CLAY,2,Jordi Arrese,Carl-Uwe Steeb,Jordi Arrese,6-3; 6-2,R32,62,3,1,46,54,35,46,4,8,1,1,9,39,54,2,2,36,50,21,36,6,14,0,3,8,27,50
1995-04-17 00:00:00.000,Bermuda Bermuda ATP World Tour,CLAY,2,Jason Stoltenberg,Louis Gloria,Jason Stoltenberg,6-4; 6-4,R32,67,3,0,36,54,24,36,15,18,1,2,10,39,54,0,3,36,53,24,36,9,17,3,6,10,33,53
1995-04-17 00:00:00.000,Bermuda Bermuda ATP World Tour,CLAY,2,Michael Tebbutt,Todd Martin,Michael Tebbutt,7-5; 6-3,R16,76,3,2,34,66,25,34,21,32,1,2,11,46,66,2,0,38,59,25,38,10,21,2,5,10,35,59
1995-04-17 00:00:00.000,Bermuda Bermuda ATP World Tour,CLAY,2,Bryan Shelton,Bohdan Ulihrach,Bryan Shelton,6-2; 6-2,R16,57,6,1,26,44,23,26,8,18,4,5,8,31,44,3,9,30,60,21,30,7,30,7,12,8,28,60
1995-04-17 00:00:00.000,Bermuda Bermuda ATP World Tour,CLAY,2,Mauricio Hadad,Lars Jonsson,Mauricio Hadad,2-6; 6-3; 6-1,R16,112,5,0,55,86,34,55,18,31,6,8,12,52,86,4,0,66,99,42,66,13,33,10,14,12,55,99
1995-04-17 00:00:00.000,Bermuda Bermuda ATP World Tour,CLAY,2,Jamie Morgan,Radomir Vasek,Jamie Morgan,2-6; 6-4; 7-6(2),R16,140,11,7,62,111,38,62,21,49,11,17,15,59,111,6,4,63,94,41,63,13,31,5,10,15,54,94
1995-04-17 00:00:00.000,Bermuda Bermuda ATP World Tour,CLAY,2,Vincent Spadea,Christian Bergstrom,Vincent Spadea,6-2; 6-2,R16,58,0,0,29,43,23,29,10,14,2,2,8,33,43,0,2,27,48,12,27,10,21,2,6,8,22,48
1995-04-17 00:00:00.000,Bermuda Bermuda ATP World Tour,CLAY,2,Karsten Braasch,Marcio Carlsson,Karsten Braasch,6-3; 6-3,R16,68,6,0,33,53,20,33,9,20,3,6,9,29,53,0,2,35,54,16,35,8,19,4,10,9,24,54
1995-04-17 00:00:00.000,Bermuda Bermuda ATP World Tour,CLAY,2,Javier Frana,Karim Alami,Javier Frana,6-0; 6-3,R16,61,5,0,42,46,28,42,3,4,2,3,8,31,46,0,1,38,55,18,38,7,17,2,7,7,25,55
1995-04-17 00:00:00.000,Bermuda Bermuda ATP World Tour,CLAY,2,Jason Stoltenberg,Jordi Arrese,Jason Stoltenberg,6-2; 6-4,R16,71,4,2,34,62,27,34,15,28,5,5,9,42,62,0,0,45,55,27,45,5,10,0,3,9,32,55
1995-04-17 00:00:00.000,Bermuda Bermuda ATP World Tour,CLAY,2,Bryan Shelton,Michael Tebbutt,Bryan Shelton,7-6(1); 1-6; 6-3,Q,110,15,5,56,98,40,56,19,42,7,11,14,59,98,12,5,50,79,36,50,14,29,0,3,14,50,79
1995-04-17 00:00:00.000,Bermuda Bermuda ATP World Tour,CLAY,2,Mauricio Hadad,Jamie Morgan,Mauricio Hadad,6-4; 7-6(3),Q,87,0,0,60,68,41,60,4,8,2,4,11,45,68,4,5,32,71,23,32,17,39,1,4,11,40,71
1995-04-17 00:00:00.000,Bermuda Bermuda ATP World Tour,CLAY,2,Vincent Spadea,Karsten Braasch,Vincent Spadea,6-2; 6-4,Q,77,1,0,26,51,20,26,14,25,2,4,9,34,51,3,1,40,69,25,40,10,29,4,9,9,35,69
1995-04-17 00:00:00.000,Bermuda Bermuda ATP World Tour,CLAY,2,Javier Frana,Jason Stoltenberg,Javier Frana,7-6(5); 6-1,Q,73,3,1,39,57,33,39,12,18,1,1,10,45,57,6,1,40,60,26,40,11,20,3,5,9,37,60
1995-04-17 00:00:00.000,Bermuda Bermuda ATP World Tour,CLAY,2,Mauricio Hadad,Bryan Shelton,Mauricio Hadad,7-6(7); 7-6(6),S,117,1,1,73,95,50,73,9,22,5,6,12,59,95,1,6,57,94,38,57,20,37,10,11,12,58,94
1995-04-17 00:00:00.000,Bermuda Bermuda ATP World Tour,CLAY,2,Javier Frana,Vincent Spadea,Javier Frana,3-6; 6-3; 6-4,S,118,7,1,69,98,50,69,15,29,8,9,14,65,98,6,0,60,83,47,60,10,23,3,5,14,57,83
1995-04-17 00:00:00.000,Bermuda Bermuda ATP World Tour,CLAY,2,Mauricio Hadad,Javier Frana,Mauricio Hadad,7-6(5); 3-6; 6-4,F,109,0,0,65,91,44,65,18,26,0,3,16,62,91,8,0,66,83,47,66,12,17,1,3,15,59,83
1995-04-17 00:00:00.000,Hong Kong Hong Kong ATP World Tour,HARD,2,Michael Chang,Jakob Hlasek,Michael Chang,6-1; 6-3,R32,59,7,0,33,54,23,33,12,21,4,5,8,35,54,2,2,29,47,13,29,7,18,5,10,8,20,47
1995-04-17 00:00:00.000,Hong Kong Hong Kong ATP World Tour,HARD,2,Alex Radulescu,Joern Renzenbrink,Alex Radulescu,6-1; 6-3,R32,57,7,2,31,51,24,31,11,20,2,2,8,35,51,2,3,25,42,17,25,5,17,1,5,8,22,42
1995-04-17 00:00:00.000,Hong Kong Hong Kong ATP World Tour,HARD,2,Kenneth Carlsen,Jim Grabb,Kenneth Carlsen,6-4; 7-5,R32,91,8,3,41,69,35,41,13,28,2,2,11,48,69,4,4,37,61,31,37,11,24,1,3,11,42,61
1995-04-17 00:00:00.000,Hong Kong Hong Kong ATP World Tour,HARD,2,Jan Siemerink,Wally Masur,Jan Siemerink,6-4; 6-4,R32,71,6,5,34,60,29,34,12,26,2,3,10,41,60,1,1,37,53,27,37,7,16,0,3,10,34,53
1995-04-17 00:00:00.000,Hong Kong Hong Kong ATP World Tour,HARD,2,Jim Courier,Yong-Il Yoon,Jim Courier,6-2; 6-4,R32,73,2,1,29,51,23,29,10,22,0,1,9,33,51,2,2,29,53,20,29,7,24,6,10,9,27,53
1995-04-17 00:00:00.000,Hong Kong Hong Kong ATP World Tour,HARD,2,Jonathan Stark,Henrik Holm,Jonathan Stark,6-3; 6-4,R32,59,9,2,35,52,30,35,11,17,0,0,10,41,52,9,8,24,51,21,24,12,27,2,4,9,33,51
1995-04-17 00:00:00.000,Hong Kong Hong Kong ATP World Tour,HARD,2,Tommy Ho,Mark Philippoussis,Tommy Ho,6-3; 3-6; 7-6(5),R32,125,9,5,66,112,46,66,26,46,14,16,15,72,112,16,3,47,91,35,47,24,44,4,6,15,59,91
1995-04-17 00:00:00.000,Hong Kong Hong Kong ATP World Tour,HARD,2,Alexander Volkov,Ofer Sela,Alexander Volkov,6-3; 6-3,R32,82,3,4,35,77,24,35,22,42,4,6,9,46,77,3,3,32,60,19,32,9,28,8,13,9,28,60
1995-04-17 00:00:00.000,Hong Kong Hong Kong ATP World Tour,HARD,2,Jonas Bjorkman,Marcos Ondruska,Jonas Bjorkman,7-6(3); 1-6; 7-6(3),R32,157,2,4,52,117,34,52,33,65,8,13,15,67,117,7,5,90,142,56,90,25,52,13,16,16,81,142
1995-04-17 00:00:00.000,Hong Kong Hong Kong ATP World Tour,HARD,2,Greg Rusedski,Anders Jarryd,Greg Rusedski,6-4; 7-6(3),R32,85,15,5,36,67,31,36,20,31,1,1,11,51,67,5,6,32,71,24,32,23,39,4,5,11,47,71
1995-04-17 00:00:00.000,Hong Kong Hong Kong ATP World Tour,HARD,2,David Prinosil,Sebastien Lareau,David Prinosil,7-5; 1-6; 6-4,R32,104,13,5,44,86,38,44,17,42,5,9,15,55,86,11,6,40,82,32,40,21,42,5,8,14,53,82
1995-04-17 00:00:00.000,Hong Kong Hong Kong ATP World Tour,HARD,2,Thomas Enqvist,Luis Herrera,Thomas Enqvist,6-1; 6-1,R32,52,2,2,20,38,16,20,7,18,0,2,7,23,38,1,0,29,50,11,29,7,21,5,12,7,18,50
1995-04-17 00:00:00.000,Hong Kong Hong Kong ATP World Tour,HARD,2,Martin Damm,Alexander Mronz,Martin Damm,7-6(3); 7-6(10),R32,124,9,2,49,84,42,49,20,35,0,0,12,62,84,6,2,59,86,43,59,20,27,4,4,12,63,86
1995-04-17 00:00:00.000,Hong Kong Hong Kong ATP World Tour,HARD,2,Jan Apell,Lars Rehmann,Jan Apell,6-4; 6-2,R32,74,3,4,37,58,31,37,9,21,3,3,9,40,58,7,1,46,61,34,46,1,15,4,7,9,35,61
1995-04-17 00:00:00.000,Hong Kong Hong Kong ATP World Tour,HARD,2,Jeff Tarango,Markus Zoecke,Jeff Tarango,7-6(5); 6-3,R32,82,9,2,38,64,30,38,15,26,0,2,11,45,64,16,4,43,76,31,43,13,33,4,7,10,44,76
1995-04-17 00:00:00.000,Hong Kong Hong Kong ATP World Tour,HARD,2,Wayne Ferreira,Jeremy Bates,Wayne Ferreira,7-5; 6-4,R32,76,7,4,40,68,30,40,13,28,5,7,11,43,68,2,2,32,66,22,32,16,34,3,7,11,38,66
1995-04-17 00:00:00.000,Hong Kong Hong Kong ATP World Tour,HARD,2,Michael Chang,Alex Radulescu,Michael Chang,5-7; 6-3; 6-1,R16,98,3,2,43,79,34,43,21,36,2,4,14,55,79,7,3,56,94,36,56,16,38,7,12,14,52,94
1995-04-17 00:00:00.000,Hong Kong Hong Kong ATP World Tour,HARD,2,Kenneth Carlsen,Jan Siemerink,Kenneth Carlsen,6-4; 2-6; 7-6(4),R16,106,5,3,57,93,41,57,21,36,2,4,15,62,93,4,3,45,79,38,45,21,34,0,1,15,59,79
1995-04-17 00:00:00.000,Hong Kong Hong Kong ATP World Tour,HARD,2,Jim Courier,Jonathan Stark,Jim Courier,7-5; 6-1,R16,103,2,6,32,66,26,32,18,34,3,4,10,44,66,4,7,29,69,22,29,11,40,10,14,9,33,69
1995-04-17 00:00:00.000,Hong Kong Hong Kong ATP World Tour,HARD,2,Alexander Volkov,Tommy Ho,Alexander Volkov,5-7; 7-5; 6-4,R16,123,9,2,56,111,40,56,29,55,5,8,17,69,111,7,3,62,106,45,62,21,44,5,9,17,66,106
1995-04-17 00:00:00.000,Hong Kong Hong Kong ATP World Tour,HARD,2,Jonas Bjorkman,Greg Rusedski,Jonas Bjorkman,7-5; 6-4,R16,82,1,4,30,64,23,30,19,34,3,4,11,42,64,4,4,34,70,22,34,19,36,7,10,11,41,70
1995-04-17 00:00:00.000,Hong Kong Hong Kong ATP World Tour,HARD,2,Thomas Enqvist,David Prinosil,Thomas Enqvist,6-7(5); 6-1; 6-4,R16,120,6,6,49,100,37,49,29,51,2,4,15,66,100,15,5,57,110,40,57,23,53,6,11,14,63,110
1995-04-17 00:00:00.000,Hong Kong Hong Kong ATP World Tour,HARD,2,Jan Apell,Martin Damm,Jan Apell,6-7(1); 6-3; 6-3,R16,120,13,6,54,88,47,54,17,34,4,5,15,64,88,11,4,56,111,41,56,26,55,10,14,15,67,111
1995-04-17 00:00:00.000,Hong Kong Hong Kong ATP World Tour,HARD,2,Wayne Ferreira,Jeff Tarango,Wayne Ferreira,6-4; 6-3,R16,66,12,3,31,59,26,31,13,28,1,2,10,39,59,0,6,32,54,21,32,10,22,3,6,9,31,54
1995-04-17 00:00:00.000,Hong Kong Hong Kong ATP World Tour,HARD,2,Michael Chang,Kenneth Carlsen,Michael Chang,6-3; 6-2,Q,66,3,2,32,51,27,32,11,19,0,0,9,38,51,3,3,35,52,22,35,7,17,7,10,8,29,52
1995-04-17 00:00:00.000,Hong Kong Hong Kong ATP World Tour,HARD,2,Jim Courier,Alexander Volkov,Jim Courier,5-7; 6-2; 6-3,Q,131,8,3,48,91,32,48,25,43,8,12,15,57,91,4,8,54,103,32,54,21,49,7,13,14,53,103
1995-04-17 00:00:00.000,Hong Kong Hong Kong ATP World Tour,HARD,2,Jonas Bjorkman,Thomas Enqvist,Jonas Bjorkman,6-4; 6-4,Q,70,15,3,39,63,30,39,13,24,2,3,10,43,63,3,6,41,63,34,41,2,22,4,7,10,36,63
1995-04-17 00:00:00.000,Hong Kong Hong Kong ATP World Tour,HARD,2,Jan Apell,Wayne Ferreira,Jan Apell,3-6; 7-6(5); 7-6(7),Q,146,9,6,78,140,56,78,34,62,12,15,16,90,140,13,6,56,110,44,56,30,54,4,6,17,74,110
1995-04-17 00:00:00.000,Hong Kong Hong Kong ATP World Tour,HARD,2,Michael Chang,Jim Courier,Michael Chang,6-4; 6-2,S,88,2,0,33,53,24,33,11,20,1,2,9,35,53,0,4,30,58,22,30,9,28,4,8,9,31,58
1995-04-17 00:00:00.000,Hong Kong Hong Kong ATP World Tour,HARD,2,Jonas Bjorkman,Jan Apell,Jonas Bjorkman,6-1; 6-4,S,65,6,3,25,53,21,25,13,28,1,3,9,34,53,5,4,30,57,16,30,12,27,7,12,8,28,57
1995-04-17 00:00:00.000,Hong Kong Hong Kong ATP World Tour,HARD,2,Michael Chang,Jonas Bjorkman,Michael Chang,6-3; 6-1,F,62,4,3,30,47,23,30,8,17,3,5,8,31,47,1,1,20,44,11,20,5,24,3,9,8,16,44
1995-04-17 00:00:00.000,Nice France ATP World Tour,CLAY,2,Yevgeny Kafelnikov,David Wheaton,Yevgeny Kafelnikov,6-3; 6-0,R32,62,3,3,32,58,24,32,15,26,3,3,8,39,58,1,0,36,49,16,36,7,13,6,10,7,23,49
1995-04-17 00:00:00.000,Nice France ATP World Tour,CLAY,2,Kris Goossens,Karol Kucera,Kris Goossens,6-3; 6-4,R32,0,0,0,0,0,0,0,0,0,0,0,0,0,0,0,0,0,0,0,0,0,0,0,0,0,0,0
1995-04-17 00:00:00.000,Nice France ATP World Tour,CLAY,2,Daniel Vacek,Arnaud Boetsch,Daniel Vacek,6-2; 6-2,R32,62,3,1,35,46,28,35,6,11,1,1,8,34,46,0,1,29,56,18,29,10,27,4,8,8,28,56
1995-04-17 00:00:00.000,Nice France ATP World Tour,CLAY,2,Cedric Pioline,Guy Forget,Cedric Pioline,6-3; 7-6(4),R32,123,3,6,60,103,40,60,19,43,8,10,11,59,103,5,2,44,75,29,44,12,31,0,3,10,41,75
1995-04-17 00:00:00.000,Nice France ATP World Tour,CLAY,2,Andrei Medvedev,Fabrice Santoro,Andrei Medvedev,6-3; 7-5,R32,69,4,1,37,60,27,37,9,23,0,3,11,36,60,0,3,37,54,17,37,10,17,1,6,10,27,54
1995-04-17 00:00:00.000,Nice France ATP World Tour,CLAY,2,Javier Sanchez,Andrei Chesnokov,Javier Sanchez,6-3; 6-3,R32,80,0,0,39,49,30,39,5,10,1,2,9,35,49,2,2,41,69,26,41,11,28,10,14,9,37,69
1995-04-17 00:00:00.000,Nice France ATP World Tour,CLAY,2,Richard Fromberg,Gilbert Schaller,Richard Fromberg,6-2; 7-6(5),R32,108,10,3,49,89,34,49,17,40,5,7,10,51,89,0,1,59,70,34,59,4,11,2,6,10,38,70
1995-04-17 00:00:00.000,Nice France ATP World Tour,CLAY,2,Alex Corretja,Ronald Agenor,Alex Corretja,4-6; 6-4; 6-0,R32,114,0,3,55,80,35,55,17,25,2,4,13,52,80,0,2,52,84,35,52,10,32,8,13,13,45,84
1995-04-17 00:00:00.000,Nice France ATP World Tour,CLAY,2,Marc Rosset,Marcelo Filippini,Marc Rosset,6-4; 6-2,R32,75,7,7,34,60,27,34,12,26,2,3,9,39,60,0,0,36,51,21,36,4,15,1,5,9,25,51
1995-04-17 00:00:00.000,Nice France ATP World Tour,CLAY,2,Roberto Carretero,Frederic Vitoux,Roberto Carretero,6-1; 6-4,R32,71,0,2,32,44,24,32,6,12,0,2,9,30,44,0,0,44,61,22,44,5,17,4,9,8,27,61
1995-04-17 00:00:00.000,Nice France ATP World Tour,CLAY,2,Mark Woodforde,Horst Skoff,Mark Woodforde,6-3; 7-6(2),R32,98,7,6,46,88,31,46,23,42,6,8,11,54,88,2,7,32,62,20,32,17,30,2,5,10,37,62
1995-04-17 00:00:00.000,Nice France ATP World Tour,CLAY,2,Henri Leconte,Goran Ivanisevic,Henri Leconte,4-6; 1-0 RET,R32,45,6,2,29,46,20,29,8,17,3,4,6,28,46,4,1,17,32,13,17,10,15,2,2,6,23,32
1995-04-17 00:00:00.000,Nice France ATP World Tour,CLAY,2,Renzo Furlan,Slava Dosedel,Renzo Furlan,6-4; 6-3,R32,0,0,0,0,0,0,0,0,0,0,0,0,0,0,0,0,0,0,0,0,0,0,0,0,0,0,0
1995-04-17 00:00:00.000,Nice France ATP World Tour,CLAY,2,Tomas Carbonell,Olivier Delaitre,Tomas Carbonell,6-3; 6-0,R32,55,0,1,39,45,26,39,4,6,0,1,8,30,45,1,0,27,43,12,27,6,16,7,12,7,18,43
1995-04-17 00:00:00.000,Nice France ATP World Tour,CLAY,2,Francisco Clavet,Thierry Guardiola,Francisco Clavet,6-1; 6-4,R32,87,0,1,32,43,25,32,9,11,3,3,8,34,43,0,0,43,81,27,43,15,38,2,6,9,42,81
1995-04-17 00:00:00.000,Nice France ATP World Tour,CLAY,2,Albert Costa,Alberto Berasategui,Albert Costa,6-7(8); 6-6(0) RET,R32,109,2,1,73,85,48,73,7,12,3,5,12,55,85,1,3,87,106,54,87,10,19,5,7,12,64,106
1995-04-17 00:00:00.000,Nice France ATP World Tour,CLAY,2,Yevgeny Kafelnikov,Kris Goossens,Yevgeny Kafelnikov,4-6; 6-3; 6-4,R16,128,3,2,44,90,31,44,24,46,1,5,15,55,90,3,4,64,105,40,64,17,41,5,10,14,57,105
1995-04-17 00:00:00.000,Nice France ATP World Tour,CLAY,2,Cedric Pioline,Daniel Vacek,Cedric Pioline,6-4; 4-6; 6-3,R16,116,1,2,49,84,33,49,20,35,4,8,15,53,84,1,4,55,80,33,55,14,25,1,6,14,47,80
1995-04-17 00:00:00.000,Nice France ATP World Tour,CLAY,2,Andrei Medvedev,Javier Sanchez,Andrei Medvedev,6-0; 6-3,R16,57,1,2,14,41,8,14,16,27,1,3,7,24,41,0,1,39,54,17,39,4,15,1,8,8,21,54
1995-04-17 00:00:00.000,Nice France ATP World Tour,CLAY,2,Richard Fromberg,Alex Corretja,Richard Fromberg,6-4; 6-3,R16,72,6,0,26,47,21,26,17,21,0,1,10,38,47,0,1,38,57,25,38,8,19,2,5,9,33,57
1995-04-17 00:00:00.000,Nice France ATP World Tour,CLAY,2,Marc Rosset,Roberto Carretero,Marc Rosset,6-4; 6-3,R16,68,5,1,23,48,20,23,18,25,3,3,9,38,48,2,1,43,55,26,43,7,12,0,3,10,33,55
1995-04-17 00:00:00.000,Nice France ATP World Tour,CLAY,2,Mark Woodforde,Henri Leconte,Mark Woodforde,6-2; 7-5,R16,87,0,2,33,67,22,33,19,34,6,8,10,41,67,2,3,41,66,25,41,9,25,7,12,10,34,66
1995-04-17 00:00:00.000,Nice France ATP World Tour,CLAY,2,Tomas Carbonell,Renzo Furlan,Tomas Carbonell,6-4; 6-4,R16,77,2,0,49,56,33,49,3,7,3,5,10,36,56,0,2,33,55,19,33,11,22,1,5,10,30,55
1995-04-17 00:00:00.000,Nice France ATP World Tour,CLAY,2,Albert Costa,Francisco Clavet,Albert Costa,6-3; 6-1,R16,69,0,0,40,48,26,40,5,8,1,2,8,31,48,0,3,32,49,17,32,4,17,3,8,8,21,49
1995-04-17 00:00:00.000,Nice France ATP World Tour,CLAY,2,Yevgeny Kafelnikov,Cedric Pioline,Yevgeny Kafelnikov,6-3; 1-6; 6-0,Q,116,2,4,41,80,25,41,21,39,6,9,11,46,80,4,1,33,69,21,33,15,36,5,10,11,36,69
1995-04-17 00:00:00.000,Nice France ATP World Tour,CLAY,2,Andrei Medvedev,Richard Fromberg,Andrei Medvedev,6-3; 6-2,Q,64,4,1,27,45,21,27,12,18,0,0,8,33,45,6,1,37,56,26,37,5,19,4,8,9,31,56
1995-04-17 00:00:00.000,Nice France ATP World Tour,CLAY,2,Marc Rosset,Mark Woodforde,Marc Rosset,7-6(3); 6-2,Q,86,4,1,37,60,30,37,14,23,3,4,10,44,60,1,0,46,64,26,46,11,18,0,3,10,37,64
1995-04-17 00:00:00.000,Nice France ATP World Tour,CLAY,2,Albert Costa,Tomas Carbonell,Albert Costa,7-6(7); 4-6; 6-4,Q,125,0,3,84,112,53,84,13,28,4,9,16,66,112,4,7,85,101,56,85,3,16,5,10,16,59,101
1995-04-17 00:00:00.000,Nice France ATP World Tour,CLAY,2,Yevgeny Kafelnikov,Andrei Medvedev,Yevgeny Kafelnikov,4-6; 6-4; 6-3,S,116,3,1,71,105,46,71,18,34,10,13,15,64,105,6,3,51,87,31,51,20,36,1,5,14,51,87
1995-04-17 00:00:00.000,Nice France ATP World Tour,CLAY,2,Marc Rosset,Albert Costa,Marc Rosset,2-6; 6-4; 6-4,S,106,12,8,49,87,43,49,14,38,8,10,14,57,87,1,2,66,85,44,66,11,19,4,6,14,55,85
1995-04-17 00:00:00.000,Nice France ATP World Tour,CLAY,2,Marc Rosset,Yevgeny Kafelnikov,Marc Rosset,6-4; 6-0,F,64,7,4,24,52,20,24,15,28,5,6,8,35,52,1,3,27,50,15,27,6,23,3,8,8,21,50
1995-04-24 00:00:00.000,ATP Masters Series Monte Carlo Monaco ATP World Tour,CLAY,2,Pete Sampras,N/A Bye,Pete Sampras,,R64,0,0,0,0,0,0,0,0,0,0,0,0,0,0,0,0,0,0,0,0,0,0,0,0,0,0,0
1995-04-24 00:00:00.000,ATP Masters Series Monte Carlo Monaco ATP World Tour,CLAY,2,Paul Haarhuis,Jaime Yzaga,Paul Haarhuis,6-2; 6-4,R64,64,3,2,25,49,19,25,13,24,1,3,9,32,49,0,4,30,57,15,30,15,27,5,10,9,30,57
1995-04-24 00:00:00.000,ATP Masters Series Monte Carlo Monaco ATP World Tour,CLAY,2,David Wheaton,Dimitri Poliakov,David Wheaton,6-4; 6-2,R64,67,8,1,35,58,25,35,14,23,1,2,9,39,58,1,4,23,53,13,23,14,30,4,8,9,27,53
1995-04-24 00:00:00.000,ATP Masters Series Monte Carlo Monaco ATP World Tour,CLAY,2,Karel Novacek,Jacco Eltingh,Karel Novacek,1-6; 6-4; 6-3,R64,87,12,5,47,80,35,47,19,33,5,7,13,54,80,6,2,47,80,34,47,20,33,4,6,13,54,80
1995-04-24 00:00:00.000,ATP Masters Series Monte Carlo Monaco ATP World Tour,CLAY,2,Thomas Muster,Guy Forget,Thomas Muster,6-2; 6-2,R64,52,3,2,18,41,14,18,12,23,0,2,8,26,41,1,3,23,47,15,23,4,24,3,9,8,19,47
1995-04-24 00:00:00.000,ATP Masters Series Monte Carlo Monaco ATP World Tour,CLAY,2,Bernd Karbacher,Slava Dosedel,Bernd Karbacher,2-6; 6-3; 6-0,R64,89,2,0,35,70,24,35,16,35,1,6,12,40,70,1,2,57,77,24,57,10,20,9,16,11,34,77
1995-04-24 00:00:00.000,ATP Masters Series Monte Carlo Monaco ATP World Tour,CLAY,2,Cedric Pioline,Horst Skoff,Cedric Pioline,6-3; 7-5,R64,96,4,2,36,52,27,36,11,16,0,1,10,38,52,3,0,39,81,22,39,22,42,6,10,11,44,81
1995-04-24 00:00:00.000,ATP Masters Series Monte Carlo Monaco ATP World Tour,CLAY,2,Alberto Berasategui,N/A Bye,Alberto Berasategui,,R64,0,0,0,0,0,0,0,0,0,0,0,0,0,0,0,0,0,0,0,0,0,0,0,0,0,0,0
1995-04-24 00:00:00.000,ATP Masters Series Monte Carlo Monaco ATP World Tour,CLAY,2,Yevgeny Kafelnikov,N/A Bye,Yevgeny Kafelnikov,,R64,0,0,0,0,0,0,0,0,0,0,0,0,0,0,0,0,0,0,0,0,0,0,0,0,0,0,0
1995-04-24 00:00:00.000,ATP Masters Series Monte Carlo Monaco ATP World Tour,CLAY,2,Mark Woodforde,Adrian Voinea,Mark Woodforde,7-5; 6-3,R64,87,4,3,41,74,28,41,17,33,8,10,11,45,74,1,1,41,78,23,41,18,37,8,12,10,41,78
1995-04-24 00:00:00.000,ATP Masters Series Monte Carlo Monaco ATP World Tour,CLAY,2,David Rikl,Henri Leconte,David Rikl,6-2; 6-4,R64,68,2,4,31,56,24,31,13,25,1,2,9,37,56,2,2,25,58,16,25,14,33,4,8,9,30,58
1995-04-24 00:00:00.000,ATP Masters Series Monte Carlo Monaco ATP World Tour,CLAY,2,Andrea Gaudenzi,Petr Korda,Andrea Gaudenzi,6-2; 6-2,R64,68,2,1,33,54,24,33,6,21,7,10,8,30,54,0,6,26,53,13,26,6,27,3,10,8,19,53
1995-04-24 00:00:00.000,ATP Masters Series Monte Carlo Monaco ATP World Tour,CLAY,2,Richard Fromberg,Andrei Medvedev,Richard Fromberg,6-2; 3-6; 6-4,R64,117,4,2,36,73,27,36,20,37,3,6,13,47,73,3,4,48,102,29,48,25,54,2,7,14,54,102
1995-04-24 00:00:00.000,ATP Masters Series Monte Carlo Monaco ATP World Tour,CLAY,2,Carlos Costa,Daniel Vacek,Carlos Costa,6-1; 7-5,R64,66,3,1,37,65,27,37,20,28,2,2,10,47,65,0,6,31,48,23,31,6,17,4,7,9,29,48
1995-04-24 00:00:00.000,ATP Masters Series Monte Carlo Monaco ATP World Tour,CLAY,2,Javier Sanchez,Patrick Rafter,Javier Sanchez,6-1; 6-3,R64,80,0,1,30,50,22,30,11,20,4,5,8,33,50,2,6,33,66,20,33,10,33,9,14,8,30,66
1995-04-24 00:00:00.000,ATP Masters Series Monte Carlo Monaco ATP World Tour,CLAY,2,Sergi Bruguera,N/A Bye,Sergi Bruguera,,R64,0,0,0,0,0,0,0,0,0,0,0,0,0,0,0,0,0,0,0,0,0,0,0,0,0,0,0
1995-04-24 00:00:00.000,ATP Masters Series Monte Carlo Monaco ATP World Tour,CLAY,2,Michael Stich,N/A Bye,Michael Stich,,R64,0,0,0,0,0,0,0,0,0,0,0,0,0,0,0,0,0,0,0,0,0,0,0,0,0,0,0
1995-04-24 00:00:00.000,ATP Masters Series Monte Carlo Monaco ATP World Tour,CLAY,2,Gilbert Schaller,Emilio Sanchez,Gilbert Schaller,4-6; 6-1; 6-3,R64,136,0,1,75,80,48,75,1,5,5,8,13,49,80,1,2,53,91,33,53,14,38,5,11,13,47,91
1995-04-24 00:00:00.000,ATP Masters Series Monte Carlo Monaco ATP World Tour,CLAY,2,Jordi Burillo,Albert Costa,Jordi Burillo,4-6; 6-3; 7-5,R64,107,4,3,57,95,39,57,19,38,5,9,15,58,95,1,2,87,115,52,87,14,28,10,16,16,66,115
1995-04-24 00:00:00.000,ATP Masters Series Monte Carlo Monaco ATP World Tour,CLAY,2,Fabrice Santoro,Stefan Edberg,Fabrice Santoro,6-3; 6-1,R64,62,0,1,33,47,25,33,8,14,0,1,8,33,47,2,2,25,47,14,25,7,22,1,6,8,21,47
1995-04-24 00:00:00.000,ATP Masters Series Monte Carlo Monaco ATP World Tour,CLAY,2,Marc Rosset,Guillaume Raoux,Marc Rosset,4-6; 6-2; 6-3,R64,113,6,3,38,78,30,38,23,40,4,6,14,53,78,7,5,45,93,30,45,22,48,9,13,13,52,93
1995-04-24 00:00:00.000,ATP Masters Series Monte Carlo Monaco ATP World Tour,CLAY,2,Albert Portas,Andrei Chesnokov,Albert Portas,6-3; 6-1,R64,71,1,0,42,61,26,42,12,19,6,7,8,38,61,0,1,35,47,16,35,6,12,4,9,8,22,47
1995-04-24 00:00:00.000,ATP Masters Series Monte Carlo Monaco ATP World Tour,CLAY,2,Francisco Clavet,Aaron Krickstein,Francisco Clavet,6-2; 6-0,R64,49,3,1,27,33,24,27,5,6,1,1,7,29,33,3,3,22,47,12,22,9,25,4,9,7,21,47
1995-04-24 00:00:00.000,ATP Masters Series Monte Carlo Monaco ATP World Tour,CLAY,2,Goran Ivanisevic,N/A Bye,Goran Ivanisevic,,R64,0,0,0,0,0,0,0,0,0,0,0,0,0,0,0,0,0,0,0,0,0,0,0,0,0,0,0
1995-04-24 00:00:00.000,ATP Masters Series Monte Carlo Monaco ATP World Tour,CLAY,2,Magnus Larsson,N/A Bye,Magnus Larsson,,R64,0,0,0,0,0,0,0,0,0,0,0,0,0,0,0,0,0,0,0,0,0,0,0,0,0,0,0
1995-04-24 00:00:00.000,ATP Masters Series Monte Carlo Monaco ATP World Tour,CLAY,2,Alex Lopez Moron,Arnaud Boetsch,Alex Lopez Moron,7-6(3); 6-7(2); 7-6(1),R64,174,5,5,94,138,59,94,19,44,3,10,18,78,138,5,5,72,128,47,72,24,56,5,12,18,71,128
1995-04-24 00:00:00.000,ATP Masters Series Monte Carlo Monaco ATP World Tour,CLAY,2,Jan Siemerink,Renzo Furlan,Jan Siemerink,6-3; 3-6; 6-2,R64,109,4,5,50,78,34,50,17,28,3,5,13,51,78,2,3,64,95,39,64,14,31,4,8,13,53,95
1995-04-24 00:00:00.000,ATP Masters Series Monte Carlo Monaco ATP World Tour,CLAY,2,Richard Krajicek,Diego Nargiso,Richard Krajicek,6-3; 6-1,R64,57,8,0,23,39,21,23,11,16,0,0,8,32,39,1,5,24,53,17,24,10,29,5,9,8,27,53
1995-04-24 00:00:00.000,ATP Masters Series Monte Carlo Monaco ATP World Tour,CLAY,2,Thomas Enqvist,Thierry Champion,Thomas Enqvist,2-6; 7-5; 6-4,R64,144,4,3,65,103,41,65,13,38,8,14,15,54,103,2,2,63,100,41,63,15,37,5,11,15,56,100
1995-04-24 00:00:00.000,ATP Masters Series Monte Carlo Monaco ATP World Tour,CLAY,2,Alex Corretja,Olivier Delaitre,Alex Corretja,6-1; 6-2,R64,67,2,0,29,48,22,29,12,19,1,1,8,34,48,0,1,36,58,23,36,4,22,2,6,7,27,58
1995-04-24 00:00:00.000,ATP Masters Series Monte Carlo Monaco ATP World Tour,CLAY,2,Jonas Bjorkman,Lionel Roux,Jonas Bjorkman,6-3; 7-5,R64,98,3,4,29,69,19,29,24,40,7,9,10,43,69,1,2,44,91,27,44,21,47,12,17,11,48,91
1995-04-24 00:00:00.000,ATP Masters Series Monte Carlo Monaco ATP World Tour,CLAY,2,Boris Becker,N/A Bye,Boris Becker,,R64,0,0,0,0,0,0,0,0,0,0,0,0,0,0,0,0,0,0,0,0,0,0,0,0,0,0,0
1995-04-24 00:00:00.000,ATP Masters Series Monte Carlo Monaco ATP World Tour,CLAY,2,Paul Haarhuis,Pete Sampras,Paul Haarhuis,4-6; 1-1 RET,R32,59,1,1,25,42,14,25,10,17,0,2,6,24,42,1,0,16,40,13,16,13,24,0,1,7,26,40
1995-04-24 00:00:00.000,ATP Masters Series Monte Carlo Monaco ATP World Tour,CLAY,2,David Wheaton,Karel Novacek,David Wheaton,6-3; 6-3,R32,62,2,1,34,51,27,34,9,17,0,1,9,36,51,2,1,28,50,16,28,9,22,1,5,9,25,50
1995-04-24 00:00:00.000,ATP Masters Series Monte Carlo Monaco ATP World Tour,CLAY,2,Thomas Muster,Bernd Karbacher,Thomas Muster,6-2; 6-2,R32,58,0,4,26,49,18,26,14,23,4,5,8,32,49,2,3,23,47,16,23,5,24,1,6,8,21,47
1995-04-24 00:00:00.000,ATP Masters Series Monte Carlo Monaco ATP World Tour,CLAY,2,Alberto Berasategui,Cedric Pioline,Alberto Berasategui,6-2; 6-2,R32,64,1,1,32,46,23,32,8,14,4,5,8,31,46,1,1,26,53,15,26,9,27,4,9,8,24,53
1995-04-24 00:00:00.000,ATP Masters Series Monte Carlo Monaco ATP World Tour,CLAY,2,Yevgeny Kafelnikov,Mark Woodforde,Yevgeny Kafelnikov,6-2; 6-2,R32,55,1,1,29,46,25,29,9,17,0,0,8,34,46,1,2,24,47,12,24,9,23,3,7,8,21,47
1995-04-24 00:00:00.000,ATP Masters Series Monte Carlo Monaco ATP World Tour,CLAY,2,Andrea Gaudenzi,David Rikl,Andrea Gaudenzi,6-2; 6-4,R32,75,1,3,35,57,26,35,9,22,3,5,9,35,57,2,2,33,64,19,33,11,31,8,13,9,30,64
1995-04-24 00:00:00.000,ATP Masters Series Monte Carlo Monaco ATP World Tour,CLAY,2,Richard Fromberg,Carlos Costa,Richard Fromberg,6-3; 6-4,R32,83,7,1,48,72,31,48,10,24,8,11,10,41,72,0,2,33,58,20,33,9,25,4,9,9,29,58
1995-04-24 00:00:00.000,ATP Masters Series Monte Carlo Monaco ATP World Tour,CLAY,2,Sergi Bruguera,Javier Sanchez,Sergi Bruguera,7-6(7); 0-6; 6-2,R32,146,5,2,52,117,37,52,29,65,14,18,13,66,117,0,1,74,115,46,74,20,41,11,14,13,66,115
1995-04-24 00:00:00.000,ATP Masters Series Monte Carlo Monaco ATP World Tour,CLAY,2,Gilbert Schaller,Michael Stich,Gilbert Schaller,7-6(5); 6-1,R32,74,0,0,51,58,36,51,1,7,2,3,9,37,58,5,7,31,66,21,31,14,35,1,5,10,35,66
1995-04-24 00:00:00.000,ATP Masters Series Monte Carlo Monaco ATP World Tour,CLAY,2,Fabrice Santoro,Jordi Burillo,Fabrice Santoro,3-6; 6-3; 7-6(1),R32,145,2,3,81,124,52,81,21,43,10,14,15,73,124,8,1,49,99,40,49,18,50,7,11,15,58,99
1995-04-24 00:00:00.000,ATP Masters Series Monte Carlo Monaco ATP World Tour,CLAY,2,Marc Rosset,Albert Portas,Marc Rosset,6-0; 6-3,R32,68,3,1,21,41,16,21,12,20,2,3,7,28,41,1,3,32,59,17,32,8,27,5,11,8,25,59
1995-04-24 00:00:00.000,ATP Masters Series Monte Carlo Monaco ATP World Tour,CLAY,2,Goran Ivanisevic,Francisco Clavet,Goran Ivanisevic,3-6; 6-3; 6-4,R32,114,10,6,41,85,34,41,22,44,5,7,14,56,85,0,1,64,97,40,64,18,33,12,15,14,58,97
1995-04-24 00:00:00.000,ATP Masters Series Monte Carlo Monaco ATP World Tour,CLAY,2,Alex Lopez Moron,Magnus Larsson,Alex Lopez Moron,6-3; 7-6(3),R32,78,2,0,37,63,29,37,15,26,1,3,11,44,63,3,1,54,79,35,54,9,25,7,10,10,44,79
1995-04-24 00:00:00.000,ATP Masters Series Monte Carlo Monaco ATP World Tour,CLAY,2,Richard Krajicek,Jan Siemerink,Richard Krajicek,3-6; 6-3; 6-4,R32,91,5,0,47,76,36,47,21,29,5,6,14,57,76,0,6,50,81,40,50,16,31,3,5,14,56,81
1995-04-24 00:00:00.000,ATP Masters Series Monte Carlo Monaco ATP World Tour,CLAY,2,Alex Corretja,Thomas Enqvist,Alex Corretja,6-4; 6-4,R32,87,2,1,46,64,26,46,6,18,7,12,10,32,64,2,2,34,62,16,34,11,28,2,9,10,27,62
1995-04-24 00:00:00.000,ATP Masters Series Monte Carlo Monaco ATP World Tour,CLAY,2,Boris Becker,Jonas Bjorkman,Boris Becker,6-3; 6-1,R32,58,3,1,26,46,24,26,8,20,0,1,8,32,46,2,2,19,45,11,19,9,26,1,6,8,20,45
1995-04-24 00:00:00.000,ATP Masters Series Monte Carlo Monaco ATP World Tour,CLAY,2,David Wheaton,Paul Haarhuis,David Wheaton,6-2; 6-7(4); 6-4,R16,149,0,3,58,95,39,58,23,37,5,7,15,62,95,0,4,66,113,36,66,25,47,4,9,15,61,113
1995-04-24 00:00:00.000,ATP Masters Series Monte Carlo Monaco ATP World Tour,CLAY,2,Thomas Muster,Alberto Berasategui,Thomas Muster,7-6(6); 6-2,R16,98,4,3,46,87,33,46,18,41,5,8,10,51,87,2,1,49,66,26,49,7,17,6,11,10,33,66
1995-04-24 00:00:00.000,ATP Masters Series Monte Carlo Monaco ATP World Tour,CLAY,2,Andrea Gaudenzi,Yevgeny Kafelnikov,Andrea Gaudenzi,1-6; 7-5; 7-5,R16,133,0,1,52,87,30,52,25,35,2,5,15,55,87,5,6,77,134,51,77,28,57,11,14,16,79,134
1995-04-24 00:00:00.000,ATP Masters Series Monte Carlo Monaco ATP World Tour,CLAY,2,Sergi Bruguera,Richard Fromberg,Sergi Bruguera,6-2; 6-4,R16,81,2,0,23,52,21,23,18,29,5,5,9,39,52,5,1,35,66,25,35,13,31,9,12,9,38,66
1995-04-24 00:00:00.000,ATP Masters Series Monte Carlo Monaco ATP World Tour,CLAY,2,Gilbert Schaller,Fabrice Santoro,Gilbert Schaller,6-3; 6-1,R16,79,0,0,43,59,28,43,7,16,7,9,8,35,59,0,2,29,51,11,29,9,22,5,11,8,20,51
1995-04-24 00:00:00.000,ATP Masters Series Monte Carlo Monaco ATP World Tour,CLAY,2,Goran Ivanisevic,Marc Rosset,Goran Ivanisevic,6-4; 6-3,R16,66,8,3,29,55,25,29,17,26,1,1,10,42,55,3,1,36,60,24,36,13,24,5,7,9,37,60
1995-04-24 00:00:00.000,ATP Masters Series Monte Carlo Monaco ATP World Tour,CLAY,2,Richard Krajicek,Alex Lopez Moron,Richard Krajicek,6-4; 6-4,R16,68,8,0,34,59,27,34,15,25,3,3,10,42,59,0,1,38,61,25,38,12,23,1,3,10,37,61
1995-04-24 00:00:00.000,ATP Masters Series Monte Carlo Monaco ATP World Tour,CLAY,2,Boris Becker,Alex Corretja,Boris Becker,6-2; 6-2,R16,53,5,0,26,40,23,26,10,14,0,0,8,33,40,1,0,29,43,16,29,7,14,1,5,8,23,43
1995-04-24 00:00:00.000,ATP Masters Series Monte Carlo Monaco ATP World Tour,CLAY,2,Thomas Muster,David Wheaton,Thomas Muster,6-4; 6-4,Q,77,1,2,29,54,21,29,18,25,1,2,10,39,54,2,4,36,59,25,36,12,23,3,6,10,37,59
1995-04-24 00:00:00.000,ATP Masters Series Monte Carlo Monaco ATP World Tour,CLAY,2,Andrea Gaudenzi,Sergi Bruguera,Andrea Gaudenzi,7-6(4); 6-2,Q,97,0,3,41,66,29,41,10,25,3,7,10,39,66,0,5,36,81,24,36,15,45,8,14,10,39,81
1995-04-24 00:00:00.000,ATP Masters Series Monte Carlo Monaco ATP World Tour,CLAY,2,Goran Ivanisevic,Gilbert Schaller,Goran Ivanisevic,4-6; 7-6(4); 7-5,Q,129,22,7,45,103,39,45,23,58,4,10,17,62,103,1,0,84,100,46,84,8,16,1,7,17,54,100
1995-04-24 00:00:00.000,ATP Masters Series Monte Carlo Monaco ATP World Tour,CLAY,2,Boris Becker,Richard Krajicek,Boris Becker,6-2; 7-5,Q,74,4,1,33,54,28,33,14,21,1,1,10,42,54,8,1,31,62,23,31,14,31,4,7,10,37,62
1995-04-24 00:00:00.000,ATP Masters Series Monte Carlo Monaco ATP World Tour,CLAY,2,Thomas Muster,Andrea Gaudenzi,Thomas Muster,6-3; 7-6(5),S,117,2,2,70,88,42,70,10,18,6,8,11,52,88,0,1,54,71,34,54,7,17,3,6,10,41,71
1995-04-24 00:00:00.000,ATP Masters Series Monte Carlo Monaco ATP World Tour,CLAY,2,Boris Becker,Goran Ivanisevic,Boris Becker,7-6(9); 3-6; 6-1,S,125,14,4,69,111,53,69,20,42,7,9,14,73,111,11,3,42,94,37,42,25,52,1,4,14,62,94
1995-04-24 00:00:00.000,ATP Masters Series Monte Carlo Monaco ATP World Tour,CLAY,2,Thomas Muster,Boris Becker,Thomas Muster,4-6; 5-7; 6-1; 7-6(6); 6-0,F,197,3,6,110,161,74,110,31,51,14,17,23,105,161,16,8,90,150,63,90,25,60,4,11,24,88,150
1995-04-24 00:00:00.000,Seoul South Korea ATP World Tour,HARD,2,Alexander Volkov,Anders Jarryd,Alexander Volkov,4-6; 7-5; 2-0 RET,R32,88,0,1,50,73,40,50,12,23,1,2,12,52,73,4,4,34,73,27,34,19,39,1,3,13,46,73
1995-04-24 00:00:00.000,Seoul South Korea ATP World Tour,HARD,2,Marcos Ondruska,Nicolas Pereira,Marcos Ondruska,6-2; 4-6; 6-3,R32,114,2,4,73,109,51,73,17,36,10,12,14,68,109,3,6,44,84,32,44,17,40,4,8,13,49,84
1995-04-24 00:00:00.000,Seoul South Korea ATP World Tour,HARD,2,Hyung-Taik Lee,Yong-Il Yoon,Hyung-Taik Lee,7-6(7); 6-3,R32,23,2,3,51,80,31,51,19,29,1,2,11,50,80,1,1,47,78,30,47,16,31,8,10,10,46,78
1995-04-24 00:00:00.000,Seoul South Korea ATP World Tour,HARD,2,Greg Rusedski,Michael Joyce,Greg Rusedski,7-6(4); 1-6; 6-3,R32,95,11,6,41,85,34,41,24,44,5,8,14,58,85,0,2,49,84,36,49,21,35,0,2,14,57,84
1995-04-24 00:00:00.000,Seoul South Korea ATP World Tour,HARD,2,Luis Herrera,Jonathan Stark,Luis Herrera,6-4; 7-6(5),R32,84,0,0,51,68,38,51,12,17,2,3,11,50,68,5,3,58,86,42,58,11,28,5,7,11,53,86
1995-04-24 00:00:00.000,Seoul South Korea ATP World Tour,HARD,2,Kenneth Carlsen,Mark Petchey,Kenneth Carlsen,5-7; 6-4; 6-1,R32,104,6,4,45,76,30,45,17,31,2,6,14,47,76,3,0,65,95,39,65,13,30,7,14,15,52,95
1995-04-24 00:00:00.000,Seoul South Korea ATP World Tour,HARD,2,Tommy Ho,Shuzo Matsuoka,Tommy Ho,7-6(2); 6-3,R32,94,5,2,36,65,31,36,19,29,1,1,11,50,65,10,4,43,75,33,43,13,32,2,3,10,46,75
1995-04-24 00:00:00.000,Seoul South Korea ATP World Tour,HARD,2,Alex Radulescu,Sebastien Lareau,Alex Radulescu,6-3; 6-7(2); 6-1,R32,121,8,1,67,105,51,67,20,38,8,8,15,71,105,7,4,44,97,30,44,29,53,7,10,13,59,97
1995-04-24 00:00:00.000,Seoul South Korea ATP World Tour,HARD,2,Jeff Tarango,Leander Paes,Jeff Tarango,6-3; 6-1,R32,50,1,2,24,36,23,24,9,12,0,0,8,32,36,2,2,32,53,17,32,10,21,3,7,8,27,53
1995-04-24 00:00:00.000,Seoul South Korea ATP World Tour,HARD,2,Alexander Mronz,Carsten Arriens,Alexander Mronz,3-2 RET,R32,13,0,2,4,10,4,4,4,6,0,0,3,8,10,3,0,11,19,9,11,2,8,0,1,3,11,19
1995-04-24 00:00:00.000,Seoul South Korea ATP World Tour,HARD,2,Emanuel Couto,Francisco Montana,Emanuel Couto,7-6(9); 6-7(3); 6-3,R32,187,7,3,84,131,59,84,22,47,13,18,17,81,131,0,1,86,118,48,86,16,32,6,12,16,64,118
1995-04-24 00:00:00.000,Seoul South Korea ATP World Tour,HARD,2,Bing Pan,Jeremy Bates,Bing Pan,6-1; 2-0 RET,R32,33,0,2,23,29,18,23,3,6,0,0,5,21,29,0,1,11,21,3,11,4,10,0,3,5,7,21
1995-04-24 00:00:00.000,Seoul South Korea ATP World Tour,HARD,2,Gianluca Pozzi,Wally Masur,Gianluca Pozzi,6-4; 7-5,R32,101,2,3,43,74,29,43,16,31,4,7,11,45,74,4,2,47,83,29,47,15,36,11,16,11,44,83
1995-04-24 00:00:00.000,Seoul South Korea ATP World Tour,HARD,2,Paul Wekesa,Jan Weinzierl,Paul Wekesa,6-3; 7-6(8),R32,92,6,6,49,78,34,49,17,29,4,5,10,51,78,1,5,45,80,31,45,15,35,1,4,11,46,80
1995-04-24 00:00:00.000,Seoul South Korea ATP World Tour,HARD,2,Lars Rehmann,Eui-Jong Chang,Lars Rehmann,6-3; 6-1,R32,67,0,2,31,51,24,31,11,20,1,1,8,35,51,2,1,36,59,23,36,8,23,6,10,8,31,59
1995-04-24 00:00:00.000,Seoul South Korea ATP World Tour,HARD,2,Martin Damm,Grant Stafford,Martin Damm,6-3; 5-7; 7-6(2),R32,133,5,4,53,91,33,53,23,38,3,8,16,56,91,4,7,70,117,42,70,23,47,10,16,17,65,117
1995-04-24 00:00:00.000,Seoul South Korea ATP World Tour,HARD,2,Alexander Volkov,Marcos Ondruska,Alexander Volkov,5-7; 6-3; 6-3,R16,112,3,4,44,92,31,44,26,48,7,10,15,57,92,9,1,61,89,43,61,12,28,4,9,15,55,89
1995-04-24 00:00:00.000,Seoul South Korea ATP World Tour,HARD,2,Greg Rusedski,Hyung-Taik Lee,Greg Rusedski,6-4; 6-4,R16,72,5,4,23,56,18,23,19,33,4,6,10,37,56,0,3,36,59,22,36,11,23,3,7,10,33,59
1995-04-24 00:00:00.000,Seoul South Korea ATP World Tour,HARD,2,Kenneth Carlsen,Luis Herrera,Kenneth Carlsen,6-3; 7-5,R16,71,3,1,32,58,25,32,17,26,0,2,11,42,58,0,3,39,57,25,39,6,18,2,6,10,31,57
1995-04-24 00:00:00.000,Seoul South Korea ATP World Tour,HARD,2,Tommy Ho,Alex Radulescu,Tommy Ho,2-6; 6-3; 6-2,R16,99,0,2,50,79,30,50,18,29,5,8,12,48,79,7,0,48,84,34,48,12,36,6,11,13,46,84
1995-04-24 00:00:00.000,Seoul South Korea ATP World Tour,HARD,2,Alexander Mronz,Jeff Tarango,Alexander Mronz,6-3; 4-6; 6-3,R16,118,7,0,47,80,33,47,17,33,4,7,14,50,80,4,2,56,85,34,56,18,29,5,10,14,52,85
1995-04-24 00:00:00.000,Seoul South Korea ATP World Tour,HARD,2,Bing Pan,Emanuel Couto,Bing Pan,7-6(3); 3-6; 6-2,R16,145,1,6,72,106,48,72,10,34,5,10,15,58,106,1,2,51,95,29,51,22,44,5,10,14,51,95
1995-04-24 00:00:00.000,Seoul South Korea ATP World Tour,HARD,2,Paul Wekesa,Gianluca Pozzi,Paul Wekesa,6-4; 3-6; 7-6(2),R16,107,8,4,58,82,45,58,12,24,1,4,15,57,82,1,3,69,95,45,69,15,26,1,4,16,60,95
1995-04-24 00:00:00.000,Seoul South Korea ATP World Tour,HARD,2,Lars Rehmann,Martin Damm,Lars Rehmann,6-2; 6-4,R16,76,4,1,41,62,29,41,11,21,8,9,9,40,62,7,1,29,54,16,29,13,25,4,8,9,29,54
1995-04-24 00:00:00.000,Seoul South Korea ATP World Tour,HARD,2,Greg Rusedski,Alexander Volkov,Greg Rusedski,7-5; 3-6; 7-5,Q,108,13,8,58,100,50,58,16,42,8,10,16,66,100,4,3,67,97,52,67,14,30,5,8,17,66,97
1995-04-24 00:00:00.000,Seoul South Korea ATP World Tour,HARD,2,Kenneth Carlsen,Tommy Ho,Kenneth Carlsen,2-6; 6-3; 6-4,Q,117,9,4,61,102,45,61,17,41,6,8,14,62,102,4,1,48,69,39,48,9,21,1,3,13,48,69
1995-04-24 00:00:00.000,Seoul South Korea ATP World Tour,HARD,2,Bing Pan,Alexander Mronz,Bing Pan,4-6; 7-6(6); 7-5,Q,171,0,6,74,109,46,74,18,35,5,10,17,64,109,6,3,62,122,42,62,29,60,6,11,17,71,122
1995-04-24 00:00:00.000,Seoul South Korea ATP World Tour,HARD,2,Lars Rehmann,Paul Wekesa,Lars Rehmann,6-3; 6-4,Q,71,2,1,46,61,31,46,13,15,2,2,10,44,61,5,2,39,60,29,39,8,21,8,10,9,37,60
1995-04-24 00:00:00.000,Seoul South Korea ATP World Tour,HARD,2,Greg Rusedski,Kenneth Carlsen,Greg Rusedski,6-4; 6-3,S,54,8,1,34,44,33,34,7,10,0,0,10,40,44,1,1,27,50,23,27,9,23,1,3,9,32,50
1995-04-24 00:00:00.000,Seoul South Korea ATP World Tour,HARD,2,Lars Rehmann,Bing Pan,Lars Rehmann,6-3; 6-2,S,64,1,1,41,54,29,41,8,13,0,1,9,37,54,1,5,24,47,16,24,8,23,2,6,8,24,47
1995-04-24 00:00:00.000,Seoul South Korea ATP World Tour,HARD,2,Greg Rusedski,Lars Rehmann,Greg Rusedski,6-4; 3-1 RET,F,68,7,4,24,39,22,24,6,15,0,0,7,28,39,0,4,34,58,23,34,9,24,7,9,8,32,58
1995-05-01 00:00:00.000,Atlanta GA; U.S.A. ATP World Tour,CLAY,2,Andre Agassi,Todd Woodbridge,Andre Agassi,6-3; 6-1,R32,58,0,1,38,55,29,38,10,17,6,6,8,39,55,4,4,22,43,14,22,7,21,4,8,8,21,43
1995-05-01 00:00:00.000,Atlanta GA; U.S.A. ATP World Tour,CLAY,2,Vincent Spadea,Roberto Jabali,Vincent Spadea,6-2; 7-6(4),R32,92,3,0,44,77,27,44,20,33,8,10,10,47,77,0,1,35,59,20,35,10,24,0,4,10,30,59
1995-05-01 00:00:00.000,Atlanta GA; U.S.A. ATP World Tour,CLAY,2,Christian Ruud,Michael Tebbutt,Christian Ruud,6-4; 6-3,R32,65,3,3,42,55,29,42,7,13,0,1,9,36,55,6,7,25,55,18,25,12,30,1,5,10,30,55
1995-05-01 00:00:00.000,Atlanta GA; U.S.A. ATP World Tour,CLAY,2,Chuck Adams,Karim Alami,Chuck Adams,7-6(2); 4-6; 6-4,R32,141,2,4,77,121,47,77,26,44,12,16,16,73,121,12,4,52,106,36,52,28,54,6,10,16,64,106
1995-05-01 00:00:00.000,Atlanta GA; U.S.A. ATP World Tour,CLAY,2,Magnus Larsson,Joost Winnink,Magnus Larsson,7-5; 6-2,R32,69,2,1,49,67,33,49,12,18,5,5,10,45,67,1,4,36,60,26,36,9,24,2,5,10,35,60
1995-05-01 00:00:00.000,Atlanta GA; U.S.A. ATP World Tour,CLAY,2,Jakob Hlasek,Nicolas Pereira,Jakob Hlasek,6-2; 5-7; 6-2,R32,105,4,2,47,86,35,47,22,39,6,8,14,57,86,5,1,70,103,42,70,16,33,9,14,14,58,103
1995-05-01 00:00:00.000,Atlanta GA; U.S.A. ATP World Tour,CLAY,2,Fernando Meligeni,Emilio Sanchez,Fernando Meligeni,6-4; 7-5,R32,85,1,3,37,63,24,37,19,26,2,4,11,43,63,3,2,45,73,28,45,14,28,4,8,11,42,73
1995-05-01 00:00:00.000,Atlanta GA; U.S.A. ATP World Tour,CLAY,2,Mats Wilander,Jason Stoltenberg,Mats Wilander,6-2; 6-2,R32,74,1,1,36,48,24,36,8,12,4,5,8,32,48,3,4,40,66,19,40,12,26,7,12,8,31,66
1995-05-01 00:00:00.000,Atlanta GA; U.S.A. ATP World Tour,CLAY,2,Aaron Krickstein,Richey Reneberg,Aaron Krickstein,6-3; 7-5,R32,91,3,1,59,91,37,59,15,32,13,16,11,52,91,3,2,33,69,21,33,15,36,1,6,10,36,69
1995-05-01 00:00:00.000,Atlanta GA; U.S.A. ATP World Tour,CLAY,2,Brett Steven,Bryan Shelton,Brett Steven,6-1; 6-2,R32,51,4,0,31,40,25,31,7,9,0,0,8,32,40,2,4,18,42,10,18,10,24,1,5,7,20,42
1995-05-01 00:00:00.000,Atlanta GA; U.S.A. ATP World Tour,CLAY,2,Karsten Braasch,Luke Jensen,Karsten Braasch,6-2; 7-5,R32,90,4,2,40,71,31,40,15,31,5,6,10,46,71,2,4,43,77,27,43,13,34,8,12,10,40,77
1995-05-01 00:00:00.000,Atlanta GA; U.S.A. ATP World Tour,CLAY,2,Todd Martin,Andrew Sznajder,Todd Martin,7-6(6); 6-4,R32,85,5,1,41,64,32,41,16,23,2,3,11,48,64,1,4,47,79,32,47,16,32,5,7,11,48,79
1995-05-01 00:00:00.000,Atlanta GA; U.S.A. ATP World Tour,CLAY,2,Jordi Arrese,MaliVai Washington,Jordi Arrese,6-4; 7-6(5),R32,104,0,1,51,72,30,51,10,21,1,6,11,40,72,2,6,58,91,37,58,8,33,8,14,11,45,91
1995-05-01 00:00:00.000,Atlanta GA; U.S.A. ATP World Tour,CLAY,2,Jared Palmer,Jamie Morgan,Jared Palmer,7-6(5); 6-4,R32,89,8,1,41,70,33,41,17,29,6,7,11,50,70,8,1,41,79,31,41,16,38,2,4,11,47,79
1995-05-01 00:00:00.000,Atlanta GA; U.S.A. ATP World Tour,CLAY,2,Wade McGuire,Alejo Mancisidor,Wade McGuire,6-4; 4-6; 7-5,R32,128,3,3,55,95,40,55,16,40,5,10,16,56,95,0,4,64,98,35,64,21,34,8,14,16,56,98
1995-05-01 00:00:00.000,Atlanta GA; U.S.A. ATP World Tour,CLAY,2,Michael Chang,Radomir Vasek,Michael Chang,6-3; 6-3,R32,67,3,2,28,47,24,28,10,19,0,1,9,34,47,1,2,28,52,15,28,12,24,3,7,9,27,52
1995-05-01 00:00:00.000,Atlanta GA; U.S.A. ATP World Tour,CLAY,2,Andre Agassi,Vincent Spadea,Andre Agassi,6-4; 7-5,R16,97,0,4,45,71,31,45,17,26,5,6,11,48,71,9,2,45,90,29,45,21,45,7,10,11,50,90
1995-05-01 00:00:00.000,Atlanta GA; U.S.A. ATP World Tour,CLAY,2,Christian Ruud,Chuck Adams,Christian Ruud,6-4; 6-1,R16,69,3,3,34,55,26,34,12,21,2,2,9,38,55,4,0,37,48,22,37,4,11,2,5,8,26,48
1995-05-01 00:00:00.000,Atlanta GA; U.S.A. ATP World Tour,CLAY,2,Magnus Larsson,Jakob Hlasek,Magnus Larsson,1-6; 6-3; 6-3,R16,84,3,2,45,70,31,45,11,25,6,10,12,42,70,3,4,47,85,30,47,16,38,5,10,13,46,85
1995-05-01 00:00:00.000,Atlanta GA; U.S.A. ATP World Tour,CLAY,2,Mats Wilander,Fernando Meligeni,Mats Wilander,6-3; 7-6(5),R16,106,4,2,50,70,37,50,9,20,5,7,10,46,70,0,1,45,79,28,45,15,34,4,8,11,43,79
1995-05-01 00:00:00.000,Atlanta GA; U.S.A. ATP World Tour,CLAY,2,Brett Steven,Aaron Krickstein,Brett Steven,7-5; 6-2,R16,76,6,2,34,53,27,34,13,19,2,3,10,40,53,4,2,40,70,26,40,11,30,4,8,10,37,70
1995-05-01 00:00:00.000,Atlanta GA; U.S.A. ATP World Tour,CLAY,2,Todd Martin,Karsten Braasch,Todd Martin,6-2; 6-2,R16,62,1,0,28,49,24,28,10,21,4,5,8,34,49,2,1,25,44,13,25,5,19,0,5,8,18,44
1995-05-01 00:00:00.000,Atlanta GA; U.S.A. ATP World Tour,CLAY,2,Jordi Arrese,Jared Palmer,Jordi Arrese,6-3; 5-7; 6-3,R16,118,1,3,67,94,45,67,12,27,6,10,15,57,94,2,3,75,101,45,75,8,26,11,17,15,53,101
1995-05-01 00:00:00.000,Atlanta GA; U.S.A. ATP World Tour,CLAY,2,Michael Chang,Wade McGuire,Michael Chang,6-1; 6-2,R16,60,3,4,29,44,26,29,7,15,0,0,8,33,44,4,3,24,43,15,24,5,19,2,6,7,20,43
1995-05-01 00:00:00.000,Atlanta GA; U.S.A. ATP World Tour,CLAY,2,Andre Agassi,Christian Ruud,Andre Agassi,6-4; 6-4,Q,86,3,1,45,69,33,45,12,24,9,10,10,45,69,4,3,38,76,26,38,17,38,6,9,10,43,76
1995-05-01 00:00:00.000,Atlanta GA; U.S.A. ATP World Tour,CLAY,2,Magnus Larsson,Mats Wilander,Magnus Larsson,6-3; 3-6; 6-2,Q,98,5,3,42,78,29,42,16,36,0,4,13,45,78,3,4,56,79,36,56,7,23,2,8,13,43,79
1995-05-01 00:00:00.000,Atlanta GA; U.S.A. ATP World Tour,CLAY,2,Todd Martin,Brett Steven,Todd Martin,7-5; 7-6(8),Q,119,2,0,46,77,31,46,20,31,5,8,12,51,77,0,3,60,92,36,60,16,32,4,8,12,52,92
1995-05-01 00:00:00.000,Atlanta GA; U.S.A. ATP World Tour,CLAY,2,Michael Chang,Jordi Arrese,Michael Chang,7-5; 6-3,Q,102,6,1,43,68,32,43,13,25,1,2,11,45,68,2,0,56,79,30,56,14,23,3,6,10,44,79
1995-05-01 00:00:00.000,Atlanta GA; U.S.A. ATP World Tour,CLAY,2,Andre Agassi,Magnus Larsson,Andre Agassi,6-4; 6-4,S,69,2,1,35,59,28,35,15,24,0,0,10,43,59,10,1,34,54,26,34,11,20,2,4,10,37,54
1995-05-01 00:00:00.000,Atlanta GA; U.S.A. ATP World Tour,CLAY,2,Michael Chang,Todd Martin,Michael Chang,6-3; 6-0,S,70,1,1,24,36,18,24,10,12,0,0,7,28,36,0,1,49,64,24,49,6,15,4,9,8,30,64
1995-05-01 00:00:00.000,Atlanta GA; U.S.A. ATP World Tour,CLAY,2,Michael Chang,Andre Agassi,Michael Chang,6-2; 6-7(6); 6-4,F,143,4,0,54,92,37,54,23,38,3,6,15,60,92,3,5,66,110,42,66,18,44,5,11,15,60,110
1995-05-01 00:00:00.000,Munich Germany ATP World Tour,CLAY,2,Hendrik Dreekmann,Boris Becker,Hendrik Dreekmann,5-7; 6-2; 6-2,R32,107,1,6,42,82,33,42,23,40,3,5,14,56,82,7,4,44,80,32,44,16,36,1,6,14,48,80
1995-05-01 00:00:00.000,Munich Germany ATP World Tour,CLAY,2,Marcelo Filippini,Jonas Svensson,Marcelo Filippini,6-4; 6-3,R32,82,1,1,41,53,31,41,7,12,1,1,9,38,53,0,1,56,75,29,56,14,19,7,10,10,43,75
1995-05-01 00:00:00.000,Munich Germany ATP World Tour,CLAY,2,Javier Sanchez,Slava Dosedel,Javier Sanchez,6-2; 6-7(4); 6-3,R32,116,0,5,80,107,59,80,11,27,7,8,15,70,107,2,2,64,85,40,64,14,21,3,7,14,54,85
1995-05-01 00:00:00.000,Munich Germany ATP World Tour,CLAY,2,Gilbert Schaller,Karel Novacek,Gilbert Schaller,6-4; 7-6(6),R32,111,1,0,71,81,40,71,6,10,7,10,11,46,81,3,3,47,87,31,47,15,40,6,10,11,46,87
1995-05-01 00:00:00.000,Munich Germany ATP World Tour,CLAY,2,Michael Stich,Jaime Yzaga,Michael Stich,4-6; 6-4; 7-5,R32,157,6,4,66,129,40,66,34,63,9,13,16,74,129,1,0,74,124,42,74,29,50,17,22,16,71,124
1995-05-01 00:00:00.000,Munich Germany ATP World Tour,CLAY,2,Karol Kucera,Horst Skoff,Karol Kucera,6-2; 6-0,R32,47,3,1,36,48,29,36,3,12,4,5,7,32,48,0,4,22,43,9,22,5,21,4,10,7,14,43
1995-05-01 00:00:00.000,Munich Germany ATP World Tour,CLAY,2,Arnaud Boetsch,Andrei Chesnokov,Arnaud Boetsch,6-3; 7-5,R32,98,1,3,26,65,18,26,22,39,3,7,11,40,65,0,3,51,78,27,51,10,27,5,11,10,37,78
1995-05-01 00:00:00.000,Munich Germany ATP World Tour,CLAY,2,Stefan Edberg,Patrick Rafter,Stefan Edberg,7-6(2); 6-3,R32,108,2,4,35,68,27,35,21,33,7,9,11,48,68,4,4,50,86,29,50,16,36,4,7,10,45,86
1995-05-01 00:00:00.000,Munich Germany ATP World Tour,CLAY,2,Renzo Furlan,Andrei Medvedev,Renzo Furlan,4-6; 6-4; 6-2,R32,132,0,3,71,106,44,71,20,35,8,10,14,64,106,15,8,58,116,40,58,23,58,8,12,14,63,116
1995-05-01 00:00:00.000,Munich Germany ATP World Tour,CLAY,2,Oliver Gross,Jordi Burillo,Oliver Gross,5-7; 7-5; 6-1,R32,114,6,4,59,101,41,59,18,42,6,11,16,59,101,3,6,56,108,40,56,14,52,4,11,15,54,108
1995-05-01 00:00:00.000,Munich Germany ATP World Tour,CLAY,2,Dinu Pescariu,Markus Zoecke,Dinu Pescariu,6-4; 6-2,R32,72,5,1,35,55,27,35,10,20,3,4,9,37,55,0,0,24,51,13,24,14,27,0,4,9,27,51
1995-05-01 00:00:00.000,Munich Germany ATP World Tour,CLAY,2,Wayne Ferreira,Daniel Vacek,Wayne Ferreira,6-4; 6-2,R32,81,3,1,35,67,30,35,15,32,6,6,9,45,67,2,3,42,69,26,42,14,27,9,12,9,40,69
1995-05-01 00:00:00.000,Munich Germany ATP World Tour,CLAY,2,Bernd Karbacher,Cedric Pioline,Bernd Karbacher,6-2; 6-2,R32,66,1,0,23,47,16,23,19,24,2,2,8,35,47,0,2,28,47,16,28,7,19,2,6,8,23,47
1995-05-01 00:00:00.000,Munich Germany ATP World Tour,CLAY,2,Sjeng Schalken,Petr Korda,Sjeng Schalken,6-4; 3-6; 6-3,R32,109,0,4,49,84,33,49,19,35,2,5,14,52,84,2,10,44,88,34,44,19,44,4,8,14,53,88
1995-05-01 00:00:00.000,Munich Germany ATP World Tour,CLAY,2,Alex Corretja,Carlos Costa,Alex Corretja,6-2; 6-3,R32,72,0,0,38,56,26,38,12,18,4,5,9,38,56,3,2,25,52,14,25,11,27,3,7,8,25,52
1995-05-01 00:00:00.000,Munich Germany ATP World Tour,CLAY,2,Martin Sinner,Yevgeny Kafelnikov,Martin Sinner,6-4; 6-3,R32,74,1,3,32,56,22,32,10,24,1,4,9,32,56,4,7,27,62,17,27,11,35,4,10,10,28,62
1995-05-01 00:00:00.000,Munich Germany ATP World Tour,CLAY,2,Marcelo Filippini,Hendrik Dreekmann,Marcelo Filippini,6-1; 3-6; 6-3,R16,113,1,2,62,85,39,62,14,23,10,13,13,53,85,2,2,51,79,27,51,16,28,8,13,12,43,79
1995-05-01 00:00:00.000,Munich Germany ATP World Tour,CLAY,2,Gilbert Schaller,Javier Sanchez,Gilbert Schaller,6-3; 6-2,R16,78,0,0,36,49,20,36,7,13,3,6,8,27,49,1,1,38,61,17,38,9,23,5,12,9,26,61
1995-05-01 00:00:00.000,Munich Germany ATP World Tour,CLAY,2,Michael Stich,Karol Kucera,Michael Stich,6-2; 5-7; 6-3,R16,106,2,4,44,91,29,44,24,47,4,9,15,53,91,1,5,39,77,23,39,17,38,5,12,14,40,77
1995-05-01 00:00:00.000,Munich Germany ATP World Tour,CLAY,2,Stefan Edberg,Arnaud Boetsch,Stefan Edberg,6-7(3); 6-4; 7-6(3),R16,142,4,4,76,121,51,76,21,45,7,11,17,72,121,2,10,47,109,35,47,32,62,2,7,17,67,109
1995-05-01 00:00:00.000,Munich Germany ATP World Tour,CLAY,2,Oliver Gross,Renzo Furlan,Oliver Gross,7-6(9); 6-4,R16,108,2,2,44,74,34,44,15,30,2,4,11,49,74,0,2,54,86,35,54,15,32,7,10,11,50,86
1995-05-01 00:00:00.000,Munich Germany ATP World Tour,CLAY,2,Wayne Ferreira,Dinu Pescariu,Wayne Ferreira,6-3; 7-6(2),R16,89,6,2,32,65,29,32,13,33,3,6,11,42,65,1,2,40,69,27,40,11,29,5,9,10,38,69
1995-05-01 00:00:00.000,Munich Germany ATP World Tour,CLAY,2,Sjeng Schalken,Bernd Karbacher,Sjeng Schalken,7-6(4); 6-7(4); 7-6(3),R16,170,6,7,97,150,64,97,27,53,12,15,18,91,150,6,7,66,126,49,66,31,60,9,12,18,80,126
1995-05-01 00:00:00.000,Munich Germany ATP World Tour,CLAY,2,Alex Corretja,Martin Sinner,Alex Corretja,6-2; 6-2,R16,65,1,0,39,53,27,39,8,14,2,3,8,35,53,0,3,26,44,13,26,6,18,1,6,8,19,44
1995-05-01 00:00:00.000,Munich Germany ATP World Tour,CLAY,2,Marcelo Filippini,Gilbert Schaller,Marcelo Filippini,7-5; 6-1,Q,0,0,0,0,0,0,0,0,0,0,0,0,0,0,0,0,0,0,0,0,0,0,0,0,0,0,0
1995-05-01 00:00:00.000,Munich Germany ATP World Tour,CLAY,2,Michael Stich,Stefan Edberg,Michael Stich,6-4; 6-0,Q,54,5,2,26,46,21,26,11,20,2,3,8,32,46,0,4,29,45,15,29,5,16,1,6,8,20,45
1995-05-01 00:00:00.000,Munich Germany ATP World Tour,CLAY,2,Wayne Ferreira,Oliver Gross,Wayne Ferreira,7-6(4); 6-3,Q,98,3,6,44,87,28,44,24,43,4,6,11,52,87,0,5,32,68,18,32,20,36,5,8,10,38,68
1995-05-01 00:00:00.000,Munich Germany ATP World Tour,CLAY,2,Alex Corretja,Sjeng Schalken,Alex Corretja,7-5; 6-2,Q,81,1,0,38,57,24,38,16,19,3,4,10,40,57,1,1,46,67,24,46,11,21,2,6,10,35,67
1995-05-01 00:00:00.000,Munich Germany ATP World Tour,CLAY,2,Michael Stich,Marcelo Filippini,Michael Stich,6-4; 6-3,S,73,5,2,26,55,23,26,15,29,3,3,9,38,55,0,1,49,62,28,49,9,13,4,7,10,37,62
1995-05-01 00:00:00.000,Munich Germany ATP World Tour,CLAY,2,Wayne Ferreira,Alex Corretja,Wayne Ferreira,6-3; 2-6; 6-4,S,126,4,0,43,82,29,43,18,39,6,11,14,47,82,2,0,76,104,44,76,13,28,9,14,13,57,104
1995-05-01 00:00:00.000,Munich Germany ATP World Tour,CLAY,2,Wayne Ferreira,Michael Stich,Wayne Ferreira,7-5; 7-6(6),F,113,2,3,56,82,42,56,11,26,3,5,12,53,82,11,4,45,101,31,45,26,56,5,8,12,57,101
1995-05-08 00:00:00.000,ATP Masters Series Hamburg Germany ATP World Tour,CLAY,2,Andre Agassi,N/A Bye,Andre Agassi,,R64,0,0,0,0,0,0,0,0,0,0,0,0,0,0,0,0,0,0,0,0,0,0,0,0,0,0,0
1995-05-08 00:00:00.000,ATP Masters Series Hamburg Germany ATP World Tour,CLAY,2,Marc-Kevin Goellner,Paul Haarhuis,Marc-Kevin Goellner,6-1; 6-4,R64,60,3,1,29,50,21,29,14,21,2,3,9,35,50,3,1,24,45,11,24,9,21,2,6,8,20,45
1995-05-08 00:00:00.000,ATP Masters Series Hamburg Germany ATP World Tour,CLAY,2,Slava Dosedel,Thomas Gollwitzer,Slava Dosedel,7-6(3); 7-5,R64,121,8,5,58,90,42,58,14,32,8,10,12,56,90,3,4,51,81,37,51,12,30,4,7,12,49,81
1995-05-08 00:00:00.000,ATP Masters Series Hamburg Germany ATP World Tour,CLAY,2,David Prinosil,Bernd Karbacher,David Prinosil,6-3; 2-6; 6-4,R64,101,2,8,44,86,32,44,17,42,5,10,14,49,86,3,2,47,84,28,47,19,37,3,8,13,47,84
1995-05-08 00:00:00.000,ATP Masters Series Hamburg Germany ATP World Tour,CLAY,2,Richard Krajicek,Markus Zoecke,Richard Krajicek,4-6; 6-4; 6-3,R64,98,10,3,47,85,37,47,20,38,4,7,15,57,85,4,3,54,84,38,54,14,30,5,9,14,52,84
1995-05-08 00:00:00.000,ATP Masters Series Hamburg Germany ATP World Tour,CLAY,2,Francisco Clavet,Gabriel Silberstein,Francisco Clavet,6-3; 3-6; 6-1,R64,112,4,2,53,92,36,53,21,39,5,7,13,57,92,3,2,40,71,27,40,12,31,3,7,12,39,71
1995-05-08 00:00:00.000,ATP Masters Series Hamburg Germany ATP World Tour,CLAY,2,Mark Knowles,Richard Fromberg,Mark Knowles,6-2; 6-7(10); 7-5,R64,166,1,2,66,104,43,66,20,38,5,10,16,63,104,4,4,61,119,38,61,27,58,6,14,16,65,119
1995-05-08 00:00:00.000,ATP Masters Series Hamburg Germany ATP World Tour,CLAY,2,Sergi Bruguera,N/A Bye,Sergi Bruguera,,R64,0,0,0,0,0,0,0,0,0,0,0,0,0,0,0,0,0,0,0,0,0,0,0,0,0,0,0
1995-05-08 00:00:00.000,ATP Masters Series Hamburg Germany ATP World Tour,CLAY,2,Goran Ivanisevic,N/A Bye,Goran Ivanisevic,,R64,0,0,0,0,0,0,0,0,0,0,0,0,0,0,0,0,0,0,0,0,0,0,0,0,0,0,0
1995-05-08 00:00:00.000,ATP Masters Series Hamburg Germany ATP World Tour,CLAY,2,Joern Renzenbrink,Alex Corretja,Joern Renzenbrink,6-3; 6-3,R64,60,2,0,28,48,26,28,11,20,0,0,9,37,48,1,1,51,65,31,51,5,14,1,4,9,36,65
1995-05-08 00:00:00.000,ATP Masters Series Hamburg Germany ATP World Tour,CLAY,2,Albert Costa,Andrei Cherkasov,Albert Costa,6-4; 6-2,R64,79,2,0,56,65,39,56,3,9,5,6,9,42,65,2,1,28,60,16,28,14,32,6,10,9,30,60
1995-05-08 00:00:00.000,ATP Masters Series Hamburg Germany ATP World Tour,CLAY,2,Jacco Eltingh,Fabrice Santoro,Jacco Eltingh,6-3; 3-6; 7-6(4),R64,131,7,3,77,122,54,77,21,45,11,13,15,75,122,2,2,70,93,50,70,11,23,4,6,15,61,93
1995-05-08 00:00:00.000,ATP Masters Series Hamburg Germany ATP World Tour,CLAY,2,Marc Rosset,Alexander Volkov,Marc Rosset,6-3; 6-3,R64,63,6,2,40,58,30,40,11,18,3,3,9,41,58,2,4,26,62,16,26,19,36,2,5,9,35,62
1995-05-08 00:00:00.000,ATP Masters Series Hamburg Germany ATP World Tour,CLAY,2,Renzo Furlan,Olivier Delaitre,Renzo Furlan,7-5; 6-2,R64,75,2,1,39,56,25,39,6,17,1,5,10,31,56,1,3,40,62,19,40,5,22,5,12,10,24,62
1995-05-08 00:00:00.000,ATP Masters Series Hamburg Germany ATP World Tour,CLAY,2,Oliver Gross,Andrei Olhovskiy,Oliver Gross,6-4; 7-6(2),R64,89,5,3,56,96,38,56,23,40,12,13,11,61,96,3,6,36,70,29,36,16,34,0,2,11,45,70
1995-05-08 00:00:00.000,ATP Masters Series Hamburg Germany ATP World Tour,CLAY,2,Alberto Berasategui,N/A Bye,Alberto Berasategui,,R64,0,0,0,0,0,0,0,0,0,0,0,0,0,0,0,0,0,0,0,0,0,0,0,0,0,0,0
1995-05-08 00:00:00.000,ATP Masters Series Hamburg Germany ATP World Tour,CLAY,2,Yevgeny Kafelnikov,N/A Bye,Yevgeny Kafelnikov,,R64,0,0,0,0,0,0,0,0,0,0,0,0,0,0,0,0,0,0,0,0,0,0,0,0,0,0,0
1995-05-08 00:00:00.000,ATP Masters Series Hamburg Germany ATP World Tour,CLAY,2,Gilbert Schaller,Horst Skoff,Gilbert Schaller,6-3; 6-0,R64,73,2,1,40,47,25,40,4,7,4,6,8,29,47,4,2,30,64,15,30,12,34,12,18,7,27,64
1995-05-08 00:00:00.000,ATP Masters Series Hamburg Germany ATP World Tour,CLAY,2,MaliVai Washington,Andrei Chesnokov,MaliVai Washington,6-7(3); 6-2; 6-3,R64,124,3,3,58,99,37,58,24,41,7,9,14,61,99,3,6,63,96,40,63,14,33,2,8,15,54,96
1995-05-08 00:00:00.000,ATP Masters Series Hamburg Germany ATP World Tour,CLAY,2,Andrei Medvedev,Marcelo Charpentier,Andrei Medvedev,6-2; 6-3,R64,77,2,3,39,67,28,39,15,28,2,2,9,43,67,0,0,43,56,26,43,6,13,6,9,8,32,56
1995-05-08 00:00:00.000,ATP Masters Series Hamburg Germany ATP World Tour,CLAY,2,Andrea Gaudenzi,Marcelo Filippini,Andrea Gaudenzi,4-6; 7-6(6); 6-1,R64,137,3,3,54,88,42,54,18,34,1,3,14,60,88,1,1,80,109,49,80,13,29,5,9,15,62,109
1995-05-08 00:00:00.000,ATP Masters Series Hamburg Germany ATP World Tour,CLAY,2,Patrick Rafter,Javier Sanchez,Patrick Rafter,6-3; 3-6; 7-6(4),R64,136,9,6,59,103,44,59,21,44,6,9,15,65,103,3,3,85,109,54,85,12,24,4,7,15,66,109
1995-05-08 00:00:00.000,ATP Masters Series Hamburg Germany ATP World Tour,CLAY,2,Jaime Yzaga,Arnaud Boetsch,Jaime Yzaga,6-7(1); 6-3; 6-3,R64,132,2,3,60,102,42,60,18,42,10,14,15,60,102,1,4,50,98,30,50,22,48,8,15,15,52,98
1995-05-08 00:00:00.000,ATP Masters Series Hamburg Germany ATP World Tour,CLAY,2,Boris Becker,N/A Bye,Boris Becker,,R64,0,0,0,0,0,0,0,0,0,0,0,0,0,0,0,0,0,0,0,0,0,0,0,0,0,0,0
1995-05-08 00:00:00.000,ATP Masters Series Hamburg Germany ATP World Tour,CLAY,2,Michael Stich,N/A Bye,Michael Stich,,R64,0,0,0,0,0,0,0,0,0,0,0,0,0,0,0,0,0,0,0,0,0,0,0,0,0,0,0
1995-05-08 00:00:00.000,ATP Masters Series Hamburg Germany ATP World Tour,CLAY,2,Petr Korda,Tomas Carbonell,Petr Korda,7-6(5); 6-3,R64,96,3,8,41,77,28,41,16,36,5,7,10,44,77,4,5,57,90,34,57,13,33,9,13,11,47,90
1995-05-08 00:00:00.000,ATP Masters Series Hamburg Germany ATP World Tour,CLAY,2,Karol Kucera,Vincent Spadea,Karol Kucera,3-6; 6-3; 6-3,R64,126,5,7,61,106,35,61,23,45,16,21,14,58,106,1,0,40,84,22,40,21,44,8,14,13,43,84
1995-05-08 00:00:00.000,ATP Masters Series Hamburg Germany ATP World Tour,CLAY,2,Wayne Ferreira,Dimitri Poliakov,Wayne Ferreira,6-2; 6-3,R64,58,1,0,33,51,21,33,9,18,0,3,9,30,51,3,3,34,60,19,34,7,26,6,12,8,26,60
1995-05-08 00:00:00.000,ATP Masters Series Hamburg Germany ATP World Tour,CLAY,2,Daniel Vacek,Roberto Carretero,Daniel Vacek,6-3; 5-7; 6-4,R64,94,11,1,50,81,40,50,23,31,0,1,16,63,81,4,3,51,81,38,51,19,30,0,2,15,57,81
1995-05-08 00:00:00.000,ATP Masters Series Hamburg Germany ATP World Tour,CLAY,2,Jan Siemerink,Martin Sinner,Jan Siemerink,6-4; 2-6; 6-2,R64,92,9,2,40,76,27,40,19,36,4,8,13,46,76,2,2,48,77,31,48,16,29,6,11,13,47,77
1995-05-08 00:00:00.000,ATP Masters Series Hamburg Germany ATP World Tour,CLAY,2,Carlos Costa,Hendrik Dreekmann,Carlos Costa,6-1; 6-3,R64,65,3,0,32,51,25,32,12,19,4,4,8,37,51,2,1,33,53,20,33,6,20,5,9,8,26,53
1995-05-08 00:00:00.000,ATP Masters Series Hamburg Germany ATP World Tour,CLAY,2,Pete Sampras,N/A Bye,Pete Sampras,,R64,0,0,0,0,0,0,0,0,0,0,0,0,0,0,0,0,0,0,0,0,0,0,0,0,0,0,0
1995-05-08 00:00:00.000,ATP Masters Series Hamburg Germany ATP World Tour,CLAY,2,Andre Agassi,Marc-Kevin Goellner,Andre Agassi,6-2; 7-6(4),R32,75,0,0,35,58,26,35,16,23,0,1,10,42,58,9,2,48,72,33,48,8,24,2,5,10,41,72
1995-05-08 00:00:00.000,ATP Masters Series Hamburg Germany ATP World Tour,CLAY,2,Slava Dosedel,David Prinosil,Slava Dosedel,6-1; 6-4,R32,56,1,0,45,57,32,45,8,12,3,3,9,40,57,3,1,26,41,18,26,7,15,0,3,8,25,41
1995-05-08 00:00:00.000,ATP Masters Series Hamburg Germany ATP World Tour,CLAY,2,Richard Krajicek,Francisco Clavet,Richard Krajicek,6-3; 6-3,R32,68,5,3,32,62,28,32,16,30,2,2,9,44,62,0,1,43,58,26,43,7,15,2,5,9,33,58
1995-05-08 00:00:00.000,ATP Masters Series Hamburg Germany ATP World Tour,CLAY,2,Sergi Bruguera,Mark Knowles,Sergi Bruguera,6-2; 6-3,R32,66,1,1,21,45,17,21,19,24,0,0,9,36,45,1,3,31,50,19,31,10,19,1,4,8,29,50
1995-05-08 00:00:00.000,ATP Masters Series Hamburg Germany ATP World Tour,CLAY,2,Goran Ivanisevic,Joern Renzenbrink,Goran Ivanisevic,6-4; 6-0,R32,55,8,2,25,45,21,25,13,20,3,3,8,34,45,3,2,33,53,23,33,5,20,3,7,8,28,53
1995-05-08 00:00:00.000,ATP Masters Series Hamburg Germany ATP World Tour,CLAY,2,Jacco Eltingh,Albert Costa,Jacco Eltingh,5-7; 6-4; 6-3,R32,113,10,11,49,96,38,49,24,47,4,7,16,62,96,3,1,81,106,49,81,13,25,10,14,15,62,106
1995-05-08 00:00:00.000,ATP Masters Series Hamburg Germany ATP World Tour,CLAY,2,Marc Rosset,Renzo Furlan,Marc Rosset,6-2; 3-6; 7-5,R32,134,15,8,56,103,42,56,18,47,10,14,14,60,103,0,0,76,105,42,76,14,29,8,14,15,56,105
1995-05-08 00:00:00.000,ATP Masters Series Hamburg Germany ATP World Tour,CLAY,2,Oliver Gross,Alberto Berasategui,Oliver Gross,6-3; 6-2,R32,67,1,3,37,59,27,37,7,22,3,5,8,34,59,0,4,43,64,20,43,8,21,5,11,9,28,64
1995-05-08 00:00:00.000,ATP Masters Series Hamburg Germany ATP World Tour,CLAY,2,Gilbert Schaller,Yevgeny Kafelnikov,Gilbert Schaller,6-3; 6-1,R32,73,2,1,39,48,26,39,6,9,6,7,8,32,48,1,3,39,69,17,39,14,30,7,12,8,31,69
1995-05-08 00:00:00.000,ATP Masters Series Hamburg Germany ATP World Tour,CLAY,2,Andrei Medvedev,MaliVai Washington,Andrei Medvedev,6-4; 6-2,R32,81,3,3,22,56,17,22,20,34,3,4,9,37,56,4,4,38,65,22,38,11,27,5,9,9,33,65
1995-05-08 00:00:00.000,ATP Masters Series Hamburg Germany ATP World Tour,CLAY,2,Andrea Gaudenzi,Patrick Rafter,Andrea Gaudenzi,6-2; 6-4,R32,74,2,1,36,51,26,36,7,15,3,5,9,33,51,4,5,39,61,27,39,3,22,5,10,9,30,61
1995-05-08 00:00:00.000,ATP Masters Series Hamburg Germany ATP World Tour,CLAY,2,Jaime Yzaga,Boris Becker,Jaime Yzaga,2-6; 6-2; 6-3,R32,106,2,4,63,92,40,63,14,29,6,9,13,54,92,4,3,38,70,25,38,15,32,4,8,12,40,70
1995-05-08 00:00:00.000,ATP Masters Series Hamburg Germany ATP World Tour,CLAY,2,Michael Stich,Petr Korda,Michael Stich,6-1; 7-6(6),R32,91,4,4,35,67,25,35,20,32,3,4,10,45,67,1,9,33,71,20,33,19,38,10,13,9,39,71
1995-05-08 00:00:00.000,ATP Masters Series Hamburg Germany ATP World Tour,CLAY,2,Wayne Ferreira,Karol Kucera,Wayne Ferreira,3-6; 7-5; 6-2,R32,125,3,2,57,101,37,57,22,44,7,11,15,59,101,4,8,52,100,33,52,23,48,7,12,14,56,100
1995-05-08 00:00:00.000,ATP Masters Series Hamburg Germany ATP World Tour,CLAY,2,Daniel Vacek,Jan Siemerink,Daniel Vacek,4-1 RET,R32,37,0,3,11,24,7,11,8,13,1,1,3,15,24,0,1,17,27,9,17,3,10,4,6,3,12,27
1995-05-08 00:00:00.000,ATP Masters Series Hamburg Germany ATP World Tour,CLAY,2,Pete Sampras,Carlos Costa,Pete Sampras,6-3; 7-5,R32,95,4,1,35,66,26,35,18,31,4,6,11,44,66,6,3,48,79,31,48,12,31,8,12,10,43,79
1995-05-08 00:00:00.000,ATP Masters Series Hamburg Germany ATP World Tour,CLAY,2,Andre Agassi,Slava Dosedel,Andre Agassi,6-2; 6-1,R16,52,3,1,28,41,22,28,8,13,0,1,8,30,41,0,1,32,44,12,32,6,12,3,8,7,18,44
1995-05-08 00:00:00.000,ATP Masters Series Hamburg Germany ATP World Tour,CLAY,2,Sergi Bruguera,Richard Krajicek,Sergi Bruguera,3-0 RET,R16,9,0,0,4,6,3,4,1,2,0,0,2,4,6,0,0,7,13,3,7,1,6,0,2,2,4,13
1995-05-08 00:00:00.000,ATP Masters Series Hamburg Germany ATP World Tour,CLAY,2,Goran Ivanisevic,Jacco Eltingh,Goran Ivanisevic,6-4; 6-4,R16,64,10,1,26,49,23,26,17,23,0,0,10,40,49,2,9,37,65,28,37,11,28,1,3,10,39,65
1995-05-08 00:00:00.000,ATP Masters Series Hamburg Germany ATP World Tour,CLAY,2,Marc Rosset,Oliver Gross,Marc Rosset,2-6; 6-4; 6-2,R16,96,4,2,38,67,30,38,17,29,1,3,13,47,67,1,6,56,88,39,56,14,32,4,7,13,53,88
1995-05-08 00:00:00.000,ATP Masters Series Hamburg Germany ATP World Tour,CLAY,2,Andrei Medvedev,Gilbert Schaller,Andrei Medvedev,1-6; 6-1; 6-2,R16,92,0,2,38,69,24,38,16,31,2,5,11,40,69,0,0,60,72,28,60,6,12,6,11,11,34,72
1995-05-08 00:00:00.000,ATP Masters Series Hamburg Germany ATP World Tour,CLAY,2,Andrea Gaudenzi,Jaime Yzaga,Andrea Gaudenzi,6-3; 6-1,R16,77,0,1,25,48,20,25,13,23,1,1,8,33,48,5,1,42,71,25,42,11,29,10,14,8,36,71
1995-05-08 00:00:00.000,ATP Masters Series Hamburg Germany ATP World Tour,CLAY,2,Wayne Ferreira,Michael Stich,Wayne Ferreira,7-5; 6-1,R16,76,0,1,43,70,30,43,15,27,3,4,10,45,70,1,1,39,57,21,39,7,18,5,9,9,28,57
1995-05-08 00:00:00.000,ATP Masters Series Hamburg Germany ATP World Tour,CLAY,2,Pete Sampras,Daniel Vacek,Pete Sampras,6-2; 3-6; 6-2,R16,95,4,3,34,64,29,34,18,30,2,3,12,47,64,11,6,43,82,29,43,19,39,9,13,13,48,82
1995-05-08 00:00:00.000,ATP Masters Series Hamburg Germany ATP World Tour,CLAY,2,Sergi Bruguera,Andre Agassi,Sergi Bruguera,6-3; 6-1,Q,66,3,3,31,47,23,31,8,16,0,1,8,31,47,0,6,27,56,19,27,8,29,2,7,8,27,56
1995-05-08 00:00:00.000,ATP Masters Series Hamburg Germany ATP World Tour,CLAY,2,Goran Ivanisevic,Marc Rosset,Goran Ivanisevic,6-1; 6-3,Q,52,6,2,30,50,26,30,10,20,8,8,8,36,50,2,3,25,44,14,25,8,19,2,6,8,22,44
1995-05-08 00:00:00.000,ATP Masters Series Hamburg Germany ATP World Tour,CLAY,2,Andrei Medvedev,Andrea Gaudenzi,Andrei Medvedev,6-3; 6-2,Q,66,5,2,32,57,23,32,17,25,4,4,9,40,57,1,1,25,48,15,25,12,23,3,6,8,27,48
1995-05-08 00:00:00.000,ATP Masters Series Hamburg Germany ATP World Tour,CLAY,2,Pete Sampras,Wayne Ferreira,Pete Sampras,6-2; 6-2,Q,62,4,3,36,59,28,36,11,23,6,6,8,39,59,4,2,32,50,20,32,6,18,6,10,8,26,50
1995-05-08 00:00:00.000,ATP Masters Series Hamburg Germany ATP World Tour,CLAY,2,Goran Ivanisevic,Sergi Bruguera,Goran Ivanisevic,6-4; 3-6; 7-6(3),S,112,9,4,38,86,32,38,25,48,2,5,15,57,86,5,0,59,88,46,59,14,29,1,4,16,60,88
1995-05-08 00:00:00.000,ATP Masters Series Hamburg Germany ATP World Tour,CLAY,2,Andrei Medvedev,Pete Sampras,Andrei Medvedev,6-4; 2-6; 6-4,S,117,2,2,43,74,34,43,19,31,1,3,14,53,74,2,2,64,110,44,64,23,46,9,11,14,67,110
1995-05-08 00:00:00.000,ATP Masters Series Hamburg Germany ATP World Tour,CLAY,2,Andrei Medvedev,Goran Ivanisevic,Andrei Medvedev,6-3; 6-2; 6-1,F,77,2,4,39,64,30,39,18,25,1,2,12,48,64,3,4,32,71,19,32,15,39,2,9,12,34,71
1995-05-08 00:00:00.000,Pinehurst NC; U.S.A. ATP World Tour,CLAY,2,Magnus Larsson,Brett Steven,Magnus Larsson,6-2; 6-3,R32,58,3,0,29,45,25,29,10,16,2,2,8,35,45,3,3,34,51,20,34,7,17,3,7,9,27,51
1995-05-08 00:00:00.000,Pinehurst NC; U.S.A. ATP World Tour,CLAY,2,Nicolas Pereira,Michael Tebbutt,Nicolas Pereira,4-6; 6-4; 7-6(6),R32,130,8,1,76,116,51,76,23,40,8,11,16,74,116,10,11,45,103,36,45,30,58,1,4,16,66,103
1995-05-08 00:00:00.000,Pinehurst NC; U.S.A. ATP World Tour,CLAY,2,Greg Rusedski,Radomir Vasek,Greg Rusedski,4-6; 6-4; 7-6(2),R32,149,6,10,59,117,42,59,27,58,10,15,16,69,117,4,14,62,126,47,62,23,64,13,18,16,70,126
1995-05-08 00:00:00.000,Pinehurst NC; U.S.A. ATP World Tour,CLAY,2,Jared Palmer,Grant Stafford,Jared Palmer,5-7; 6-3; 7-5,R32,116,7,5,62,94,44,62,15,32,5,10,17,59,94,2,4,71,106,45,71,14,35,5,11,16,59,106
1995-05-08 00:00:00.000,Pinehurst NC; U.S.A. ATP World Tour,CLAY,2,Jason Stoltenberg,Todd Woodbridge,Jason Stoltenberg,6-0; 7-6(3),R32,80,2,6,29,63,25,29,17,34,3,4,9,42,63,0,7,32,62,16,32,14,30,3,7,9,30,62
1995-05-08 00:00:00.000,Pinehurst NC; U.S.A. ATP World Tour,CLAY,2,Javier Frana,Pat Cash,Javier Frana,6-2; 6-0,R32,53,4,0,19,38,15,19,15,19,0,0,7,30,38,0,2,21,46,14,21,6,25,2,7,7,20,46
1995-05-08 00:00:00.000,Pinehurst NC; U.S.A. ATP World Tour,CLAY,2,Jakob Hlasek,Juan Albert Viloca-Puig,Jakob Hlasek,7-6(7); 6-1,R32,70,6,2,34,59,26,34,14,25,1,3,10,40,59,2,1,39,56,21,39,9,17,0,4,9,30,56
1995-05-08 00:00:00.000,Pinehurst NC; U.S.A. ATP World Tour,CLAY,2,Gaston Etlis,Karsten Braasch,Gaston Etlis,6-3; 6-4,R32,76,3,1,25,64,15,25,24,39,4,6,10,39,64,2,2,18,53,14,18,15,35,2,6,9,29,53
1995-05-08 00:00:00.000,Pinehurst NC; U.S.A. ATP World Tour,CLAY,2,Guillaume Raoux,Mark Woodforde,Guillaume Raoux,2-6; 7-6(5); 6-4,R32,146,7,5,62,106,41,62,23,44,7,12,15,64,106,5,4,69,104,43,69,20,35,7,11,15,63,104
1995-05-08 00:00:00.000,Pinehurst NC; U.S.A. ATP World Tour,CLAY,2,Jordi Arrese,Mats Wilander,Jordi Arrese,6-2; 6-2,R32,60,3,3,25,41,19,25,9,16,2,4,8,28,41,2,1,30,44,15,30,3,14,3,9,8,18,44
1995-05-08 00:00:00.000,Pinehurst NC; U.S.A. ATP World Tour,CLAY,2,Patrick McEnroe,Alex Antonitsch,Patrick McEnroe,6-2; 6-1,R32,53,3,1,20,49,17,20,17,29,0,0,8,34,49,5,3,17,39,12,17,7,22,2,6,7,19,39
1995-05-08 00:00:00.000,Pinehurst NC; U.S.A. ATP World Tour,CLAY,2,David Wheaton,Donald Johnson,David Wheaton,6-1; 5-7; 6-3,R32,136,4,8,67,110,47,67,23,43,9,11,14,70,110,3,8,47,86,32,47,15,39,6,11,14,47,86
1995-05-08 00:00:00.000,Pinehurst NC; U.S.A. ATP World Tour,CLAY,2,Fernando Meligeni,Chuck Adams,Fernando Meligeni,6-2; 6-1,R32,48,5,1,23,39,19,23,12,16,2,2,7,31,39,0,4,44,53,23,44,1,9,5,10,8,24,53
1995-05-08 00:00:00.000,Pinehurst NC; U.S.A. ATP World Tour,CLAY,2,Steve Bryan,Jamie Morgan,Steve Bryan,6-2; 6-3,R32,70,3,3,32,55,22,32,15,23,5,5,8,37,55,9,5,22,55,18,22,13,33,8,12,9,31,55
1995-05-08 00:00:00.000,Pinehurst NC; U.S.A. ATP World Tour,CLAY,2,Richey Reneberg,Emilio Sanchez,Richey Reneberg,6-4; 6-4,R32,76,6,0,30,53,26,30,13,23,0,1,10,39,53,4,0,39,67,24,39,15,28,4,7,10,39,67
1995-05-08 00:00:00.000,Pinehurst NC; U.S.A. ATP World Tour,CLAY,2,Thomas Enqvist,Lionel Roux,Thomas Enqvist,6-4; 7-5,R32,79,2,4,32,62,26,32,15,30,0,2,11,41,62,4,2,30,53,21,30,12,23,4,8,11,33,53
1995-05-08 00:00:00.000,Pinehurst NC; U.S.A. ATP World Tour,CLAY,2,Magnus Larsson,Nicolas Pereira,Magnus Larsson,6-2; 6-3,R16,62,3,3,34,54,26,34,12,20,2,2,8,38,54,6,2,32,58,19,32,11,26,3,7,9,30,58
1995-05-08 00:00:00.000,Pinehurst NC; U.S.A. ATP World Tour,CLAY,2,Jared Palmer,Greg Rusedski,Jared Palmer,6-4; 7-6(5),R16,86,4,2,54,75,44,54,9,21,4,5,11,53,75,11,7,37,71,28,37,17,34,1,3,11,45,71
1995-05-08 00:00:00.000,Pinehurst NC; U.S.A. ATP World Tour,CLAY,2,Javier Frana,Jason Stoltenberg,Javier Frana,2-6; 6-2; 6-4,R16,109,2,0,50,83,32,50,21,33,7,10,13,53,83,5,3,64,103,41,64,17,39,9,13,13,58,103
1995-05-08 00:00:00.000,Pinehurst NC; U.S.A. ATP World Tour,CLAY,2,Jakob Hlasek,Gaston Etlis,Jakob Hlasek,6-3; 6-4,R16,70,0,3,39,60,28,39,8,21,4,6,9,36,60,0,2,24,53,14,24,13,29,2,7,10,27,53
1995-05-08 00:00:00.000,Pinehurst NC; U.S.A. ATP World Tour,CLAY,2,Jordi Arrese,Guillaume Raoux,Jordi Arrese,7-6(3); 7-6(5),R16,111,2,3,61,86,44,61,16,25,5,6,12,60,86,3,1,48,89,39,48,19,41,3,4,12,58,89
1995-05-08 00:00:00.000,Pinehurst NC; U.S.A. ATP World Tour,CLAY,2,David Wheaton,Patrick McEnroe,David Wheaton,3-6; 6-3; 6-3,R16,114,7,1,57,84,35,57,14,27,8,12,13,49,84,1,7,45,82,30,45,12,37,1,7,14,42,82
1995-05-08 00:00:00.000,Pinehurst NC; U.S.A. ATP World Tour,CLAY,2,Fernando Meligeni,Steve Bryan,Fernando Meligeni,6-2; 6-4,R16,80,12,1,28,57,24,28,12,29,4,6,9,36,57,0,8,36,63,21,36,10,27,5,10,9,31,63
1995-05-08 00:00:00.000,Pinehurst NC; U.S.A. ATP World Tour,CLAY,2,Thomas Enqvist,Richey Reneberg,Thomas Enqvist,7-6(4); 3-6; 6-2,R16,122,9,7,62,107,38,62,26,45,9,14,15,64,107,9,4,47,86,33,47,17,39,3,8,14,50,86
1995-05-08 00:00:00.000,Pinehurst NC; U.S.A. ATP World Tour,CLAY,2,Magnus Larsson,Jared Palmer,Magnus Larsson,6-7(5); 7-6(2); 7-6(6),Q,155,12,1,78,121,66,78,22,43,4,5,18,88,121,3,5,78,134,57,78,32,56,6,7,18,89,134
1995-05-08 00:00:00.000,Pinehurst NC; U.S.A. ATP World Tour,CLAY,2,Javier Frana,Jakob Hlasek,Javier Frana,6-7(3); 7-5; 6-4,Q,133,2,3,75,120,50,75,24,45,9,12,17,74,120,4,2,59,100,42,59,21,41,6,11,17,63,100
1995-05-08 00:00:00.000,Pinehurst NC; U.S.A. ATP World Tour,CLAY,2,David Wheaton,Jordi Arrese,David Wheaton,6-4; 6-3,Q,92,9,1,54,87,40,54,16,33,12,12,10,56,87,2,3,37,50,25,37,7,13,0,2,9,32,50
1995-05-08 00:00:00.000,Pinehurst NC; U.S.A. ATP World Tour,CLAY,2,Thomas Enqvist,Fernando Meligeni,Thomas Enqvist,6-2; 6-1,Q,46,4,2,26,43,23,26,8,17,2,3,8,31,43,2,3,12,33,6,12,6,21,2,7,7,12,33
1995-05-08 00:00:00.000,Pinehurst NC; U.S.A. ATP World Tour,CLAY,2,Javier Frana,Magnus Larsson,Javier Frana,6-4; 4-6; 6-3,S,101,4,0,64,102,45,64,21,38,9,11,15,66,102,10,2,41,77,36,41,16,36,2,5,14,52,77
1995-05-08 00:00:00.000,Pinehurst NC; U.S.A. ATP World Tour,CLAY,2,Thomas Enqvist,David Wheaton,Thomas Enqvist,7-5; 6-4,S,84,8,4,39,54,31,39,8,15,1,3,11,39,54,7,1,48,78,33,48,11,30,5,9,11,44,78
1995-05-08 00:00:00.000,Pinehurst NC; U.S.A. ATP World Tour,CLAY,2,Thomas Enqvist,Javier Frana,Thomas Enqvist,6-3; 3-6; 6-3,F,111,3,7,32,83,26,32,24,51,2,6,14,50,83,8,0,49,82,33,49,13,33,6,11,13,46,82
1995-05-15 00:00:00.000,ATP Masters Series Rome Italy ATP World Tour,CLAY,2,Fabrice Santoro,Pete Sampras,Fabrice Santoro,6-4; 6-3,R64,77,1,3,33,59,21,33,15,26,5,7,9,36,59,2,5,32,57,19,32,9,25,2,7,10,28,57
1995-05-15 00:00:00.000,ATP Masters Series Rome Italy ATP World Tour,CLAY,2,Slava Dosedel,Jason Stoltenberg,Slava Dosedel,6-1; 6-0,R64,50,0,1,33,45,28,33,3,12,1,1,7,31,45,0,2,25,44,10,25,7,19,3,8,6,17,44
1995-05-15 00:00:00.000,ATP Masters Series Rome Italy ATP World Tour,CLAY,2,Andrei Chesnokov,Francisco Clavet,Andrei Chesnokov,2-6; 7-5; 6-2,R64,130,4,4,61,100,38,61,16,39,9,14,14,54,100,1,4,44,81,25,44,17,37,5,11,14,42,81
1995-05-15 00:00:00.000,ATP Masters Series Rome Italy ATP World Tour,CLAY,2,Jonas Bjorkman,Daniel Nestor,Jonas Bjorkman,3-6; 6-1; 7-6(4),R64,111,10,3,48,95,40,48,25,47,1,2,14,65,95,11,4,52,86,38,52,18,34,1,3,14,56,86
1995-05-15 00:00:00.000,ATP Masters Series Rome Italy ATP World Tour,CLAY,2,Thierry Guardiola,Jim Courier,Thierry Guardiola,3-6; 6-3; 7-6(3),R64,165,6,1,54,100,40,54,29,46,5,6,15,69,100,0,1,62,101,43,62,23,39,4,5,15,66,101
1995-05-15 00:00:00.000,ATP Masters Series Rome Italy ATP World Tour,CLAY,2,Richard Fromberg,Jared Palmer,Richard Fromberg,6-2; 6-2,R64,67,6,1,27,54,22,27,12,27,5,6,8,34,54,2,4,23,44,13,23,8,21,3,8,8,21,44
1995-05-15 00:00:00.000,ATP Masters Series Rome Italy ATP World Tour,CLAY,2,Jacco Eltingh,Mats Wilander,Jacco Eltingh,6-3; 6-2,R64,65,5,3,27,51,22,27,16,24,1,1,9,38,51,1,0,30,44,18,30,8,14,0,3,8,26,44
1995-05-15 00:00:00.000,ATP Masters Series Rome Italy ATP World Tour,CLAY,2,Sergi Bruguera,Patrick Rafter,Sergi Bruguera,6-4; 7-5,R64,99,1,2,52,72,35,52,12,20,8,9,11,47,72,2,3,37,74,25,37,18,37,7,10,11,43,74
1995-05-15 00:00:00.000,ATP Masters Series Rome Italy ATP World Tour,CLAY,2,Goran Ivanisevic,Oscar Martinez,Goran Ivanisevic,7-5; 6-1,R64,67,7,1,22,49,19,22,18,27,0,0,9,37,49,2,2,32,61,20,32,15,29,3,7,10,35,61
1995-05-15 00:00:00.000,ATP Masters Series Rome Italy ATP World Tour,CLAY,2,Vincent Spadea,Carlos Costa,Vincent Spadea,6-4; 6-3,R64,84,1,0,30,59,24,30,17,29,3,4,10,41,59,1,1,45,71,33,45,8,26,6,9,9,41,71
1995-05-15 00:00:00.000,ATP Masters Series Rome Italy ATP World Tour,CLAY,2,Richey Reneberg,Stefano Pescosolido,Richey Reneberg,7-6(2); 7-6(5),R64,117,2,1,39,85,28,39,29,46,6,8,12,57,85,3,3,42,80,28,42,22,38,0,2,12,50,80
1995-05-15 00:00:00.000,ATP Masters Series Rome Italy ATP World Tour,CLAY,2,Andrei Medvedev,Daniel Vacek,Andrei Medvedev,6-1; 6-2,R64,62,3,0,26,46,20,26,10,20,3,4,7,30,46,0,4,26,51,12,26,8,25,2,8,8,20,51
1995-05-15 00:00:00.000,ATP Masters Series Rome Italy ATP World Tour,CLAY,2,Jeff Tarango,Marc Rosset,Jeff Tarango,7-6(4); 6-3,R64,82,5,5,41,62,34,41,12,21,0,1,11,46,62,15,2,46,74,36,46,10,28,4,6,10,46,74
1995-05-15 00:00:00.000,ATP Masters Series Rome Italy ATP World Tour,CLAY,2,Oliver Gross,Petr Korda,Oliver Gross,6-4; 3-6; 6-3,R64,112,1,0,93,119,55,93,14,26,10,13,14,69,119,6,5,50,87,37,50,15,37,6,10,14,52,87
1995-05-15 00:00:00.000,ATP Masters Series Rome Italy ATP World Tour,CLAY,2,Marc-Kevin Goellner,Gilbert Schaller,Marc-Kevin Goellner,6-2; 3-6; 6-3,R64,124,13,5,46,92,36,46,23,46,14,16,13,59,92,0,0,61,86,35,61,14,25,5,9,13,49,86
1995-05-15 00:00:00.000,ATP Masters Series Rome Italy ATP World Tour,CLAY,2,MaliVai Washington,Alberto Berasategui,MaliVai Washington,7-5; 6-2,R64,78,2,2,34,63,26,34,17,29,3,4,10,43,63,0,0,49,66,23,49,12,17,7,11,10,35,66
1995-05-15 00:00:00.000,ATP Masters Series Rome Italy ATP World Tour,CLAY,2,Corrado Borroni,Yevgeny Kafelnikov,Corrado Borroni,3-6; 7-5; 6-3,R64,122,9,7,49,98,35,49,29,49,4,6,15,64,98,5,1,47,97,34,47,26,50,6,9,15,60,97
1995-05-15 00:00:00.000,ATP Masters Series Rome Italy ATP World Tour,CLAY,2,Roberto Carretero,Gianluca Pozzi,Roberto Carretero,6-3; 6-3,R64,67,0,3,49,66,31,49,9,17,4,5,9,40,66,2,1,29,47,20,29,7,18,0,4,9,27,47
1995-05-15 00:00:00.000,ATP Masters Series Rome Italy ATP World Tour,CLAY,2,Marcelo Rios,Emilio Benfele Alvarez,Marcelo Rios,7-5; 6-2,R64,83,2,0,32,53,21,32,14,21,0,2,10,35,53,4,4,40,78,27,40,12,38,10,15,10,39,78
1995-05-15 00:00:00.000,ATP Masters Series Rome Italy ATP World Tour,CLAY,2,Stefan Edberg,Arnaud Boetsch,Stefan Edberg,6-2; 4-6; 6-3,R64,106,1,6,59,87,41,59,13,28,6,10,14,54,87,2,3,50,86,27,50,19,36,7,13,13,46,86
1995-05-15 00:00:00.000,ATP Masters Series Rome Italy ATP World Tour,CLAY,2,Andrea Gaudenzi,Andrei Olhovskiy,Andrea Gaudenzi,6-2; 6-2,R64,66,0,0,34,53,25,34,12,19,3,3,8,37,53,4,3,25,49,12,25,12,24,3,7,8,24,49
1995-05-15 00:00:00.000,ATP Masters Series Rome Italy ATP World Tour,CLAY,2,Alex Corretja,Javier Sanchez,Alex Corretja,6-1; 3-6; 6-3,R64,102,4,0,52,72,40,52,10,20,2,4,13,50,72,3,3,57,86,33,57,16,29,6,10,12,49,86
1995-05-15 00:00:00.000,ATP Masters Series Rome Italy ATP World Tour,CLAY,2,Jaime Yzaga,Alexander Volkov,Jaime Yzaga,6-2; 6-7(6); 6-4,R64,131,2,4,64,107,38,64,27,43,8,12,15,65,107,0,2,47,102,30,47,24,55,8,15,15,54,102
1995-05-15 00:00:00.000,ATP Masters Series Rome Italy ATP World Tour,CLAY,2,Wayne Ferreira,Cedric Pioline,Wayne Ferreira,6-4; 6-1,R64,70,5,3,39,69,26,39,20,30,8,8,9,46,69,3,4,27,50,16,27,11,23,5,8,8,27,50
1995-05-15 00:00:00.000,ATP Masters Series Rome Italy ATP World Tour,CLAY,2,Thomas Muster,Paul Haarhuis,Thomas Muster,6-4; 6-4,R64,70,1,2,38,56,28,38,10,18,1,2,10,38,56,2,2,27,55,24,27,10,28,0,3,10,34,55
1995-05-15 00:00:00.000,ATP Masters Series Rome Italy ATP World Tour,CLAY,2,Jan Siemerink,Marcos Aurelio Gorriz,Jan Siemerink,6-3; 6-2,R64,55,1,2,30,49,25,30,13,19,2,2,9,38,49,1,1,39,46,23,39,4,7,3,6,8,27,46
1995-05-15 00:00:00.000,ATP Masters Series Rome Italy ATP World Tour,CLAY,2,Bohdan Ulihrach,Marcelo Filippini,Bohdan Ulihrach,3-6; 6-2; 6-4,R64,117,4,4,44,89,28,44,17,45,6,12,13,45,89,2,3,53,89,24,53,17,36,5,13,14,41,89
1995-05-15 00:00:00.000,ATP Masters Series Rome Italy ATP World Tour,CLAY,2,Todd Martin,Albert Costa,Todd Martin,7-6(3); 5-7; 6-3,R64,135,12,3,59,103,46,59,23,44,5,7,16,69,103,2,1,90,117,58,90,13,27,3,6,17,71,117
1995-05-15 00:00:00.000,ATP Masters Series Rome Italy ATP World Tour,CLAY,2,Renzo Furlan,Karel Novacek,Renzo Furlan,6-3; 6-2,R64,78,4,0,36,60,24,36,14,24,5,6,9,38,60,3,0,28,58,16,28,14,30,7,11,8,30,58
1995-05-15 00:00:00.000,ATP Masters Series Rome Italy ATP World Tour,CLAY,2,Karol Kucera,Martin Damm,Karol Kucera,4-6; 6-3; 6-3,R64,124,3,7,38,94,23,38,32,56,7,11,14,55,94,5,3,42,89,24,42,22,47,7,13,14,46,89
1995-05-15 00:00:00.000,ATP Masters Series Rome Italy ATP World Tour,CLAY,2,Tomas Carbonell,Martin Sinner,Tomas Carbonell,6-2; 6-4,R64,64,0,5,33,51,23,33,11,18,2,4,9,34,51,0,4,35,60,20,35,9,25,4,9,9,29,60
1995-05-15 00:00:00.000,ATP Masters Series Rome Italy ATP World Tour,CLAY,2,Michael Chang,Mark Philippoussis,Michael Chang,6-4; 6-3,R64,73,5,1,30,56,21,30,14,26,4,7,10,35,56,6,6,28,48,18,28,4,20,4,9,9,22,48
1995-05-15 00:00:00.000,ATP Masters Series Rome Italy ATP World Tour,CLAY,2,Fabrice Santoro,Slava Dosedel,Fabrice Santoro,7-5; 6-7(5); 6-4,R32,175,0,7,70,115,40,70,17,45,9,17,17,57,115,4,3,74,109,40,74,13,35,10,20,17,53,109
1995-05-15 00:00:00.000,ATP Masters Series Rome Italy ATP World Tour,CLAY,2,Jonas Bjorkman,Andrei Chesnokov,Jonas Bjorkman,7-6(5); 6-3,R32,104,3,3,38,77,31,38,15,39,2,5,10,46,77,2,2,53,95,28,53,24,42,9,14,11,52,95
1995-05-15 00:00:00.000,ATP Masters Series Rome Italy ATP World Tour,CLAY,2,Richard Fromberg,Thierry Guardiola,Richard Fromberg,6-3; 7-5,R32,101,8,4,45,74,36,45,14,29,4,5,11,50,74,2,2,33,60,24,33,11,27,0,3,10,35,60
1995-05-15 00:00:00.000,ATP Masters Series Rome Italy ATP World Tour,CLAY,2,Sergi Bruguera,Jacco Eltingh,Sergi Bruguera,6-2; 4-6; 6-4,R32,117,4,3,67,90,44,67,11,23,2,5,14,55,90,8,5,46,90,30,46,19,44,6,11,14,49,90
1995-05-15 00:00:00.000,ATP Masters Series Rome Italy ATP World Tour,CLAY,2,Goran Ivanisevic,Vincent Spadea,Goran Ivanisevic,6-4; 6-3,R32,49,7,4,38,59,30,38,9,21,1,2,9,39,59,4,2,46,65,27,46,8,19,5,9,10,35,65
1995-05-15 00:00:00.000,ATP Masters Series Rome Italy ATP World Tour,CLAY,2,Andrei Medvedev,Richey Reneberg,Andrei Medvedev,6-4; 6-4,R32,72,5,4,27,60,22,27,20,33,3,4,10,42,60,0,3,30,60,21,30,15,30,7,10,10,36,60
1995-05-15 00:00:00.000,ATP Masters Series Rome Italy ATP World Tour,CLAY,2,Jeff Tarango,Oliver Gross,Jeff Tarango,W/O,R32,0,0,0,0,0,0,0,0,0,0,0,0,0,0,0,0,0,0,0,0,0,0,0,0,0,0,0
1995-05-15 00:00:00.000,ATP Masters Series Rome Italy ATP World Tour,CLAY,2,MaliVai Washington,Marc-Kevin Goellner,MaliVai Washington,7-6(5); 6-2,R32,76,9,2,37,58,30,37,9,21,1,3,10,39,58,15,1,43,73,28,43,11,30,2,6,10,39,73
1995-05-15 00:00:00.000,ATP Masters Series Rome Italy ATP World Tour,CLAY,2,Corrado Borroni,Roberto Carretero,Corrado Borroni,7-6(4); 7-6(5),R32,127,7,3,48,96,34,48,31,48,7,8,12,65,96,0,4,68,102,46,68,19,34,10,11,12,65,102
1995-05-15 00:00:00.000,ATP Masters Series Rome Italy ATP World Tour,CLAY,2,Stefan Edberg,Marcelo Rios,Stefan Edberg,6-3; 6-3,R32,72,3,3,29,57,26,29,12,28,2,2,9,38,57,1,0,31,55,19,31,11,24,3,6,9,30,55
1995-05-15 00:00:00.000,ATP Masters Series Rome Italy ATP World Tour,CLAY,2,Alex Corretja,Andrea Gaudenzi,Alex Corretja,3-6; 7-6(2); 6-0,R32,129,4,1,68,85,39,68,10,17,9,14,13,49,85,0,5,47,88,29,47,14,41,5,12,14,43,88
1995-05-15 00:00:00.000,ATP Masters Series Rome Italy ATP World Tour,CLAY,2,Wayne Ferreira,Jaime Yzaga,Wayne Ferreira,6-4; 7-6(3),R32,95,5,0,41,70,29,41,17,29,2,4,11,46,70,1,4,32,70,18,32,22,38,4,7,11,40,70
1995-05-15 00:00:00.000,ATP Masters Series Rome Italy ATP World Tour,CLAY,2,Thomas Muster,Jan Siemerink,Thomas Muster,3-6; 6-4; 6-3,R32,103,3,3,70,89,49,70,9,19,2,4,14,58,89,8,3,56,88,38,56,17,32,5,8,14,55,88
1995-05-15 00:00:00.000,ATP Masters Series Rome Italy ATP World Tour,CLAY,2,Bohdan Ulihrach,Todd Martin,Bohdan Ulihrach,6-4; 3-6; 6-3,R32,103,1,4,48,83,33,48,21,35,1,3,14,54,83,7,1,46,82,33,46,18,36,2,5,14,51,82
1995-05-15 00:00:00.000,ATP Masters Series Rome Italy ATP World Tour,CLAY,2,Karol Kucera,Renzo Furlan,Karol Kucera,7-6(5); 6-1,R32,105,4,1,35,70,21,35,22,35,5,7,9,43,70,1,0,55,85,28,55,14,30,6,11,10,42,85
1995-05-15 00:00:00.000,ATP Masters Series Rome Italy ATP World Tour,CLAY,2,Michael Chang,Tomas Carbonell,Michael Chang,2-6; 6-2; 6-3,R32,95,5,0,42,71,32,42,13,29,3,6,13,45,71,1,2,50,71,31,50,11,21,5,9,12,42,71
1995-05-15 00:00:00.000,ATP Masters Series Rome Italy ATP World Tour,CLAY,2,Jonas Bjorkman,Fabrice Santoro,Jonas Bjorkman,3-6; 7-5; 6-1,R16,127,2,3,50,84,38,50,16,34,3,6,14,54,84,0,4,67,102,36,67,21,35,6,11,14,57,102
1995-05-15 00:00:00.000,ATP Masters Series Rome Italy ATP World Tour,CLAY,2,Sergi Bruguera,Richard Fromberg,Sergi Bruguera,1-6; 6-2; 6-2,R16,87,3,3,37,66,26,37,14,29,3,7,12,40,66,4,4,31,65,22,31,12,34,4,9,11,34,65
1995-05-15 00:00:00.000,ATP Masters Series Rome Italy ATP World Tour,CLAY,2,Goran Ivanisevic,Andrei Medvedev,Goran Ivanisevic,6-1; 7-6(3),R16,71,8,2,26,55,19,26,18,29,0,1,9,37,55,6,1,33,61,21,33,12,28,4,8,10,33,61
1995-05-15 00:00:00.000,ATP Masters Series Rome Italy ATP World Tour,CLAY,2,Jeff Tarango,MaliVai Washington,Jeff Tarango,3-6; 6-3; 6-4,R16,112,5,5,54,97,35,54,25,43,7,9,14,60,97,10,1,55,92,36,55,23,37,7,10,14,59,92
1995-05-15 00:00:00.000,ATP Masters Series Rome Italy ATP World Tour,CLAY,2,Stefan Edberg,Corrado Borroni,Stefan Edberg,6-0; 6-2,R16,58,1,2,33,47,26,33,5,14,1,1,7,31,47,0,1,22,42,14,22,4,20,2,7,7,18,42
1995-05-15 00:00:00.000,ATP Masters Series Rome Italy ATP World Tour,CLAY,2,Wayne Ferreira,Alex Corretja,Wayne Ferreira,6-3; 6-4,R16,85,3,1,34,64,29,34,14,30,3,4,10,43,64,1,0,48,66,28,48,10,18,8,11,9,38,66
1995-05-15 00:00:00.000,ATP Masters Series Rome Italy ATP World Tour,CLAY,2,Thomas Muster,Bohdan Ulihrach,Thomas Muster,6-2; 6-2,R16,61,0,2,22,45,15,22,15,23,1,3,8,30,45,4,5,31,54,19,31,2,23,2,8,8,21,54
1995-05-15 00:00:00.000,ATP Masters Series Rome Italy ATP World Tour,CLAY,2,Michael Chang,Karol Kucera,Michael Chang,6-2; 3-6; 6-4,R16,143,4,0,61,91,41,61,17,30,7,8,13,58,91,6,8,52,107,37,52,27,55,11,14,14,64,107
1995-05-15 00:00:00.000,ATP Masters Series Rome Italy ATP World Tour,CLAY,2,Sergi Bruguera,Jonas Bjorkman,Sergi Bruguera,6-4; 6-1,Q,67,4,3,36,59,30,36,12,23,5,5,9,42,59,0,1,29,58,20,29,11,29,6,9,8,31,58
1995-05-15 00:00:00.000,ATP Masters Series Rome Italy ATP World Tour,CLAY,2,Goran Ivanisevic,Jeff Tarango,Goran Ivanisevic,7-6(2); 6-4,Q,79,16,2,29,61,25,29,20,32,3,4,11,45,61,4,3,48,67,32,48,10,19,2,4,11,42,67
1995-05-15 00:00:00.000,ATP Masters Series Rome Italy ATP World Tour,CLAY,2,Wayne Ferreira,Stefan Edberg,Wayne Ferreira,6-2; 6-0,Q,57,3,6,26,52,20,26,14,26,4,4,7,34,52,0,2,27,42,16,27,1,15,4,9,7,17,42
1995-05-15 00:00:00.000,ATP Masters Series Rome Italy ATP World Tour,CLAY,2,Thomas Muster,Michael Chang,Thomas Muster,6-3; 6-2,Q,71,2,4,27,44,23,27,11,17,2,2,8,34,44,3,5,27,56,16,27,13,29,3,7,9,29,56
1995-05-15 00:00:00.000,ATP Masters Series Rome Italy ATP World Tour,CLAY,2,Sergi Bruguera,Goran Ivanisevic,Sergi Bruguera,6-4; 6-4,S,74,0,4,45,61,30,45,9,16,2,4,10,39,61,7,1,29,58,19,29,14,29,1,5,10,33,58
1995-05-15 00:00:00.000,ATP Masters Series Rome Italy ATP World Tour,CLAY,2,Thomas Muster,Wayne Ferreira,Thomas Muster,3-6; 6-1; 6-3,S,92,1,1,41,59,28,41,14,18,4,6,12,42,59,7,4,41,86,28,41,20,45,7,12,13,48,86
1995-05-15 00:00:00.000,ATP Masters Series Rome Italy ATP World Tour,CLAY,2,Thomas Muster,Sergi Bruguera,Thomas Muster,3-6; 7-6(5); 6-2; 6-3,F,175,6,4,90,134,59,90,21,44,14,19,18,80,134,6,6,75,129,48,75,22,54,10,18,20,70,129
1995-05-15 00:00:00.000,Coral Springs FL; U.S.A. ATP World Tour,CLAY,2,Ivan Baron,Magnus Larsson,Ivan Baron,7-6(5); 6-3,R32,82,2,2,54,73,41,54,13,19,3,3,11,54,73,11,3,43,67,33,43,12,24,0,1,10,45,67
1995-05-15 00:00:00.000,Coral Springs FL; U.S.A. ATP World Tour,CLAY,2,Nicolas Pereira,Jaime Oncins,Nicolas Pereira,6-4; 6-4,R32,85,2,4,38,71,31,38,15,33,3,4,10,46,71,1,4,42,63,28,42,11,21,3,6,10,39,63
1995-05-15 00:00:00.000,Coral Springs FL; U.S.A. ATP World Tour,CLAY,2,Michael Tebbutt,Lionel Roux,Michael Tebbutt,7-5; 6-3,R32,80,7,2,38,54,29,38,13,16,0,1,11,42,54,1,5,40,77,27,40,17,37,2,5,10,44,77
1995-05-15 00:00:00.000,Coral Springs FL; U.S.A. ATP World Tour,CLAY,2,Javier Frana,Tommy Ho,Javier Frana,6-4; 6-2,R32,68,7,0,34,55,25,34,14,21,2,2,9,39,55,6,2,29,54,21,29,13,25,4,7,9,34,54
1995-05-15 00:00:00.000,Coral Springs FL; U.S.A. ATP World Tour,CLAY,2,David Wheaton,Jamie Morgan,David Wheaton,6-3; 6-3,R32,70,8,2,38,57,29,38,11,19,2,2,9,40,57,7,1,28,50,18,28,12,22,3,6,9,30,50
1995-05-15 00:00:00.000,Coral Springs FL; U.S.A. ATP World Tour,CLAY,2,Hernan Gumy,Jordi Arrese,Hernan Gumy,6-2; 6-2,R32,59,2,2,22,40,19,22,14,18,1,1,8,33,40,0,0,40,49,20,40,4,9,1,5,8,24,49
1995-05-15 00:00:00.000,Coral Springs FL; U.S.A. ATP World Tour,CLAY,2,Luke Jensen,Bryan Shelton,Luke Jensen,4-6; 6-4; 7-6(7),R32,123,8,4,64,105,42,64,25,41,4,8,16,67,105,9,8,47,94,39,47,23,47,5,9,16,62,94
1995-05-15 00:00:00.000,Coral Springs FL; U.S.A. ATP World Tour,CLAY,2,Greg Rusedski,Alex O'Brien,Greg Rusedski,6-4; 6-4,R32,72,10,4,30,56,28,30,13,26,2,3,10,41,56,3,5,37,64,28,37,11,27,2,5,10,39,64
1995-05-15 00:00:00.000,Coral Springs FL; U.S.A. ATP World Tour,CLAY,2,Brett Steven,Patrick McEnroe,Brett Steven,3-6; 7-6(5); 6-0,R32,129,4,1,58,91,38,58,17,33,3,7,13,55,91,3,7,56,94,37,56,14,38,7,12,13,51,94
1995-05-15 00:00:00.000,Coral Springs FL; U.S.A. ATP World Tour,CLAY,2,Sandon Stolle,Andrew Sznajder,Sandon Stolle,3-6; 6-3; 6-4,R32,107,9,5,60,92,41,60,16,32,3,6,14,57,92,10,8,50,85,36,50,14,35,3,7,14,50,85
1995-05-15 00:00:00.000,Coral Springs FL; U.S.A. ATP World Tour,CLAY,2,Jakob Hlasek,Robbie Weiss,Jakob Hlasek,6-7(3); 6-4; 6-2,R32,123,11,3,60,104,45,60,21,44,8,10,15,66,104,3,3,52,92,35,52,21,40,2,7,15,56,92
1995-05-15 00:00:00.000,Coral Springs FL; U.S.A. ATP World Tour,CLAY,2,Mark Woodforde,Mauricio Hadad,Mark Woodforde,6-7(5); 6-1; 6-4,R32,101,5,1,46,80,39,46,25,34,0,0,15,64,80,0,2,58,82,42,58,14,24,2,5,14,56,82
1995-05-15 00:00:00.000,Coral Springs FL; U.S.A. ATP World Tour,CLAY,2,Jonathan Stark,Gaston Etlis,Jonathan Stark,7-6(6); 3-6; 6-3,R32,141,18,1,69,118,52,69,23,49,11,13,15,75,118,12,3,50,93,37,50,26,43,1,3,15,63,93
1995-05-15 00:00:00.000,Coral Springs FL; U.S.A. ATP World Tour,CLAY,2,Todd Woodbridge,Guillaume Raoux,Todd Woodbridge,6-4; 6-1,R32,63,2,2,37,52,28,37,9,15,6,6,8,37,52,3,1,26,54,16,26,10,28,2,6,9,26,54
1995-05-15 00:00:00.000,Coral Springs FL; U.S.A. ATP World Tour,CLAY,2,Emilio Sanchez,Fernando Meligeni,Emilio Sanchez,7-6(5); 6-3,R32,97,1,0,41,64,26,41,13,23,0,2,10,39,64,4,3,36,76,23,36,20,40,2,6,11,43,76
1995-05-15 00:00:00.000,Coral Springs FL; U.S.A. ATP World Tour,CLAY,2,Thomas Enqvist,Radomir Vasek,Thomas Enqvist,6-2; 6-2,R32,57,0,2,32,45,23,32,5,13,1,3,8,28,45,2,4,32,54,16,32,7,22,9,15,8,23,54
1995-05-15 00:00:00.000,Coral Springs FL; U.S.A. ATP World Tour,CLAY,2,Nicolas Pereira,Ivan Baron,Nicolas Pereira,6-4; 6-4,R16,83,14,0,46,65,35,46,11,19,1,1,10,46,65,0,0,39,53,27,39,8,14,0,2,10,35,53
1995-05-15 00:00:00.000,Coral Springs FL; U.S.A. ATP World Tour,CLAY,2,Javier Frana,Michael Tebbutt,Javier Frana,6-4; 6-4,R16,66,1,0,31,53,24,31,12,22,0,1,10,36,53,4,6,28,51,23,28,8,23,1,4,10,31,51
1995-05-15 00:00:00.000,Coral Springs FL; U.S.A. ATP World Tour,CLAY,2,Hernan Gumy,David Wheaton,Hernan Gumy,6-3; 7-6(5),R16,110,7,0,41,56,32,41,10,15,0,1,10,42,56,4,5,60,92,37,60,15,32,8,11,11,52,92
1995-05-15 00:00:00.000,Coral Springs FL; U.S.A. ATP World Tour,CLAY,2,Greg Rusedski,Luke Jensen,Greg Rusedski,6-1; 6-2,R16,51,9,2,17,32,15,17,13,15,0,0,7,28,32,0,2,35,55,16,35,8,20,3,8,8,24,55
1995-05-15 00:00:00.000,Coral Springs FL; U.S.A. ATP World Tour,CLAY,2,Brett Steven,Sandon Stolle,Brett Steven,6-2; 6-2,R16,65,1,1,38,52,29,38,8,14,4,4,8,37,52,2,1,30,52,19,30,8,22,1,5,8,27,52
1995-05-15 00:00:00.000,Coral Springs FL; U.S.A. ATP World Tour,CLAY,2,Mark Woodforde,Jakob Hlasek,Mark Woodforde,6-1; 6-2,R16,61,3,2,27,47,21,27,14,20,3,3,8,35,47,4,2,36,54,20,36,7,18,9,13,7,27,54
1995-05-15 00:00:00.000,Coral Springs FL; U.S.A. ATP World Tour,CLAY,2,Todd Woodbridge,Jonathan Stark,Todd Woodbridge,6-3; 6-3,R16,84,0,1,32,46,27,32,10,14,2,2,9,37,46,7,3,53,81,33,53,13,28,6,9,9,46,81
1995-05-15 00:00:00.000,Coral Springs FL; U.S.A. ATP World Tour,CLAY,2,Thomas Enqvist,Emilio Sanchez,Thomas Enqvist,6-1; 7-6(5),R16,85,6,4,42,64,33,42,9,22,2,3,9,42,64,8,0,55,78,31,55,11,23,10,14,10,42,78
1995-05-15 00:00:00.000,Coral Springs FL; U.S.A. ATP World Tour,CLAY,2,Javier Frana,Nicolas Pereira,Javier Frana,4-6; 7-6(8); 7-6(5),Q,165,9,0,95,132,65,95,22,37,4,5,17,87,132,9,4,79,138,57,79,34,59,4,4,17,91,138
1995-05-15 00:00:00.000,Coral Springs FL; U.S.A. ATP World Tour,CLAY,2,Greg Rusedski,Hernan Gumy,Greg Rusedski,7-6(7); 6-4,Q,85,9,6,34,68,32,34,18,34,0,0,11,50,68,1,3,52,73,34,52,16,21,3,4,11,50,73
1995-05-15 00:00:00.000,Coral Springs FL; U.S.A. ATP World Tour,CLAY,2,Mark Woodforde,Brett Steven,Mark Woodforde,3-6; 7-6(3); 7-6(7),Q,155,13,3,55,95,36,55,29,40,1,5,16,65,95,10,3,82,124,57,82,24,42,9,12,17,81,124
1995-05-15 00:00:00.000,Coral Springs FL; U.S.A. ATP World Tour,CLAY,2,Todd Woodbridge,Thomas Enqvist,Todd Woodbridge,4-3 RET,Q,27,4,1,12,22,10,12,4,10,0,1,4,14,22,0,1,16,20,11,16,1,4,1,2,4,12,20
1995-05-15 00:00:00.000,Coral Springs FL; U.S.A. ATP World Tour,CLAY,2,Greg Rusedski,Javier Frana,Greg Rusedski,7-6(6); 6-4,S,90,6,8,29,79,26,29,26,50,3,4,11,52,79,4,0,44,71,29,44,16,27,5,7,11,45,71
1995-05-15 00:00:00.000,Coral Springs FL; U.S.A. ATP World Tour,CLAY,2,Todd Woodbridge,Mark Woodforde,Todd Woodbridge,1-6; 7-5; 7-5,S,126,0,3,55,99,31,55,27,44,9,13,15,58,99,1,1,59,90,40,59,18,31,10,14,16,58,90
1995-05-15 00:00:00.000,Coral Springs FL; U.S.A. ATP World Tour,CLAY,2,Todd Woodbridge,Greg Rusedski,Todd Woodbridge,6-4; 6-2,F,65,1,3,38,51,32,38,6,13,2,2,9,38,51,3,2,29,54,20,29,10,25,2,5,9,30,54
1995-05-22 00:00:00.000,Bologna Italy ATP World Tour,CLAY,2,Gilbert Schaller,Cristiano Caratti,Gilbert Schaller,6-3; 6-3,R32,69,0,0,49,57,30,49,3,8,2,5,9,33,57,1,4,36,51,18,36,2,15,2,8,9,20,51
1995-05-22 00:00:00.000,Bologna Italy ATP World Tour,CLAY,2,Mats Wilander,Jeremy Bates,Mats Wilander,6-0; 3-6; 7-5,R32,121,1,4,68,85,46,68,7,17,7,10,13,53,85,3,3,49,88,29,49,19,39,7,13,14,48,88
1995-05-22 00:00:00.000,Bologna Italy ATP World Tour,CLAY,2,Marcelo Rios,Byron Black,Marcelo Rios,5-7; 6-3; 6-0,R32,114,4,2,74,100,43,74,14,26,8,12,13,57,100,3,3,49,87,27,49,14,38,3,11,14,41,87
1995-05-22 00:00:00.000,Bologna Italy ATP World Tour,CLAY,2,Renzo Furlan,Christian Ruud,Renzo Furlan,6-4; 6-4,R32,89,2,0,22,53,19,22,17,31,1,3,10,36,53,3,4,28,61,20,28,14,33,3,7,10,34,61
1995-05-22 00:00:00.000,Bologna Italy ATP World Tour,CLAY,2,Mark Philippoussis,Francisco Clavet,Mark Philippoussis,6-4; 6-2,R32,73,7,1,26,55,23,26,16,29,4,4,9,39,55,0,0,32,50,19,32,11,18,2,5,9,30,50
1995-05-22 00:00:00.000,Bologna Italy ATP World Tour,CLAY,2,Tomas Carbonell,Luis Adrian Morejon,Tomas Carbonell,5-7; 6-4; 6-1,R32,116,6,5,62,96,45,62,12,34,4,8,15,57,96,0,2,72,99,42,72,9,27,7,13,14,51,99
1995-05-22 00:00:00.000,Bologna Italy ATP World Tour,CLAY,2,Karim Alami,Omar Camporese,Karim Alami,6-3; 3-6; 6-1,R32,110,2,3,41,81,29,41,17,40,3,7,13,46,81,2,2,33,72,17,33,20,39,5,11,12,37,72
1995-05-22 00:00:00.000,Bologna Italy ATP World Tour,CLAY,2,Arnaud Boetsch,Jeff Tarango,Arnaud Boetsch,6-3; 6-3,R32,71,2,2,29,50,21,29,14,21,3,4,9,35,50,1,4,35,64,25,35,8,29,9,13,9,33,64
1995-05-22 00:00:00.000,Bologna Italy ATP World Tour,CLAY,2,Massimo Calvelli,Vincent Spadea,Massimo Calvelli,2-6; 6-4; 7-5,R32,117,1,2,56,94,35,56,23,38,2,6,15,58,94,5,4,60,91,42,60,14,31,5,9,15,56,91
1995-05-22 00:00:00.000,Bologna Italy ATP World Tour,CLAY,2,Jordi Burillo,Paolo Cane,Jordi Burillo,6-0; 6-1,R32,42,4,1,18,35,16,18,12,17,0,0,7,28,35,4,1,20,44,10,20,9,24,4,9,6,19,44
1995-05-22 00:00:00.000,Bologna Italy ATP World Tour,CLAY,2,Kenneth Carlsen,Anders Jarryd,Kenneth Carlsen,6-4; 6-7(4); 7-5,R32,153,7,2,62,107,45,62,33,45,2,3,17,78,107,4,2,61,109,47,61,24,48,5,8,17,71,109
1995-05-22 00:00:00.000,Bologna Italy ATP World Tour,CLAY,2,Javier Sanchez,Carl-Uwe Steeb,Javier Sanchez,6-3; 6-3,R32,66,3,0,42,52,28,42,7,10,1,2,9,35,52,0,3,25,52,17,25,9,27,1,5,9,26,52
1995-05-22 00:00:00.000,Bologna Italy ATP World Tour,CLAY,2,Slava Dosedel,Alejo Mancisidor,Slava Dosedel,6-2; 6-1,R32,66,2,4,26,49,22,26,13,23,2,2,8,35,49,1,4,30,45,17,30,4,15,6,10,7,21,45
1995-05-22 00:00:00.000,Bologna Italy ATP World Tour,CLAY,2,Pietro Pennisi,Oscar Martinez,Pietro Pennisi,6-0; 6-1,R32,45,1,0,12,29,11,12,13,17,0,0,6,24,29,0,4,21,42,8,21,6,21,1,7,7,14,42
1995-05-22 00:00:00.000,Bologna Italy ATP World Tour,CLAY,2,Jonathan Stark,Bryan Shelton,Jonathan Stark,6-1; 7-6(4),R32,78,15,3,38,59,33,38,9,21,2,3,10,42,59,4,2,34,61,21,34,13,27,4,7,9,34,61
1995-05-22 00:00:00.000,Bologna Italy ATP World Tour,CLAY,2,Marcelo Filippini,Richard Fromberg,Marcelo Filippini,7-6(6); 6-4,R32,110,2,1,51,71,36,51,9,20,5,8,11,45,71,1,1,43,78,27,43,16,35,5,9,11,43,78
1995-05-22 00:00:00.000,Bologna Italy ATP World Tour,CLAY,2,Gilbert Schaller,Mats Wilander,Gilbert Schaller,6-4; 6-1,R16,85,0,0,35,51,22,35,10,16,4,6,8,32,51,0,1,41,54,20,41,4,13,5,11,9,24,54
1995-05-22 00:00:00.000,Bologna Italy ATP World Tour,CLAY,2,Marcelo Rios,Renzo Furlan,Marcelo Rios,6-4; 7-6(6),R16,106,2,0,53,78,40,53,12,25,5,6,11,52,78,4,1,46,78,31,46,16,32,3,5,11,47,78
1995-05-22 00:00:00.000,Bologna Italy ATP World Tour,CLAY,2,Mark Philippoussis,Tomas Carbonell,Mark Philippoussis,6-4; 7-6(1),R16,86,4,1,44,68,26,44,11,24,4,9,11,37,68,4,2,59,74,30,59,6,15,7,13,11,36,74
1995-05-22 00:00:00.000,Bologna Italy ATP World Tour,CLAY,2,Karim Alami,Arnaud Boetsch,Karim Alami,6-4; 7-5,R16,97,5,1,28,66,22,28,23,38,4,5,11,45,66,6,5,45,83,27,45,20,38,10,13,11,47,83
1995-05-22 00:00:00.000,Bologna Italy ATP World Tour,CLAY,2,Jordi Burillo,Massimo Calvelli,Jordi Burillo,6-2; 6-7(5); 6-3,R16,110,11,4,42,79,33,42,22,37,2,5,15,55,79,5,2,53,106,26,53,27,53,11,17,14,53,106
1995-05-22 00:00:00.000,Bologna Italy ATP World Tour,CLAY,2,Javier Sanchez,Kenneth Carlsen,Javier Sanchez,6-3; 6-2,R16,70,2,0,33,47,28,33,7,14,2,3,9,35,47,3,1,38,62,23,38,10,24,6,10,8,33,62
1995-05-22 00:00:00.000,Bologna Italy ATP World Tour,CLAY,2,Slava Dosedel,Pietro Pennisi,Slava Dosedel,6-0; 6-2,R16,56,2,0,34,42,20,34,6,8,3,5,7,26,42,1,2,24,49,10,24,7,25,6,13,7,17,49
1995-05-22 00:00:00.000,Bologna Italy ATP World Tour,CLAY,2,Marcelo Filippini,Jonathan Stark,Marcelo Filippini,7-5; 6-3,R16,81,0,0,31,47,24,31,14,16,1,2,10,38,47,6,1,42,70,26,42,12,28,4,8,11,38,70
1995-05-22 00:00:00.000,Bologna Italy ATP World Tour,CLAY,2,Marcelo Rios,Gilbert Schaller,Marcelo Rios,6-1; 3-6; 6-2,Q,105,3,1,52,81,35,52,14,29,6,9,12,49,81,1,0,64,82,33,64,9,18,8,14,12,42,82
1995-05-22 00:00:00.000,Bologna Italy ATP World Tour,CLAY,2,Mark Philippoussis,Karim Alami,Mark Philippoussis,7-6(9); 3-6; 6-2,Q,136,10,3,66,106,48,66,19,40,7,9,14,67,106,5,4,56,106,39,56,28,50,4,7,15,67,106
1995-05-22 00:00:00.000,Bologna Italy ATP World Tour,CLAY,2,Javier Sanchez,Jordi Burillo,Javier Sanchez,6-4; 6-3,Q,74,1,0,47,64,30,47,12,17,3,4,10,42,64,8,1,36,67,23,36,16,31,6,9,10,39,67
1995-05-22 00:00:00.000,Bologna Italy ATP World Tour,CLAY,2,Marcelo Filippini,Slava Dosedel,Marcelo Filippini,6-1; 6-3(2),Q,110,1,1,55,77,37,55,10,22,4,7,11,47,77,3,1,52,70,32,52,6,18,2,6,11,38,70
1995-05-22 00:00:00.000,Bologna Italy ATP World Tour,CLAY,2,Marcelo Rios,Mark Philippoussis,Marcelo Rios,6-4; 7-6(6),S,88,2,0,52,68,39,52,10,16,3,4,11,49,68,4,2,48,71,31,48,17,23,3,5,11,48,71
1995-05-22 00:00:00.000,Bologna Italy ATP World Tour,CLAY,2,Marcelo Filippini,Javier Sanchez,Marcelo Filippini,7-6(5); 2-6; 6-4,S,143,1,0,96,120,52,96,15,24,8,13,15,67,120,1,5,77,105,49,77,10,28,5,9,15,59,105
1995-05-22 00:00:00.000,Bologna Italy ATP World Tour,CLAY,2,Marcelo Rios,Marcelo Filippini,Marcelo Rios,6-2; 6-4,F,74,3,1,30,55,22,30,13,25,2,4,9,35,55,2,0,35,60,18,35,9,25,3,8,9,27,60
1995-05-29 00:00:00.000,Roland Garros France Grand Slams,CLAY,3,Andre Agassi,Karsten Braasch,Andre Agassi,6-1; 6-4; 6-4,R128,21,3,1,56,80,45,56,14,24,2,3,14,59,80,13,3,71,98,47,71,13,27,8,13,13,60,98
1995-05-29 00:00:00.000,Roland Garros France Grand Slams,CLAY,3,Todd Woodbridge,Marcelo Filippini,Todd Woodbridge,6-3; 4-6; 6-4; 1-6; 6-4,R128,18,0,8,96,162,65,96,24,66,11,18,23,89,162,1,1,106,140,65,106,18,34,7,14,23,83,140
1995-05-29 00:00:00.000,Roland Garros France Grand Slams,CLAY,3,Francisco Clavet,Gianluca Pozzi,Francisco Clavet,6-2; 6-3; 4-6; 6-3,R128,14,3,2,90,134,57,90,20,44,8,13,18,77,134,2,3,59,110,35,59,17,51,7,16,18,52,110
1995-05-29 00:00:00.000,Roland Garros France Grand Slams,CLAY,3,Thierry Champion,Tommy Ho,Thierry Champion,4-6; 6-1; 3-6; 6-2; 7-5,R128,25,9,1,98,143,72,98,24,45,2,6,23,96,143,8,2,90,162,68,90,30,72,7,14,23,98,162
1995-05-29 00:00:00.000,Roland Garros France Grand Slams,CLAY,3,Patrick McEnroe,Thomas Johansson,Patrick McEnroe,6-3; 6-2; 7-5,R128,6,7,1,68,114,49,68,25,46,12,13,15,74,114,2,4,73,110,44,73,14,37,14,19,14,58,110
1995-05-29 00:00:00.000,Roland Garros France Grand Slams,CLAY,3,Younes El Aynaoui,Alex Lopez Moron,Younes El Aynaoui,7-5; 6-3; 6-3,R128,19,9,4,58,112,45,58,24,54,6,9,15,69,112,3,3,63,98,41,63,12,35,4,11,15,53,98
1995-05-29 00:00:00.000,Roland Garros France Grand Slams,CLAY,3,Andrew Ilie,Cristiano Caratti,Andrew Ilie,3-6; 2-6; 7-6(6); 6-2; 6-4,R128,0,3,6,106,178,57,106,35,72,13,23,24,92,178,0,6,91,146,58,91,21,55,6,15,23,79,146
1995-05-29 00:00:00.000,Roland Garros France Grand Slams,CLAY,3,Richard Krajicek,Martin Sinner,Richard Krajicek,6-4; 6-3; 6-3,R128,9,19,4,76,110,60,76,13,34,5,8,14,73,110,4,6,58,99,40,58,9,41,3,10,14,49,99
1995-05-29 00:00:00.000,Roland Garros France Grand Slams,CLAY,3,Yevgeny Kafelnikov,Jan Siemerink,Yevgeny Kafelnikov,6-1; 6-2; 6-7(3); 6-3,R128,7,4,2,59,121,45,59,39,62,4,6,19,84,121,11,3,83,128,54,83,20,45,6,13,17,74,128
1995-05-29 00:00:00.000,Roland Garros France Grand Slams,CLAY,3,Magnus Gustafsson,David Prinosil,Magnus Gustafsson,5-7; 6-1; 6-2; 6-1,R128,9,2,3,71,108,51,71,21,37,1,3,17,72,108,9,11,71,136,50,71,16,65,9,17,17,66,136
1995-05-29 00:00:00.000,Roland Garros France Grand Slams,CLAY,3,David Wheaton,Paul Haarhuis,David Wheaton,6-3; 4-6; 6-4; 6-4,R128,10,9,2,100,143,65,100,25,43,8,13,20,90,143,6,1,87,133,52,87,25,46,16,23,19,77,133
1995-05-29 00:00:00.000,Roland Garros France Grand Slams,CLAY,3,Emilio Sanchez,Jamie Morgan,Emilio Sanchez,6-1; 6-4; 6-2,R128,5,3,2,61,87,48,61,14,26,3,3,13,62,87,9,6,42,78,29,42,15,36,1,6,12,44,78
1995-05-29 00:00:00.000,Roland Garros France Grand Slams,CLAY,3,Guy Forget,Wojtek Kowalski,Guy Forget,6-4; 5-7; 6-7(8); 6-2; 6-4,R128,13,15,3,111,193,79,111,43,82,9,16,26,122,193,6,2,118,187,72,118,34,69,11,21,26,106,187
1995-05-29 00:00:00.000,Roland Garros France Grand Slams,CLAY,3,Alex Corretja,Jerome Golmard,Alex Corretja,6-4; 7-5; 6-0,R128,6,3,0,57,84,44,57,16,27,2,3,14,60,84,3,3,49,88,33,49,14,39,4,10,14,47,88
1995-05-29 00:00:00.000,Roland Garros France Grand Slams,CLAY,3,Mats Wilander,Derrick Rostagno,Mats Wilander,7-5; 7-5; 6-4,R128,33,4,2,79,113,55,79,16,34,3,7,17,71,113,10,5,98,157,64,98,22,59,13,20,17,86,157
1995-05-29 00:00:00.000,Roland Garros France Grand Slams,CLAY,3,Wayne Ferreira,Lionel Roux,Wayne Ferreira,6-4; 6-4; 7-5,R128,6,9,5,61,115,48,61,26,54,6,8,16,74,115,4,2,56,89,43,56,13,33,4,9,16,56,89
1995-05-29 00:00:00.000,Roland Garros France Grand Slams,CLAY,3,Mikael Tillstrom,Goran Ivanisevic,Mikael Tillstrom,7-5; 6-3; 6-4,R128,7,6,2,70,116,54,70,27,46,6,6,16,81,116,13,2,66,105,55,66,17,39,3,6,15,72,105
1995-05-29 00:00:00.000,Roland Garros France Grand Slams,CLAY,3,Bernd Karbacher,Daniel Courcol,Bernd Karbacher,6-2; 6-4; 6-7(4); 6-3,R128,21,14,2,83,140,67,83,30,57,6,9,20,97,140,8,4,78,143,57,78,27,65,6,13,19,84,143
1995-05-29 00:00:00.000,Roland Garros France Grand Slams,CLAY,3,Guillaume Raoux,Jeremy Bates,Guillaume Raoux,6-3; 6-0; 0-6; 7-5,R128,7,7,6,64,131,47,64,27,67,6,11,16,74,131,3,3,56,105,28,56,25,49,9,17,17,53,105
1995-05-29 00:00:00.000,Roland Garros France Grand Slams,CLAY,3,Albert Costa,Joern Renzenbrink,Albert Costa,6-3; 6-4; 6-0,R128,4,6,0,64,80,51,64,11,16,2,2,13,62,80,4,11,67,127,48,67,14,60,14,19,12,62,127
1995-05-29 00:00:00.000,Roland Garros France Grand Slams,CLAY,3,Donald Johnson,Radomir Vasek,Donald Johnson,6-4; 6-3; 6-1,R128,7,4,1,45,77,32,45,18,32,0,2,13,50,77,1,7,52,98,32,52,14,46,7,14,13,46,98
1995-05-29 00:00:00.000,Roland Garros France Grand Slams,CLAY,3,Christian Ruud,Lionel Barthez,Christian Ruud,4-6; 6-3; 6-3; 7-6(3),R128,0,7,6,78,130,49,78,26,52,8,16,20,75,130,5,8,85,171,57,85,26,86,15,25,20,83,171
1995-05-29 00:00:00.000,Roland Garros France Grand Slams,CLAY,3,Kenneth Carlsen,Markus Zoecke,Kenneth Carlsen,6-2; 3-6; 6-3; 6-2,R128,10,13,3,81,110,66,81,19,29,5,6,17,85,110,7,2,84,107,57,84,8,23,1,6,17,65,107
1995-05-29 00:00:00.000,Roland Garros France Grand Slams,CLAY,3,Jim Courier,Jeff Tarango,Jim Courier,6-4; 6-3; 6-3,R128,5,13,6,58,102,51,58,20,44,3,5,14,71,102,4,3,62,99,40,62,14,37,7,13,14,54,99
1995-05-29 00:00:00.000,Roland Garros France Grand Slams,CLAY,3,Alberto Berasategui,Andrei Olhovskiy,Alberto Berasategui,2-6; 6-4; 6-2; 7-5,R128,11,0,4,83,126,58,83,17,43,3,8,19,75,126,12,8,80,149,56,80,27,69,10,17,19,83,149
1995-05-29 00:00:00.000,Roland Garros France Grand Slams,CLAY,3,Marcelo Rios,Vincent Spadea,Marcelo Rios,6-4; 6-4; 6-7(8); 6-3,R128,11,4,6,97,162,66,97,34,65,6,10,21,100,162,3,3,76,149,53,76,33,73,13,20,20,86,149
1995-05-29 00:00:00.000,Roland Garros France Grand Slams,CLAY,3,Andrei Medvedev,Frederic Vitoux,Andrei Medvedev,6-2; 6-1; 6-1,R128,4,1,0,24,57,21,24,22,33,0,1,11,43,57,1,8,48,84,24,48,9,36,9,17,11,33,84
1995-05-29 00:00:00.000,Roland Garros France Grand Slams,CLAY,3,MaliVai Washington,Jason Stoltenberg,MaliVai Washington,6-4; 3-6; 7-6(2); 6-1,R128,6,8,2,90,137,64,90,24,47,6,10,18,88,137,3,1,77,134,48,77,27,57,9,16,20,75,134
1995-05-29 00:00:00.000,Roland Garros France Grand Slams,CLAY,3,Bohdan Ulihrach,Alexander Volkov,Bohdan Ulihrach,6-0; 6-3; 6-1,R128,3,1,1,37,70,26,37,23,33,3,3,11,49,70,2,6,32,70,19,32,10,38,2,9,11,29,70
1995-05-29 00:00:00.000,Roland Garros France Grand Slams,CLAY,3,Carlos Costa,Jaime Yzaga,Carlos Costa,4-6; 6-1; 6-2; 6-2,R128,5,9,1,88,112,63,88,13,24,4,7,17,76,112,0,5,82,119,44,82,11,37,9,17,16,55,119
1995-05-29 00:00:00.000,Roland Garros France Grand Slams,CLAY,3,Cedric Pioline,Karel Novacek,Cedric Pioline,6-1; 3-6; 6-3; 6-4,R128,5,7,4,66,110,57,66,23,44,2,3,18,80,110,4,1,78,119,56,78,16,41,8,12,17,72,119
1995-05-29 00:00:00.000,Roland Garros France Grand Slams,CLAY,3,Thomas Muster,Gerard Solves,Thomas Muster,3-6; 6-4; 6-2; 6-1,R128,5,6,2,62,104,48,62,21,42,4,8,17,69,104,4,3,77,112,45,77,11,35,11,19,17,56,112
1995-05-29 00:00:00.000,Roland Garros France Grand Slams,CLAY,3,Michael Chang,Diego Nargiso,Michael Chang,6-3; 6-4; 6-1,R128,4,5,2,54,92,41,54,17,38,6,9,13,58,92,4,6,33,82,22,33,13,49,5,13,13,35,82
1995-05-29 00:00:00.000,Roland Garros France Grand Slams,CLAY,3,Daniel Vacek,Oscar Martinez,Daniel Vacek,6-1; 6-3; 6-0,R128,2,5,5,51,78,43,51,10,27,4,4,11,53,78,3,5,61,83,31,61,5,22,6,13,11,36,83
1995-05-29 00:00:00.000,Roland Garros France Grand Slams,CLAY,3,Frederik Fetterlein,Bryan Shelton,Frederik Fetterlein,3-6; 4-6; 6-3; 6-2; 6-4,R128,3,6,13,107,175,75,107,27,68,4,7,23,102,175,10,12,108,192,77,108,33,84,14,19,23,110,192
1995-05-29 00:00:00.000,Roland Garros France Grand Slams,CLAY,3,Tomas Carbonell,Rodolphe Gilbert,Tomas Carbonell,6-2; 5-7; 6-2; 7-6(3),R128,4,1,6,113,141,74,113,10,28,8,13,20,84,141,1,2,75,144,44,75,32,69,7,15,20,76,144
1995-05-29 00:00:00.000,Roland Garros France Grand Slams,CLAY,3,Javier Sanchez,Sebastien Lareau,Javier Sanchez,6-4; 6-4; 6-3,R128,2,0,4,53,82,40,53,16,29,3,4,14,56,82,0,9,47,108,33,47,24,61,10,15,15,57,108
1995-05-29 00:00:00.000,Roland Garros France Grand Slams,CLAY,3,Arnaud Boetsch,Thomas Enqvist,Arnaud Boetsch,6-4; 6-3; 6-2,R128,3,5,6,45,98,38,45,28,53,3,3,14,66,98,5,5,66,125,45,66,24,59,15,19,13,69,125
1995-05-29 00:00:00.000,Roland Garros France Grand Slams,CLAY,3,Stefan Edberg,Fabrice Santoro,Stefan Edberg,6-2; 6-0; 6-2,R128,4,2,1,32,61,30,32,18,29,1,1,11,48,61,1,0,41,67,18,41,14,26,9,16,11,32,67
1995-05-29 00:00:00.000,Roland Garros France Grand Slams,CLAY,3,Michael Stich,Martin Damm,Michael Stich,7-6(6); 5-7; 7-6(4); 6-4,R128,5,11,4,110,166,79,110,30,56,7,12,23,109,166,3,2,113,165,73,113,26,52,5,10,23,99,165
1995-05-29 00:00:00.000,Roland Garros France Grand Slams,CLAY,3,Todd Martin,Michael Tebbutt,Todd Martin,6-2; 6-1; 7-6(4),R128,0,10,2,57,91,51,57,19,34,3,3,13,70,91,8,11,43,108,36,43,23,65,3,8,14,59,108
1995-05-29 00:00:00.000,Roland Garros France Grand Slams,CLAY,3,Slava Dosedel,Olivier Mutis,Slava Dosedel,6-7(6); 7-5; 5-7; 7-6(4); 8-6,R128,15,4,6,165,223,103,165,26,58,12,21,31,129,223,8,10,137,226,85,137,40,89,9,19,31,125,226
1995-05-29 00:00:00.000,Roland Garros France Grand Slams,CLAY,3,Andrei Chesnokov,Aaron Krickstein,Andrei Chesnokov,6-1; 6-4; 6-4,R128,3,3,1,54,78,37,54,17,24,1,3,13,54,78,2,1,80,117,42,80,17,37,10,17,14,59,117
1995-05-29 00:00:00.000,Roland Garros France Grand Slams,CLAY,3,Thierry Guardiola,Paul Wekesa,Thierry Guardiola,6-2; 1-0 RET,R128,1,2,2,27,37,19,27,5,10,1,1,5,24,37,0,1,25,32,10,25,5,7,5,7,5,15,32
1995-05-29 00:00:00.000,Roland Garros France Grand Slams,CLAY,3,Adrian Voinea,Karol Kucera,Adrian Voinea,6-2; 6-2; 6-3,R128,2,6,3,53,88,41,53,20,35,7,7,12,61,88,1,5,50,98,28,50,22,48,6,12,13,50,98
1995-05-29 00:00:00.000,Roland Garros France Grand Slams,CLAY,3,Johan Van Herck,Olivier Delaitre,Johan Van Herck,6-1; 6-4; 7-6(4),R128,2,6,1,64,108,48,64,27,44,6,7,15,75,108,4,6,52,106,39,52,24,54,2,6,14,63,106
1995-05-29 00:00:00.000,Roland Garros France Grand Slams,CLAY,3,Jared Palmer,Jakob Hlasek,Jared Palmer,4-6; 3-6; 7-6(8); 6-4; 8-6,R128,10,4,4,141,205,83,141,31,64,12,22,28,114,205,10,9,137,208,95,137,22,71,9,18,27,117,208
1995-05-29 00:00:00.000,Roland Garros France Grand Slams,CLAY,3,Boris Becker,Javier Frana,Boris Becker,7-6(6); 6-4; 6-3,R128,0,9,4,56,102,46,56,23,46,2,4,15,69,102,5,3,70,115,43,70,22,45,5,10,16,65,115
1995-05-29 00:00:00.000,Roland Garros France Grand Slams,CLAY,3,Sergi Bruguera,Patrick Rafter,Sergi Bruguera,6-3; 6-1; 7-6(3),R128,27,4,3,84,98,64,84,6,14,2,2,14,70,98,4,8,61,108,42,61,17,47,5,9,14,59,108
1995-05-29 00:00:00.000,Roland Garros France Grand Slams,CLAY,3,Emilio Benfele Alvarez,Jean-Philippe Fleurian,Emilio Benfele Alvarez,7-6(4); 6-2; 7-6(4),R128,2,5,3,92,116,65,92,10,24,1,3,16,75,116,10,0,93,129,53,93,27,36,8,12,16,80,129
1995-05-29 00:00:00.000,Roland Garros France Grand Slams,CLAY,3,Brett Steven,Carsten Arriens,Brett Steven,6-7(6); 6-2 DEF,R128,0,2,1,47,73,31,47,15,26,2,4,10,46,73,3,1,43,67,30,43,9,24,0,4,11,39,67
1995-05-29 00:00:00.000,Roland Garros France Grand Slams,CLAY,3,Marc-Kevin Goellner,Andrea Gaudenzi,Marc-Kevin Goellner,6-3; 6-7(4); 7-6(3); 6-4,R128,6,22,4,110,188,89,110,32,78,10,14,22,121,188,3,8,92,159,62,92,28,67,7,13,21,90,159
1995-05-29 00:00:00.000,Roland Garros France Grand Slams,CLAY,3,Jacco Eltingh,Carl-Uwe Steeb,Jacco Eltingh,6-4; 6-2; 6-0,R128,2,1,2,44,69,33,44,14,25,3,5,12,47,69,3,3,61,95,30,61,13,34,13,21,12,43,95
1995-05-29 00:00:00.000,Roland Garros France Grand Slams,CLAY,3,Byron Black,Jan Apell,Byron Black,6-3; 3-6; 7-6(5); 4-6; 10-8,R128,0,3,3,70,121,44,70,25,51,2,8,20,69,121,9,3,92,144,69,92,21,52,5,10,20,90,144
1995-05-29 00:00:00.000,Roland Garros France Grand Slams,CLAY,3,Hendrik Dreekmann,Kris Goossens,Hendrik Dreekmann,6-4; 6-2; 5-7; 3-6; 6-4,R128,4,8,8,103,188,71,103,43,85,14,18,24,114,188,6,6,100,169,73,100,31,69,8,14,25,104,169
1995-05-29 00:00:00.000,Roland Garros France Grand Slams,CLAY,3,Magnus Larsson,Jordi Arrese,Magnus Larsson,6-1; 1-6; 6-2; 6-4,R128,2,5,4,62,100,44,62,16,38,5,10,16,60,100,2,4,77,102,45,77,7,25,4,12,16,52,102
1995-05-29 00:00:00.000,Roland Garros France Grand Slams,CLAY,3,Marc Rosset,Richard Fromberg,Marc Rosset,7-5; 5-7; 7-5; 7-6(5),R128,4,6,4,86,152,65,86,38,66,6,10,24,103,152,7,3,92,160,67,92,33,68,6,11,24,100,160
1995-05-29 00:00:00.000,Roland Garros France Grand Slams,CLAY,3,Fernando Meligeni,Petr Korda,Fernando Meligeni,6-4; 6-4; 6-4,R128,4,4,1,42,98,31,42,36,56,3,4,15,67,98,4,7,58,102,42,58,18,44,5,9,15,60,102
1995-05-29 00:00:00.000,Roland Garros France Grand Slams,CLAY,3,Renzo Furlan,Marcos Ondruska,Renzo Furlan,6-4; 4-6; 6-2; 6-3,R128,7,3,3,63,107,44,63,24,44,5,9,18,68,107,1,3,74,121,42,74,23,47,8,16,19,65,121
1995-05-29 00:00:00.000,Roland Garros France Grand Slams,CLAY,3,David Rikl,Jonathan Stark,David Rikl,6-4; 7-6(3); 6-2,R128,3,3,3,63,99,47,63,20,36,2,4,15,67,99,2,1,66,104,39,66,19,38,4,9,15,58,104
1995-05-29 00:00:00.000,Roland Garros France Grand Slams,CLAY,3,Mark Woodforde,Hernan Gumy,Mark Woodforde,6-4; 6-0; 6-3,R128,3,6,5,57,99,45,57,17,42,4,5,13,62,99,2,7,61,97,35,61,12,36,6,12,12,47,97
1995-05-29 00:00:00.000,Roland Garros France Grand Slams,CLAY,3,Richey Reneberg,Jim Grabb,Richey Reneberg,6-4; 5-7; 6-2; 6-3,R128,3,6,1,75,115,57,75,21,40,5,10,20,78,115,4,2,83,127,51,83,18,44,6,14,19,69,127
1995-05-29 00:00:00.000,Roland Garros France Grand Slams,CLAY,3,Scott Draper,Jonas Bjorkman,Scott Draper,6-7(6); 6-3; 6-3; 3-6; 6-2,R128,27,13,3,113,160,84,113,29,47,7,9,23,113,160,5,3,111,147,77,111,20,36,3,9,24,97,147
1995-05-29 00:00:00.000,Roland Garros France Grand Slams,CLAY,3,Gilbert Schaller,Pete Sampras,Gilbert Schaller,7-6(3); 4-6; 6-7(4); 6-2; 6-4,R128,7,1,1,141,177,84,141,20,36,13,20,26,104,177,23,10,119,201,90,119,26,82,9,18,26,116,201
1995-05-29 00:00:00.000,Roland Garros France Grand Slams,CLAY,3,Andre Agassi,Todd Woodbridge,Andre Agassi,7-5; 6-1; 6-0,R64,3,3,1,47,69,36,47,14,22,0,1,12,50,69,1,5,58,95,35,58,7,37,4,12,13,42,95
1995-05-29 00:00:00.000,Roland Garros France Grand Slams,CLAY,3,Francisco Clavet,Thierry Champion,Francisco Clavet,6-2; 1-0 RET,R64,0,1,0,31,36,21,31,2,5,6,6,5,23,36,0,1,21,36,11,21,6,15,3,6,5,17,36
1995-05-29 00:00:00.000,Roland Garros France Grand Slams,CLAY,3,Younes El Aynaoui,Patrick McEnroe,Younes El Aynaoui,6-2; 6-1; 6-3,R64,5,5,3,41,77,33,41,21,36,1,3,12,54,77,1,5,53,87,29,53,7,34,7,15,12,36,87
1995-05-29 00:00:00.000,Roland Garros France Grand Slams,CLAY,3,Andrew Ilie,Richard Krajicek,Andrew Ilie,3-6; 6-3; 6-4; 2-6; 6-4,R64,6,2,4,108,162,65,108,27,54,11,18,23,92,162,11,5,97,159,70,97,22,62,12,19,23,92,159
1995-05-29 00:00:00.000,Roland Garros France Grand Slams,CLAY,3,Yevgeny Kafelnikov,Magnus Gustafsson,Yevgeny Kafelnikov,6-3; 6-7(2); 6-1; 7-5,R64,10,4,5,76,150,50,76,39,74,3,8,21,89,150,6,9,72,142,44,72,27,70,10,19,19,71,142
1995-05-29 00:00:00.000,Roland Garros France Grand Slams,CLAY,3,David Wheaton,Emilio Sanchez,David Wheaton,5-7; 6-4; 7-6(5); 7-6(3),R64,6,14,4,113,169,77,113,35,56,6,11,23,112,169,7,1,126,178,84,126,23,52,17,22,23,107,178
1995-05-29 00:00:00.000,Roland Garros France Grand Slams,CLAY,3,Alex Corretja,Guy Forget,Alex Corretja,6-2; 6-3; 6-3,R64,3,4,0,57,82,42,57,18,25,4,4,13,60,82,5,3,54,103,38,54,21,49,9,14,13,59,103
1995-05-29 00:00:00.000,Roland Garros France Grand Slams,CLAY,3,Wayne Ferreira,Mats Wilander,Wayne Ferreira,6-7(5); 7-6(1); 6-3; 6-7(4); 8-6,R64,17,5,6,91,206,67,91,58,115,10,17,30,125,206,4,9,131,207,82,131,33,76,8,17,29,115,207
1995-05-29 00:00:00.000,Roland Garros France Grand Slams,CLAY,3,Bernd Karbacher,Mikael Tillstrom,Bernd Karbacher,7-6(4); 6-3; 6-7(5); 2-6; 9-7,R64,0,14,5,93,164,77,93,31,71,7,11,21,108,164,13,5,120,184,89,120,28,64,9,12,20,117,184
1995-05-29 00:00:00.000,Roland Garros France Grand Slams,CLAY,3,Albert Costa,Guillaume Raoux,Albert Costa,6-4; 6-4; 6-4,R64,4,4,4,60,96,49,60,18,36,5,6,15,67,96,2,2,65,116,37,65,28,51,7,11,15,65,116
1995-05-29 00:00:00.000,Roland Garros France Grand Slams,CLAY,3,Christian Ruud,Donald Johnson,Christian Ruud,6-1; 6-4; 6-3,R64,2,1,2,45,75,35,45,18,30,2,3,13,53,75,4,5,46,93,31,46,16,47,3,9,13,47,93
1995-05-29 00:00:00.000,Roland Garros France Grand Slams,CLAY,3,Jim Courier,Kenneth Carlsen,Jim Courier,6-3; 6-4; 6-0,R64,0,1,4,43,74,36,43,17,31,0,0,13,53,74,9,4,58,105,42,58,16,47,6,11,12,58,105
1995-05-29 00:00:00.000,Roland Garros France Grand Slams,CLAY,3,Alberto Berasategui,Marcelo Rios,Alberto Berasategui,6-4; 7-5; 6-7(3); 3-6; 6-1,R64,5,2,6,125,176,71,125,24,51,11,21,25,95,176,5,5,127,198,72,127,28,71,21,34,25,100,198
1995-05-29 00:00:00.000,Roland Garros France Grand Slams,CLAY,3,Andrei Medvedev,MaliVai Washington,Andrei Medvedev,5-7; 6-3; 6-4; 6-7(3); 6-3,R64,15,13,4,106,209,77,106,49,103,15,22,27,126,209,16,12,124,198,88,124,24,74,10,19,25,112,198
1995-05-29 00:00:00.000,Roland Garros France Grand Slams,CLAY,3,Carlos Costa,Bohdan Ulihrach,Carlos Costa,6-4; 4-6; 2-6; 7-5; 6-2,R64,5,6,2,98,153,68,98,21,55,11,20,24,89,153,6,4,94,187,65,94,39,93,18,28,24,104,187
1995-05-29 00:00:00.000,Roland Garros France Grand Slams,CLAY,3,Thomas Muster,Cedric Pioline,Thomas Muster,6-1; 6-3; 6-3,R64,2,0,0,40,69,31,40,20,29,0,0,13,51,69,4,2,55,85,32,55,12,30,3,9,12,44,85
1995-05-29 00:00:00.000,Roland Garros France Grand Slams,CLAY,3,Michael Chang,Daniel Vacek,Michael Chang,6-3; 5-7; 6-4; 6-4,R64,7,4,2,84,116,60,84,20,32,0,4,21,80,116,10,7,80,134,58,80,24,54,6,12,20,82,134
1995-05-29 00:00:00.000,Roland Garros France Grand Slams,CLAY,3,Tomas Carbonell,Frederik Fetterlein,Tomas Carbonell,2-6; 6-3; 3-6; 6-4; 6-4,R64,4,1,6,122,165,71,122,15,43,12,21,23,86,165,3,8,105,147,61,105,16,42,3,12,23,77,147
1995-05-29 00:00:00.000,Roland Garros France Grand Slams,CLAY,3,Arnaud Boetsch,Javier Sanchez,Arnaud Boetsch,7-6(5); 6-2; 6-2,R64,3,4,3,50,90,43,50,23,40,4,5,14,66,90,2,5,57,103,43,57,13,46,1,6,14,56,103
1995-05-29 00:00:00.000,Roland Garros France Grand Slams,CLAY,3,Michael Stich,Stefan Edberg,Michael Stich,7-6(3); 6-3; 6-2,R64,12,4,3,51,92,46,51,21,41,1,2,15,67,92,1,5,60,96,39,60,16,36,3,7,14,55,96
1995-05-29 00:00:00.000,Roland Garros France Grand Slams,CLAY,3,Todd Martin,Slava Dosedel,Todd Martin,6-2; 2-6; 6-3; 7-6(5),R64,5,9,2,94,148,67,94,26,54,8,12,19,93,148,1,1,96,121,59,96,13,25,9,14,18,72,121
1995-05-29 00:00:00.000,Roland Garros France Grand Slams,CLAY,3,Andrei Chesnokov,Thierry Guardiola,Andrei Chesnokov,7-5; 6-2; 6-3,R64,3,1,3,48,89,37,48,24,41,8,10,15,61,89,3,0,45,96,32,45,21,51,7,13,14,53,96
1995-05-29 00:00:00.000,Roland Garros France Grand Slams,CLAY,3,Adrian Voinea,Johan Van Herck,Adrian Voinea,7-6(4); 6-3; 6-0,R64,4,5,0,53,82,44,53,16,29,1,2,13,60,82,1,2,74,111,44,74,14,37,7,13,14,58,111
1995-05-29 00:00:00.000,Roland Garros France Grand Slams,CLAY,3,Boris Becker,Jared Palmer,Boris Becker,6-2; 6-2; 6-2,R64,0,5,2,47,70,40,47,15,23,1,1,12,55,70,4,3,75,102,42,75,10,27,11,17,12,52,102
1995-05-29 00:00:00.000,Roland Garros France Grand Slams,CLAY,3,Sergi Bruguera,Emilio Benfele Alvarez,Sergi Bruguera,6-4; 6-4; 6-2,R64,2,3,0,68,85,43,68,9,17,5,9,14,52,85,1,3,57,95,29,57,13,38,5,13,14,42,95
1995-05-29 00:00:00.000,Roland Garros France Grand Slams,CLAY,3,Brett Steven,Marc-Kevin Goellner,Brett Steven,7-6(5); 6-2; 5-7; 4-6; 7-5,R64,102,7,2,119,172,86,119,32,53,1,4,27,118,172,25,5,137,219,103,137,44,82,15,19,27,147,219
1995-05-29 00:00:00.000,Roland Garros France Grand Slams,CLAY,3,Jacco Eltingh,Byron Black,Jacco Eltingh,6-2; 6-4; 6-4,R64,0,10,5,56,84,50,56,12,28,0,2,14,62,84,0,2,72,105,40,72,14,33,8,14,14,54,105
1995-05-29 00:00:00.000,Roland Garros France Grand Slams,CLAY,3,Magnus Larsson,Hendrik Dreekmann,Magnus Larsson,6-4; 6-3; 6-7(6); 6-2,R64,5,18,3,99,152,78,99,30,53,6,8,20,108,152,5,4,68,127,47,68,32,59,10,16,19,79,127
1995-05-29 00:00:00.000,Roland Garros France Grand Slams,CLAY,3,Fernando Meligeni,Marc Rosset,Fernando Meligeni,7-6(7); 7-6(4); 2-6; 6-3,R64,5,7,8,92,159,76,92,28,67,9,12,21,104,159,13,11,84,155,71,84,32,71,4,6,20,103,155
1995-05-29 00:00:00.000,Roland Garros France Grand Slams,CLAY,3,Renzo Furlan,David Rikl,Renzo Furlan,6-4; 6-4; 6-7(4); 4-6; 7-5,R64,14,11,1,143,182,99,143,19,39,6,11,27,118,182,6,3,135,192,90,135,28,57,14,21,27,118,192
1995-05-29 00:00:00.000,Roland Garros France Grand Slams,CLAY,3,Richey Reneberg,Mark Woodforde,Richey Reneberg,6-0; 7-5; 7-6(5),R64,4,7,0,96,140,67,96,21,44,12,14,15,88,140,4,3,67,116,43,67,17,49,9,15,15,60,116
1995-05-29 00:00:00.000,Roland Garros France Grand Slams,CLAY,3,Scott Draper,Gilbert Schaller,Scott Draper,4-6; 4-6; 7-6(5); 7-5; 8-6,R64,5,20,6,115,227,89,115,54,112,6,12,29,143,227,4,1,142,179,94,142,20,37,7,13,29,114,179
1995-05-29 00:00:00.000,Roland Garros France Grand Slams,CLAY,3,Andre Agassi,Francisco Clavet,Andre Agassi,6-1; 6-2; 6-0,R32,2,1,1,48,71,34,48,16,23,4,4,11,50,71,1,1,39,66,17,39,11,27,7,14,10,28,66
1995-05-29 00:00:00.000,Roland Garros France Grand Slams,CLAY,3,Younes El Aynaoui,Andrew Ilie,Younes El Aynaoui,6-2; 7-5; 6-2,R32,4,2,1,45,87,36,45,20,42,4,7,14,56,87,1,5,60,109,32,60,18,49,11,19,14,50,109
1995-05-29 00:00:00.000,Roland Garros France Grand Slams,CLAY,3,Yevgeny Kafelnikov,David Wheaton,Yevgeny Kafelnikov,6-2; 6-1; 4-6; 6-3,R32,3,6,3,77,130,54,77,27,53,8,11,17,81,130,8,3,93,127,52,93,13,34,6,14,17,65,127
1995-05-29 00:00:00.000,Roland Garros France Grand Slams,CLAY,3,Alex Corretja,Wayne Ferreira,Alex Corretja,6-4; 7-5; 6-2,R32,2,0,0,76,102,48,76,13,26,9,13,15,61,102,6,1,56,112,33,56,24,56,10,18,15,57,112
1995-05-29 00:00:00.000,Roland Garros France Grand Slams,CLAY,3,Albert Costa,Bernd Karbacher,Albert Costa,7-5; 6-2; 6-2,R32,3,3,1,71,89,58,71,8,18,2,2,14,66,89,8,1,68,102,52,68,9,34,8,13,14,61,102
1995-05-29 00:00:00.000,Roland Garros France Grand Slams,CLAY,3,Jim Courier,Christian Ruud,Jim Courier,6-4; 6-3; 6-4,R32,2,4,4,52,112,38,52,28,60,7,10,15,66,112,4,4,55,92,34,55,14,37,4,10,14,48,92
1995-05-29 00:00:00.000,Roland Garros France Grand Slams,CLAY,3,Andrei Medvedev,Alberto Berasategui,Andrei Medvedev,3-6; 6-3; 4-6; 7-5; 6-3,R32,5,7,2,113,167,75,113,24,54,12,18,24,99,167,1,4,126,156,78,126,13,30,8,16,25,91,156
1995-05-29 00:00:00.000,Roland Garros France Grand Slams,CLAY,3,Thomas Muster,Carlos Costa,Thomas Muster,6-3; 7-5; 6-2,R32,2,2,3,62,100,47,62,18,38,7,9,15,65,100,5,4,60,99,42,60,11,39,8,14,14,53,99
1995-05-29 00:00:00.000,Roland Garros France Grand Slams,CLAY,3,Michael Chang,Tomas Carbonell,Michael Chang,6-1; 6-2; 7-5,R32,2,4,2,45,82,33,45,18,37,3,7,14,51,82,2,4,76,106,38,76,8,30,10,19,13,46,106
1995-05-29 00:00:00.000,Roland Garros France Grand Slams,CLAY,3,Michael Stich,Arnaud Boetsch,Michael Stich,6-2; 6-4; 5-7; 3-6; 6-3,R32,7,13,3,152,190,111,152,11,38,18,22,24,122,190,5,6,139,177,91,139,12,38,19,25,24,103,177
1995-05-29 00:00:00.000,Roland Garros France Grand Slams,CLAY,3,Andrei Chesnokov,Todd Martin,Andrei Chesnokov,6-2; 6-2; 6-4,R32,0,0,1,42,81,30,42,22,39,0,3,13,52,81,0,3,36,75,17,36,15,39,3,11,13,32,75
1995-05-29 00:00:00.000,Roland Garros France Grand Slams,CLAY,3,Adrian Voinea,Boris Becker,Adrian Voinea,6-3; 6-4; 3-6; 7-5,R32,4,10,4,107,156,72,107,27,49,9,13,20,99,156,8,7,91,146,62,91,20,55,3,9,20,82,146
1995-05-29 00:00:00.000,Roland Garros France Grand Slams,CLAY,3,Sergi Bruguera,Brett Steven,Sergi Bruguera,6-3; 6-2; 6-4,R32,5,6,1,63,82,42,63,9,19,4,8,13,51,82,3,5,60,100,35,60,9,40,5,14,14,44,100
1995-05-29 00:00:00.000,Roland Garros France Grand Slams,CLAY,3,Magnus Larsson,Jacco Eltingh,Magnus Larsson,6-4; 5-7; 7-6(2); 6-3,R32,23,12,8,94,165,72,94,34,71,8,13,22,106,165,16,12,114,191,72,114,34,77,13,19,21,106,191
1995-05-29 00:00:00.000,Roland Garros France Grand Slams,CLAY,3,Renzo Furlan,Fernando Meligeni,Renzo Furlan,6-3; 7-6(4); 7-5,R32,3,2,0,58,103,42,58,19,45,4,9,16,61,103,5,7,59,130,38,59,28,71,4,12,17,66,130
1995-05-29 00:00:00.000,Roland Garros France Grand Slams,CLAY,3,Scott Draper,Richey Reneberg,Scott Draper,6-2; 6-2; 3-6; 6-4,R32,3,10,0,66,117,53,66,31,51,6,7,17,84,117,10,2,73,114,52,73,23,41,7,12,18,75,114
1995-05-29 00:00:00.000,Roland Garros France Grand Slams,CLAY,3,Andre Agassi,Younes El Aynaoui,Andre Agassi,6-4; 6-2; 6-2,R16,2,0,0,55,66,44,55,10,11,1,1,13,54,66,3,5,41,80,30,41,14,39,3,8,13,44,80
1995-05-29 00:00:00.000,Roland Garros France Grand Slams,CLAY,3,Yevgeny Kafelnikov,Alex Corretja,Yevgeny Kafelnikov,6-3; 6-2; 6-2,R16,2,2,5,54,118,37,54,37,64,13,13,13,74,118,0,2,50,76,27,50,11,26,4,9,12,38,76
1995-05-29 00:00:00.000,Roland Garros France Grand Slams,CLAY,3,Albert Costa,Jim Courier,Albert Costa,6-4; 1-6; 7-6(4); 6-4,R16,4,1,1,113,138,66,113,12,25,10,16,19,78,138,3,3,89,138,56,89,24,49,7,13,20,80,138
1995-05-29 00:00:00.000,Roland Garros France Grand Slams,CLAY,3,Thomas Muster,Andrei Medvedev,Thomas Muster,6-3; 6-3; 6-0,R16,2,0,4,37,74,32,37,20,37,3,3,12,52,74,1,2,30,67,17,30,16,37,6,12,12,33,67
1995-05-29 00:00:00.000,Roland Garros France Grand Slams,CLAY,3,Michael Chang,Michael Stich,Michael Chang,1-6; 6-0; 6-2; 6-3,R16,3,0,5,65,106,47,65,12,41,8,12,15,59,106,6,4,80,121,47,80,13,41,11,19,15,60,121
1995-05-29 00:00:00.000,Roland Garros France Grand Slams,CLAY,3,Adrian Voinea,Andrei Chesnokov,Adrian Voinea,7-6(3); 6-3; 6-4,R16,2,3,2,69,114,42,69,22,45,6,11,15,64,114,1,7,69,123,37,69,22,54,10,18,16,59,123
1995-05-29 00:00:00.000,Roland Garros France Grand Slams,CLAY,3,Sergi Bruguera,Magnus Larsson,Sergi Bruguera,6-1; 2-6; 7-5; 7-6(4),R16,0,0,1,93,132,60,93,19,39,8,13,20,79,132,4,2,87,130,63,87,14,43,7,13,19,77,130
1995-05-29 00:00:00.000,Roland Garros France Grand Slams,CLAY,3,Renzo Furlan,Scott Draper,Renzo Furlan,7-5; 6-1; 7-6(6),R16,2,0,2,66,100,40,66,18,34,3,7,15,58,100,3,1,59,109,35,59,21,50,5,13,16,56,109
1995-05-29 00:00:00.000,Roland Garros France Grand Slams,CLAY,3,Yevgeny Kafelnikov,Andre Agassi,Yevgeny Kafelnikov,6-4; 6-3; 7-5,Q,2,6,4,56,102,40,56,19,46,2,6,16,59,102,4,1,59,109,33,59,25,50,10,17,15,58,109
1995-05-29 00:00:00.000,Roland Garros France Grand Slams,CLAY,3,Thomas Muster,Albert Costa,Thomas Muster,6-2; 3-6; 6-7(6); 7-5; 6-2,Q,5,4,3,100,168,71,100,36,68,12,17,24,107,168,8,3,117,170,75,117,24,53,13,22,25,99,170
1995-05-29 00:00:00.000,Roland Garros France Grand Slams,CLAY,3,Michael Chang,Adrian Voinea,Michael Chang,7-5; 6-0; 6-1,Q,2,2,1,50,71,38,50,15,21,2,2,12,53,71,1,3,58,91,30,58,14,33,7,14,13,44,91
1995-05-29 00:00:00.000,Roland Garros France Grand Slams,CLAY,3,Sergi Bruguera,Renzo Furlan,Sergi Bruguera,6-2; 7-5; 6-2,Q,2,5,0,72,94,51,72,13,22,8,10,14,64,94,0,2,47,93,27,47,18,46,6,13,14,45,93
1995-05-29 00:00:00.000,Roland Garros France Grand Slams,CLAY,3,Thomas Muster,Yevgeny Kafelnikov,Thomas Muster,6-4; 6-0; 6-4,S,2,3,0,57,77,43,57,15,20,2,2,13,58,77,5,3,42,82,31,42,15,40,2,7,13,46,82
1995-05-29 00:00:00.000,Roland Garros France Grand Slams,CLAY,3,Michael Chang,Sergi Bruguera,Michael Chang,6-4; 7-6(5); 7-6(0),S,4,4,2,75,119,51,75,25,44,7,10,17,76,119,3,1,62,110,45,62,23,48,3,7,17,68,110
1995-05-29 00:00:00.000,Roland Garros France Grand Slams,CLAY,3,Thomas Muster,Michael Chang,Thomas Muster,7-5; 6-2; 6-4,F,2,3,3,56,95,39,56,23,39,4,6,15,62,95,3,2,59,94,37,59,16,35,4,10,15,53,94
1995-06-12 00:00:00.000,London / Queen's Club England ATP World Tour,GRASS,2,Pete Sampras,N/A Bye,Pete Sampras,,R64,0,0,0,0,0,0,0,0,0,0,0,0,0,0,0,0,0,0,0,0,0,0,0,0,0,0,0
1995-06-12 00:00:00.000,London / Queen's Club England ATP World Tour,GRASS,2,Jonathan Stark,Kenneth Carlsen,Jonathan Stark,7-5; 6-2,R64,82,11,5,40,71,31,40,16,31,3,3,10,47,71,5,7,34,61,26,34,11,27,2,5,10,37,61
1995-06-12 00:00:00.000,London / Queen's Club England ATP World Tour,GRASS,2,Jeremy Bates,Markus Zoecke,Jeremy Bates,6-4; 6-3,R64,75,4,2,35,58,26,35,11,23,3,4,9,37,58,6,5,41,73,28,41,12,32,5,9,10,40,73
1995-06-12 00:00:00.000,London / Queen's Club England ATP World Tour,GRASS,2,Tim Henman,Martin Sinner,Tim Henman,7-5; 6-4,R64,85,4,8,42,68,30,42,11,26,5,8,11,41,68,2,13,35,76,22,35,17,41,7,12,11,39,76
1995-06-12 00:00:00.000,London / Queen's Club England ATP World Tour,GRASS,2,Jared Palmer,David Wheaton,Jared Palmer,6-2; 4-6; 6-1,R64,92,1,4,46,74,35,46,18,28,5,6,13,53,74,4,2,42,75,24,42,19,33,7,11,12,43,75
1995-06-12 00:00:00.000,London / Queen's Club England ATP World Tour,GRASS,2,Sandon Stolle,Doug Flach,Sandon Stolle,6-2; 6-7(5); 6-2,R64,100,9,8,53,99,40,53,25,46,8,10,14,65,99,3,6,60,97,39,60,13,37,10,16,14,52,97
1995-06-12 00:00:00.000,London / Queen's Club England ATP World Tour,GRASS,2,Jamie Morgan,Scott Draper,Jamie Morgan,6-4; 6-0,R64,52,6,3,22,40,17,22,13,18,1,2,8,30,40,5,3,29,52,18,29,4,23,2,7,8,22,52
1995-06-12 00:00:00.000,London / Queen's Club England ATP World Tour,GRASS,2,Jonas Bjorkman,N/A Bye,Jonas Bjorkman,,R64,0,0,0,0,0,0,0,0,0,0,0,0,0,0,0,0,0,0,0,0,0,0,0,0,0,0,0
1995-06-12 00:00:00.000,London / Queen's Club England ATP World Tour,GRASS,2,Wayne Ferreira,N/A Bye,Wayne Ferreira,,R64,0,0,0,0,0,0,0,0,0,0,0,0,0,0,0,0,0,0,0,0,0,0,0,0,0,0,0
1995-06-12 00:00:00.000,London / Queen's Club England ATP World Tour,GRASS,2,Bryan Shelton,Brian MacPhie,Bryan Shelton,6-2; 6-4,R64,61,5,4,23,50,18,23,16,27,2,3,9,34,50,4,10,31,60,22,31,11,29,4,8,9,33,60
1995-06-12 00:00:00.000,London / Queen's Club England ATP World Tour,GRASS,2,Derrick Rostagno,Grant Connell,Derrick Rostagno,6-4; 6-2,R64,57,3,2,27,45,21,27,13,18,0,1,9,34,45,0,6,26,54,17,26,14,28,2,6,9,31,54
1995-06-12 00:00:00.000,London / Queen's Club England ATP World Tour,GRASS,2,Alexander Volkov,Philippe Pech,Alexander Volkov,4-6; 6-1; 6-1,R64,87,5,2,31,67,21,31,24,36,2,4,12,45,67,6,8,54,98,35,54,14,44,11,17,12,49,98
1995-06-12 00:00:00.000,London / Queen's Club England ATP World Tour,GRASS,2,Marc-Kevin Goellner,Mark Woodforde,Marc-Kevin Goellner,7-6(4); 4-6; 10-8,R64,141,23,10,81,142,65,81,30,61,9,12,20,95,142,12,4,76,122,63,76,25,46,7,10,20,88,122
1995-06-12 00:00:00.000,London / Queen's Club England ATP World Tour,GRASS,2,Gianluca Pozzi,Frederik Fetterlein,Gianluca Pozzi,6-3; 6-2,R64,54,5,6,33,61,25,33,14,28,6,7,9,39,61,1,4,28,46,18,28,6,18,3,7,8,24,46
1995-06-12 00:00:00.000,London / Queen's Club England ATP World Tour,GRASS,2,Todd Woodbridge,Michael Joyce,Todd Woodbridge,7-5; 6-1,R64,80,2,5,36,74,27,36,16,38,5,7,10,43,74,0,2,40,70,22,40,12,30,7,12,9,34,70
1995-06-12 00:00:00.000,London / Queen's Club England ATP World Tour,GRASS,2,Marc Rosset,N/A Bye,Marc Rosset,,R64,0,0,0,0,0,0,0,0,0,0,0,0,0,0,0,0,0,0,0,0,0,0,0,0,0,0,0
1995-06-12 00:00:00.000,London / Queen's Club England ATP World Tour,GRASS,2,Todd Martin,N/A Bye,Todd Martin,,R64,0,0,0,0,0,0,0,0,0,0,0,0,0,0,0,0,0,0,0,0,0,0,0,0,0,0,0
1995-06-12 00:00:00.000,London / Queen's Club England ATP World Tour,GRASS,2,Jan Apell,Sebastien Lareau,Jan Apell,6-2; 6-3,R64,53,4,2,35,49,28,35,9,14,0,0,9,37,49,4,6,23,44,18,23,7,21,0,3,8,25,44
1995-06-12 00:00:00.000,London / Queen's Club England ATP World Tour,GRASS,2,David Prinosil,Patrick McEnroe,David Prinosil,6-1; 6-3,R64,73,7,3,23,42,21,23,11,19,0,0,8,32,42,3,2,51,90,31,51,13,39,14,18,8,44,90
1995-06-12 00:00:00.000,London / Queen's Club England ATP World Tour,GRASS,2,Guy Forget,Byron Black,Guy Forget,6-4; 6-2,R64,70,12,4,35,60,30,35,13,25,4,4,9,43,60,5,2,41,67,25,41,12,26,6,9,9,37,67
1995-06-12 00:00:00.000,London / Queen's Club England ATP World Tour,GRASS,2,Patrick Rafter,Vincent Spadea,Patrick Rafter,6-3; 6-1,R64,56,4,2,23,49,19,23,14,26,1,2,8,33,49,5,3,28,54,18,28,7,26,4,9,8,25,54
1995-06-12 00:00:00.000,London / Queen's Club England ATP World Tour,GRASS,2,Petr Korda,Pat Cash,Petr Korda,7-6(4); 7-5,R64,126,2,8,45,88,32,45,20,43,3,6,12,52,88,8,2,69,111,45,69,15,42,4,8,12,60,111
1995-06-12 00:00:00.000,London / Queen's Club England ATP World Tour,GRASS,2,Marcos Ondruska,Mark Philippoussis,Marcos Ondruska,6-4; 6-3,R64,78,3,3,37,62,28,37,13,25,3,4,9,41,62,6,11,35,68,25,35,11,33,2,6,10,36,68
1995-06-12 00:00:00.000,London / Queen's Club England ATP World Tour,GRASS,2,Goran Ivanisevic,N/A Bye,Goran Ivanisevic,,R64,0,0,0,0,0,0,0,0,0,0,0,0,0,0,0,0,0,0,0,0,0,0,0,0,0,0,0
1995-06-12 00:00:00.000,London / Queen's Club England ATP World Tour,GRASS,2,Stefan Edberg,N/A Bye,Stefan Edberg,,R64,0,0,0,0,0,0,0,0,0,0,0,0,0,0,0,0,0,0,0,0,0,0,0,0,0,0,0
1995-06-12 00:00:00.000,London / Queen's Club England ATP World Tour,GRASS,2,Arnaud Boetsch,Alexander Mronz,Arnaud Boetsch,6-4; 6-2,R64,57,9,4,33,59,25,33,17,26,3,3,9,42,59,4,7,24,51,17,24,12,27,0,3,9,29,51
1995-06-12 00:00:00.000,London / Queen's Club England ATP World Tour,GRASS,2,Mark Petchey,Greg Rusedski,Mark Petchey,6-4; 1-6; 6-3,R64,86,2,3,56,84,39,56,16,28,7,9,13,55,84,5,6,47,77,34,47,15,30,5,7,13,49,77
1995-06-12 00:00:00.000,London / Queen's Club England ATP World Tour,GRASS,2,Jason Stoltenberg,Jakob Hlasek,Jason Stoltenberg,6-4; 6-2,R64,56,5,3,32,55,25,32,11,23,3,4,9,36,55,1,8,31,57,21,31,10,26,2,6,9,31,57
1995-06-12 00:00:00.000,London / Queen's Club England ATP World Tour,GRASS,2,Javier Frana,Michael Tebbutt,Javier Frana,6-1; 6-3,R64,60,7,2,36,59,28,36,13,23,11,11,8,41,59,2,9,21,55,14,21,13,34,1,5,8,27,55
1995-06-12 00:00:00.000,London / Queen's Club England ATP World Tour,GRASS,2,Tommy Ho,Chris Wilkinson,Tommy Ho,6-4; 6-0,R64,55,2,2,37,55,26,37,10,18,5,6,8,36,55,2,3,23,43,17,23,2,20,2,7,8,19,43
1995-06-12 00:00:00.000,London / Queen's Club England ATP World Tour,GRASS,2,Danny Sapsford,Andrew Richardson,Danny Sapsford,6-2; 6-4,R64,77,2,1,27,52,20,27,16,25,1,2,9,36,52,5,2,42,71,29,42,10,29,8,12,9,39,71
1995-06-12 00:00:00.000,London / Queen's Club England ATP World Tour,GRASS,2,Boris Becker,N/A Bye,Boris Becker,,R64,0,0,0,0,0,0,0,0,0,0,0,0,0,0,0,0,0,0,0,0,0,0,0,0,0,0,0
1995-06-12 00:00:00.000,London / Queen's Club England ATP World Tour,GRASS,2,Pete Sampras,Jonathan Stark,Pete Sampras,7-6(4); 6-3,R32,75,9,3,35,57,30,35,15,22,2,2,10,45,57,13,2,46,75,34,46,11,29,3,5,11,45,75
1995-06-12 00:00:00.000,London / Queen's Club England ATP World Tour,GRASS,2,Jeremy Bates,Tim Henman,Jeremy Bates,6-4; 7-6(4),R32,92,3,1,44,76,29,44,22,32,2,3,11,51,76,7,4,54,85,38,54,15,31,4,6,11,53,85
1995-06-12 00:00:00.000,London / Queen's Club England ATP World Tour,GRASS,2,Sandon Stolle,Jared Palmer,Sandon Stolle,6-3; 6-2,R32,58,6,11,34,61,27,34,11,27,8,10,9,38,61,2,5,20,46,12,20,10,26,4,9,8,22,46
1995-06-12 00:00:00.000,London / Queen's Club England ATP World Tour,GRASS,2,Jonas Bjorkman,Jamie Morgan,Jonas Bjorkman,6-4; 6-4,R32,74,5,6,39,60,27,39,13,21,1,3,10,40,60,12,6,43,71,28,43,10,28,7,11,10,38,71
1995-06-12 00:00:00.000,London / Queen's Club England ATP World Tour,GRASS,2,Wayne Ferreira,Bryan Shelton,Wayne Ferreira,6-2; 6-4,R32,61,6,6,37,57,29,37,8,20,1,2,9,37,57,5,8,38,59,24,38,6,21,5,9,9,30,59
1995-06-12 00:00:00.000,London / Queen's Club England ATP World Tour,GRASS,2,Derrick Rostagno,Alexander Volkov,Derrick Rostagno,7-5; 6-2,R32,63,8,1,31,52,28,31,11,21,0,1,10,39,52,3,2,35,68,22,35,16,33,8,12,10,38,68
1995-06-12 00:00:00.000,London / Queen's Club England ATP World Tour,GRASS,2,Marc-Kevin Goellner,Gianluca Pozzi,Marc-Kevin Goellner,6-3; 6-2,R32,0,0,0,0,0,0,0,0,0,0,0,0,0,0,0,0,0,0,0,0,0,0,0,0,0,0,0
1995-06-12 00:00:00.000,London / Queen's Club England ATP World Tour,GRASS,2,Marc Rosset,Todd Woodbridge,Marc Rosset,7-6(2); 6-7(4); 6-2,R32,124,23,9,71,115,61,71,17,44,5,7,16,78,115,0,6,60,103,43,60,20,43,5,9,16,63,103
1995-06-12 00:00:00.000,London / Queen's Club England ATP World Tour,GRASS,2,Todd Martin,Jan Apell,Todd Martin,6-3; 6-4,R32,71,8,1,37,55,31,37,8,18,3,4,10,39,55,4,3,36,73,24,36,16,37,10,13,9,40,73
1995-06-12 00:00:00.000,London / Queen's Club England ATP World Tour,GRASS,2,Guy Forget,David Prinosil,Guy Forget,7-6(5); 7-5,R32,89,7,4,57,78,44,57,10,21,2,3,12,54,78,3,7,52,89,35,52,20,37,10,12,12,55,89
1995-06-12 00:00:00.000,London / Queen's Club England ATP World Tour,GRASS,2,Petr Korda,Patrick Rafter,Petr Korda,5-7; 7-6(6); 9-7,R32,155,6,6,73,122,55,73,25,49,4,9,20,80,122,9,9,82,135,59,82,20,53,5,10,20,79,135
1995-06-12 00:00:00.000,London / Queen's Club England ATP World Tour,GRASS,2,Goran Ivanisevic,Marcos Ondruska,Goran Ivanisevic,4-6; 6-3; 7-5,R32,109,17,13,52,94,38,52,23,42,4,7,16,61,94,6,8,53,102,35,53,24,49,7,11,15,59,102
1995-06-12 00:00:00.000,London / Queen's Club England ATP World Tour,GRASS,2,Stefan Edberg,Arnaud Boetsch,Stefan Edberg,7-5; 6-3,R32,75,1,2,41,66,24,41,16,25,7,10,10,40,66,0,6,47,76,31,47,9,29,4,10,11,40,76
1995-06-12 00:00:00.000,London / Queen's Club England ATP World Tour,GRASS,2,Jason Stoltenberg,Mark Petchey,Jason Stoltenberg,6-3; 6-2,R32,54,1,1,22,47,19,22,13,25,0,1,8,32,47,0,0,33,46,15,33,5,13,2,7,8,20,46
1995-06-12 00:00:00.000,London / Queen's Club England ATP World Tour,GRASS,2,Javier Frana,Tommy Ho,Javier Frana,6-1; 6-2,R32,50,8,2,26,50,24,26,12,24,0,0,8,36,50,0,4,25,48,14,25,9,23,3,7,7,23,48
1995-06-12 00:00:00.000,London / Queen's Club England ATP World Tour,GRASS,2,Boris Becker,Danny Sapsford,Boris Becker,6-1; 6-1,R32,55,5,3,31,53,26,31,9,22,3,3,7,35,53,2,2,23,40,11,23,6,17,2,7,7,17,40
1995-06-12 00:00:00.000,London / Queen's Club England ATP World Tour,GRASS,2,Pete Sampras,Jeremy Bates,Pete Sampras,6-3; 7-5,R16,77,13,2,50,81,33,50,17,31,6,8,11,50,81,3,7,35,69,24,35,12,34,7,11,10,36,69
1995-06-12 00:00:00.000,London / Queen's Club England ATP World Tour,GRASS,2,Sandon Stolle,Jonas Bjorkman,Sandon Stolle,6-7(7); 6-4; 6-4,R16,128,6,7,79,116,53,79,18,37,9,12,16,71,116,7,8,66,111,48,66,19,45,10,15,16,67,111
1995-06-12 00:00:00.000,London / Queen's Club England ATP World Tour,GRASS,2,Derrick Rostagno,Wayne Ferreira,Derrick Rostagno,7-5; 6-7(2); 10-8,R16,155,15,8,73,132,52,73,24,59,6,12,21,76,132,8,9,84,139,56,84,23,55,5,13,21,79,139
1995-06-12 00:00:00.000,London / Queen's Club England ATP World Tour,GRASS,2,Marc-Kevin Goellner,Marc Rosset,Marc-Kevin Goellner,6-4; 6-7(2); 6-3,R16,98,17,4,43,94,38,43,32,51,4,4,16,70,94,12,9,58,96,49,58,16,38,2,4,15,65,96
1995-06-12 00:00:00.000,London / Queen's Club England ATP World Tour,GRASS,2,Guy Forget,Todd Martin,Guy Forget,6-4; 6-4,R16,73,5,2,37,51,33,37,8,14,1,1,10,41,51,5,5,38,66,30,38,11,28,4,6,10,41,66
1995-06-12 00:00:00.000,London / Queen's Club England ATP World Tour,GRASS,2,Goran Ivanisevic,Petr Korda,Goran Ivanisevic,6-3; 6-7(4); 7-5,R16,127,20,6,57,118,45,57,37,61,9,9,16,82,118,9,8,72,118,52,72,24,46,7,10,17,76,118
1995-06-12 00:00:00.000,London / Queen's Club England ATP World Tour,GRASS,2,Jason Stoltenberg,Stefan Edberg,Jason Stoltenberg,6-3; 0-6; 6-4,R16,107,0,2,42,83,31,42,16,41,0,5,13,47,83,1,5,55,98,32,55,22,43,11,15,12,54,98
1995-06-12 00:00:00.000,London / Queen's Club England ATP World Tour,GRASS,2,Boris Becker,Javier Frana,Boris Becker,6-4; 6-2,R16,57,6,5,32,52,29,32,10,20,3,3,9,39,52,5,2,29,48,20,29,8,19,2,5,9,28,48
1995-06-12 00:00:00.000,London / Queen's Club England ATP World Tour,GRASS,2,Pete Sampras,Sandon Stolle,Pete Sampras,6-2; 6-3,Q,54,13,1,31,49,25,31,12,18,0,0,9,37,49,7,4,35,57,21,35,10,22,2,5,8,31,57
1995-06-12 00:00:00.000,London / Queen's Club England ATP World Tour,GRASS,2,Marc-Kevin Goellner,Derrick Rostagno,Marc-Kevin Goellner,7-5; 6-4,Q,74,14,3,31,60,29,31,18,29,2,2,11,47,60,10,5,45,75,30,45,16,30,5,7,11,46,75
1995-06-12 00:00:00.000,London / Queen's Club England ATP World Tour,GRASS,2,Guy Forget,Goran Ivanisevic,Guy Forget,6-3; 7-6(3),Q,65,10,3,37,61,35,37,14,24,1,1,11,49,61,17,5,37,65,27,37,16,28,4,5,10,43,65
1995-06-12 00:00:00.000,London / Queen's Club England ATP World Tour,GRASS,2,Boris Becker,Jason Stoltenberg,Boris Becker,6-4; 6-1,Q,55,8,4,31,54,24,31,12,23,1,2,9,36,54,4,3,22,43,14,22,8,21,6,10,8,22,43
1995-06-12 00:00:00.000,London / Queen's Club England ATP World Tour,GRASS,2,Pete Sampras,Marc-Kevin Goellner,Pete Sampras,6-7(4); 6-2; 13-11,S,132,19,5,76,129,58,76,31,53,4,7,22,89,129,20,13,55,136,43,55,40,81,5,11,22,83,136
1995-06-12 00:00:00.000,London / Queen's Club England ATP World Tour,GRASS,2,Guy Forget,Boris Becker,Guy Forget,4-6; 6-3; 6-4,S,106,10,6,62,96,43,62,21,34,6,7,15,64,96,10,5,43,81,33,43,24,38,6,8,14,57,81
1995-06-12 00:00:00.000,London / Queen's Club England ATP World Tour,GRASS,2,Pete Sampras,Guy Forget,Pete Sampras,7-6(3); 7-6(6),F,77,21,0,39,68,36,39,22,29,0,0,12,58,68,15,3,43,71,38,43,17,28,0,0,12,55,71
1995-06-12 00:00:00.000,Oporto Portugal ATP World Tour,CLAY,2,Alberto Berasategui,Stefano Pescosolido,Alberto Berasategui,7-5; 4-6; 6-3,R32,118,3,2,61,83,35,61,11,22,3,9,15,46,83,5,3,65,115,39,65,18,50,9,17,16,57,115
1995-06-12 00:00:00.000,Oporto Portugal ATP World Tour,CLAY,2,Emilio Sanchez,Frederic Fontang,Emilio Sanchez,6-4; 6-4,R32,91,3,0,32,56,24,32,14,24,3,5,10,38,56,1,2,46,74,29,46,11,28,6,10,10,40,74
1995-06-12 00:00:00.000,Oporto Portugal ATP World Tour,CLAY,2,Emanuel Couto,Jeff Tarango,Emanuel Couto,6-4; 6-4,R32,85,2,0,37,55,29,37,9,18,3,4,10,38,55,1,8,40,73,30,40,13,33,4,7,10,43,73
1995-06-12 00:00:00.000,Oporto Portugal ATP World Tour,CLAY,2,Filip Dewulf,Christian Ruud,Filip Dewulf,7-6(4); 7-5,R32,120,4,2,39,67,25,39,8,28,0,6,12,33,67,1,4,57,101,25,57,21,44,8,15,12,46,101
1995-06-12 00:00:00.000,Oporto Portugal ATP World Tour,CLAY,2,Richard Fromberg,Tomas Carbonell,Richard Fromberg,1-6; 6-4; 7-5,R32,144,10,6,58,100,39,58,16,42,5,10,14,55,100,0,5,74,105,45,74,16,31,8,13,15,61,105
1995-06-12 00:00:00.000,Oporto Portugal ATP World Tour,CLAY,2,Nuno Marques,Oscar Martinez,Nuno Marques,2-6; 6-2; 6-3,R32,98,2,0,62,90,41,62,13,28,11,14,12,54,90,7,3,41,86,27,41,20,45,5,10,13,47,86
1995-06-12 00:00:00.000,Oporto Portugal ATP World Tour,CLAY,2,Donald Johnson,Joao Cunha-Silva,Donald Johnson,6-3; 6-7(5); 6-4,R32,150,7,3,75,108,47,75,16,33,7,10,15,63,108,0,6,67,105,40,67,18,38,7,13,16,58,105
1995-06-12 00:00:00.000,Oporto Portugal ATP World Tour,CLAY,2,Francisco Clavet,Magnus Gustafsson,Francisco Clavet,3-6; 7-5; 6-3,R32,137,2,4,53,91,33,53,19,38,5,10,15,52,91,3,3,64,106,37,64,21,42,10,16,15,58,106
1995-06-12 00:00:00.000,Oporto Portugal ATP World Tour,CLAY,2,Carsten Arriens,Albert Costa,Carsten Arriens,3-6; 6-3; 6-2,R32,114,3,8,55,100,37,55,22,45,7,9,13,59,100,1,0,47,76,29,47,19,29,3,7,13,48,76
1995-06-12 00:00:00.000,Oporto Portugal ATP World Tour,CLAY,2,Kris Goossens,Alejo Mancisidor,Kris Goossens,6-4; 6-3,R32,88,3,3,24,52,16,24,16,28,4,6,9,32,52,0,2,37,66,21,37,13,29,4,9,10,34,66
1995-06-12 00:00:00.000,Oporto Portugal ATP World Tour,CLAY,2,Alex Lopez Moron,Ronald Agenor,Alex Lopez Moron,7-6(2); 6-3,R32,91,0,1,38,63,30,38,16,25,2,3,10,46,63,2,0,51,85,34,51,14,34,5,8,11,48,85
1995-06-12 00:00:00.000,Oporto Portugal ATP World Tour,CLAY,2,Hernan Gumy,Alex Corretja,Hernan Gumy,6-2; 6-4,R32,85,0,2,30,52,21,30,14,22,1,2,9,35,52,1,3,35,53,21,35,6,18,1,5,9,27,53
1995-06-12 00:00:00.000,Oporto Portugal ATP World Tour,CLAY,2,Carlos Costa,Carl-Uwe Steeb,Carlos Costa,6-1; 6-4,R32,74,2,2,30,57,21,30,14,27,3,5,9,35,57,1,3,32,60,21,32,6,28,6,11,8,27,60
1995-06-12 00:00:00.000,Oporto Portugal ATP World Tour,CLAY,2,Carlos Moya,Sandor Noszaly,Carlos Moya,6-3; 3-6; 6-4,R32,128,0,1,58,92,31,58,17,34,6,12,14,48,92,1,5,67,89,37,67,8,22,3,10,14,45,89
1995-06-12 00:00:00.000,Oporto Portugal ATP World Tour,CLAY,2,Jordi Arrese,Andrei Cherkasov,Jordi Arrese,5-7; 6-1; 6-1,R32,117,2,3,49,81,35,49,17,32,3,5,13,52,81,1,3,51,89,30,51,18,38,7,13,13,48,89
1995-06-12 00:00:00.000,Oporto Portugal ATP World Tour,CLAY,2,Bernd Karbacher,Juan Albert Viloca-Puig,Bernd Karbacher,7-5 RET,R32,54,2,2,12,41,8,12,15,29,1,3,6,23,41,0,3,34,49,21,34,4,15,5,8,6,25,49
1995-06-12 00:00:00.000,Oporto Portugal ATP World Tour,CLAY,2,Alberto Berasategui,Emilio Sanchez,Alberto Berasategui,7-5; 7-6(12),R16,110,4,3,69,88,44,69,10,19,2,5,12,54,88,5,2,60,99,40,60,15,39,7,11,12,55,99
1995-06-12 00:00:00.000,Oporto Portugal ATP World Tour,CLAY,2,Filip Dewulf,Emanuel Couto,Filip Dewulf,6-3; 2-6; 7-6(5),R16,153,4,4,72,124,40,72,27,52,13,18,15,67,124,4,3,58,92,35,58,17,34,6,10,14,52,92
1995-06-12 00:00:00.000,Oporto Portugal ATP World Tour,CLAY,2,Richard Fromberg,Nuno Marques,Richard Fromberg,6-4; 3-6; 7-6(4),R16,137,10,2,56,91,44,56,18,35,2,5,16,62,91,3,3,70,100,46,70,17,30,6,8,15,63,100
1995-06-12 00:00:00.000,Oporto Portugal ATP World Tour,CLAY,2,Francisco Clavet,Donald Johnson,Francisco Clavet,3-6; 7-6(5); 6-3,R16,130,1,4,69,106,43,69,19,37,6,11,16,62,106,6,8,44,84,38,44,16,40,3,7,14,54,84
1995-06-12 00:00:00.000,Oporto Portugal ATP World Tour,CLAY,2,Carsten Arriens,Kris Goossens,Carsten Arriens,3-6; 7-5; 6-1,R16,118,4,2,54,90,37,54,13,36,5,10,14,50,90,0,3,41,83,26,41,15,42,6,13,14,41,83
1995-06-12 00:00:00.000,Oporto Portugal ATP World Tour,CLAY,2,Hernan Gumy,Alex Lopez Moron,Hernan Gumy,6-2; 3-6; 6-3,R16,141,3,1,51,79,36,51,16,28,4,6,13,52,79,4,1,45,95,30,45,24,50,8,12,13,54,95
1995-06-12 00:00:00.000,Oporto Portugal ATP World Tour,CLAY,2,Carlos Costa,Carlos Moya,Carlos Costa,7-6(2); 6-2,R16,103,3,0,40,71,30,40,18,31,3,4,10,48,71,1,1,53,79,28,53,18,26,9,12,10,46,79
1995-06-12 00:00:00.000,Oporto Portugal ATP World Tour,CLAY,2,Jordi Arrese,Bernd Karbacher,Jordi Arrese,6-1; 6-3,R16,57,1,1,29,40,22,29,5,11,2,4,8,27,40,0,4,24,49,11,24,7,25,0,6,8,18,49
1995-06-12 00:00:00.000,Oporto Portugal ATP World Tour,CLAY,2,Alberto Berasategui,Filip Dewulf,Alberto Berasategui,6-2; 6-1,Q,50,1,2,34,42,28,34,5,8,2,2,8,33,42,0,3,24,55,14,24,13,31,3,7,7,27,55
1995-06-12 00:00:00.000,Oporto Portugal ATP World Tour,CLAY,2,Francisco Clavet,Richard Fromberg,Francisco Clavet,W/O,Q,0,0,0,0,0,0,0,0,0,0,0,0,0,0,0,0,0,0,0,0,0,0,0,0,0,0,0
1995-06-12 00:00:00.000,Oporto Portugal ATP World Tour,CLAY,2,Hernan Gumy,Carsten Arriens,Hernan Gumy,6-1; 6-2,Q,62,1,1,30,45,22,30,9,15,0,1,8,31,45,0,4,14,39,8,14,9,25,2,7,7,17,39
1995-06-12 00:00:00.000,Oporto Portugal ATP World Tour,CLAY,2,Carlos Costa,Jordi Arrese,Carlos Costa,4-6; 6-4; 7-6(5),Q,166,1,4,52,95,40,52,20,43,6,11,16,60,95,0,1,84,117,47,84,18,33,11,16,16,65,117
1995-06-12 00:00:00.000,Oporto Portugal ATP World Tour,CLAY,2,Alberto Berasategui,Francisco Clavet,Alberto Berasategui,6-4; 6-4,S,99,2,1,57,74,36,57,9,17,3,5,10,45,74,1,1,47,71,27,47,12,24,5,9,10,39,71
1995-06-12 00:00:00.000,Oporto Portugal ATP World Tour,CLAY,2,Carlos Costa,Hernan Gumy,Carlos Costa,7-6(0); 3-6; 6-4,S,152,4,2,46,100,33,46,29,54,8,12,15,62,100,3,6,65,104,45,65,17,39,8,12,16,62,104
1995-06-12 00:00:00.000,Oporto Portugal ATP World Tour,CLAY,2,Alberto Berasategui,Carlos Costa,Alberto Berasategui,3-6; 6-3; 6-4,F,116,1,2,84,106,49,84,13,22,6,9,14,62,106,9,4,54,92,40,54,15,38,6,10,14,55,92
1995-06-12 00:00:00.000,Rosmalen The Netherlands ATP World Tour,GRASS,2,Richard Krajicek,Shuzo Matsuoka,Richard Krajicek,4-6; 6-3; 7-6(3),R32,138,17,7,55,108,43,55,29,53,14,16,16,72,108,6,11,62,116,43,62,30,54,14,16,15,73,116
1995-06-12 00:00:00.000,Rosmalen The Netherlands ATP World Tour,GRASS,2,Alex O'Brien,Tom Kempers,Alex O'Brien,4-6; 7-6(5); 6-2,R32,136,7,9,61,119,42,61,31,58,7,9,15,73,119,12,5,64,99,50,64,13,35,4,7,15,63,99
1995-06-12 00:00:00.000,Rosmalen The Netherlands ATP World Tour,GRASS,2,Anders Jarryd,Hendrik Jan Davids,Anders Jarryd,7-6(7); 6-2,R32,112,4,6,38,72,27,38,19,34,4,6,10,46,72,3,4,52,94,30,52,21,42,13,17,10,51,94
1995-06-12 00:00:00.000,Rosmalen The Netherlands ATP World Tour,GRASS,2,Jan Siemerink,Joern Renzenbrink,Jan Siemerink,6-4; 6-3,R32,76,3,5,27,53,24,27,14,26,2,3,10,38,53,8,6,35,69,25,35,15,34,5,8,9,40,69
1995-06-12 00:00:00.000,Rosmalen The Netherlands ATP World Tour,GRASS,2,Richey Reneberg,Guillaume Raoux,Richey Reneberg,7-6(5); 2-6; 6-1,R32,116,5,9,48,89,31,48,19,41,2,7,14,50,89,6,8,56,106,34,56,24,50,9,14,13,58,106
1995-06-12 00:00:00.000,Rosmalen The Netherlands ATP World Tour,GRASS,2,Andrei Olhovskiy,Patrick Baur,Andrei Olhovskiy,6-2; 6-4,R32,67,5,2,32,64,25,32,19,32,5,5,9,44,64,5,5,26,52,19,26,13,26,3,6,9,32,52
1995-06-12 00:00:00.000,Rosmalen The Netherlands ATP World Tour,GRASS,2,Dick Norman,Sjeng Schalken,Dick Norman,6-0; 6-4,R32,55,4,6,26,40,24,26,8,14,0,0,8,32,40,3,5,34,57,19,34,9,23,6,10,8,28,57
1995-06-12 00:00:00.000,Rosmalen The Netherlands ATP World Tour,GRASS,2,Brett Steven,Karsten Braasch,Brett Steven,7-6(2); 6-4,R32,84,5,3,47,69,38,47,14,22,4,4,11,52,69,4,2,38,70,29,38,16,32,1,2,11,45,70
1995-06-12 00:00:00.000,Rosmalen The Netherlands ATP World Tour,GRASS,2,Karol Kucera,Eyal Erlich,Karol Kucera,3-6; 6-4; 6-0,R32,93,6,10,44,81,31,44,16,37,5,9,13,47,81,1,2,45,68,28,45,9,23,2,8,12,37,68
1995-06-12 00:00:00.000,Rosmalen The Netherlands ATP World Tour,GRASS,2,Arne Thoms,Jordi Burillo,Arne Thoms,6-1; 7-5,R32,67,5,8,35,65,30,35,15,30,2,2,10,45,65,4,6,28,58,19,28,14,30,5,8,9,33,58
1995-06-12 00:00:00.000,Rosmalen The Netherlands ATP World Tour,GRASS,2,Henri Leconte,Jan Kroslak,Henri Leconte,6-3; 7-6(5),R32,94,7,15,40,82,31,40,21,42,7,8,10,52,82,9,11,56,90,36,56,13,34,10,13,11,49,90
1995-06-12 00:00:00.000,Rosmalen The Netherlands ATP World Tour,GRASS,2,Paul Haarhuis,Nicolas Pereira,Paul Haarhuis,2-6; 7-6(4); 6-3,R32,108,6,12,59,116,45,59,23,57,11,15,15,68,116,7,9,46,87,37,46,21,41,5,8,14,58,87
1995-06-12 00:00:00.000,Rosmalen The Netherlands ATP World Tour,GRASS,2,Cedric Pioline,Rogier Wassen,Cedric Pioline,7-6(3); 6-4,R32,81,3,5,35,62,31,35,18,27,0,0,11,49,62,4,2,37,66,30,37,16,29,2,3,11,46,66
1995-06-12 00:00:00.000,Rosmalen The Netherlands ATP World Tour,GRASS,2,Henrik Holm,Fernon Wibier,Henrik Holm,7-6(6); 7-6(0),R32,92,5,8,38,74,37,38,18,36,2,3,12,55,74,2,3,44,70,34,44,15,26,0,1,12,49,70
1995-06-12 00:00:00.000,Rosmalen The Netherlands ATP World Tour,GRASS,2,Diego Nargiso,Paul Wekesa,Diego Nargiso,6-2; 6-1,R32,51,8,4,28,50,23,28,13,22,2,2,8,36,50,1,2,19,40,8,19,10,21,1,5,7,18,40
1995-06-12 00:00:00.000,Rosmalen The Netherlands ATP World Tour,GRASS,2,Jacco Eltingh,Wally Masur,Jacco Eltingh,6-2; 6-4,R32,65,7,1,26,45,22,26,14,19,0,0,9,36,45,5,5,28,63,18,28,16,35,5,8,9,34,63
1995-06-12 00:00:00.000,Rosmalen The Netherlands ATP World Tour,GRASS,2,Richard Krajicek,Alex O'Brien,Richard Krajicek,6-3; 6-3,R16,13,12,7,26,50,25,26,9,24,1,2,9,34,50,0,7,39,57,27,39,4,18,4,8,9,31,57
1995-06-12 00:00:00.000,Rosmalen The Netherlands ATP World Tour,GRASS,2,Anders Jarryd,Jan Siemerink,Anders Jarryd,6-4; 6-7(3); 7-6(5),R16,146,6,6,66,117,50,66,30,51,2,4,17,80,117,6,8,63,120,47,63,31,57,8,11,17,78,120
1995-06-12 00:00:00.000,Rosmalen The Netherlands ATP World Tour,GRASS,2,Richey Reneberg,Andrei Olhovskiy,Richey Reneberg,3-6; 6-1; 6-1,R16,83,3,9,38,65,31,38,11,27,2,4,11,42,65,6,7,32,72,22,32,17,40,5,11,12,39,72
1995-06-12 00:00:00.000,Rosmalen The Netherlands ATP World Tour,GRASS,2,Brett Steven,Dick Norman,Brett Steven,7-5; 6-4,R16,75,2,1,41,56,33,41,11,15,0,0,11,44,56,6,10,40,73,31,40,16,33,3,5,11,47,73
1995-06-12 00:00:00.000,Rosmalen The Netherlands ATP World Tour,GRASS,2,Karol Kucera,Arne Thoms,Karol Kucera,7-6(3); 7-5,R16,82,1,4,40,71,34,40,19,31,2,2,12,53,71,1,4,45,69,36,45,12,24,0,1,12,48,69
1995-06-12 00:00:00.000,Rosmalen The Netherlands ATP World Tour,GRASS,2,Paul Haarhuis,Henri Leconte,Paul Haarhuis,6-7(5); 6-3; 6-2,R16,111,5,4,59,98,44,59,22,39,4,5,15,66,98,6,13,43,94,30,43,26,51,7,11,14,56,94
1995-06-12 00:00:00.000,Rosmalen The Netherlands ATP World Tour,GRASS,2,Henrik Holm,Cedric Pioline,Henrik Holm,7-5; 7-6(4),R16,111,5,11,50,86,37,50,14,36,8,12,12,51,86,1,11,46,86,30,46,15,40,6,11,12,45,86
1995-06-12 00:00:00.000,Rosmalen The Netherlands ATP World Tour,GRASS,2,Diego Nargiso,Jacco Eltingh,Diego Nargiso,7-6(5); 6-4,R16,79,13,7,34,70,28,34,19,36,2,5,11,47,70,1,6,53,80,36,53,12,27,8,12,11,48,80
1995-06-12 00:00:00.000,Rosmalen The Netherlands ATP World Tour,GRASS,2,Anders Jarryd,Richard Krajicek,Anders Jarryd,6-4; 6-2,Q,66,0,2,32,51,22,32,15,19,1,1,9,37,51,4,3,39,68,25,39,15,29,8,11,9,40,68
1995-06-12 00:00:00.000,Rosmalen The Netherlands ATP World Tour,GRASS,2,Brett Steven,Richey Reneberg,Brett Steven,6-3; 6-1,Q,55,2,5,32,48,26,32,8,16,2,2,8,34,48,1,2,24,45,13,24,9,21,2,6,8,22,45
1995-06-12 00:00:00.000,Rosmalen The Netherlands ATP World Tour,GRASS,2,Karol Kucera,Paul Haarhuis,Karol Kucera,6-3; 6-2,Q,58,4,6,29,58,25,29,16,29,1,1,9,41,58,1,4,29,46,19,29,7,17,5,8,8,26,46
1995-06-12 00:00:00.000,Rosmalen The Netherlands ATP World Tour,GRASS,2,Henrik Holm,Diego Nargiso,Henrik Holm,6-4; 6-4,Q,62,2,2,25,49,22,25,18,24,0,0,10,40,49,1,6,30,56,22,30,14,26,1,3,10,36,56
1995-06-12 00:00:00.000,Rosmalen The Netherlands ATP World Tour,GRASS,2,Anders Jarryd,Brett Steven,Anders Jarryd,6-3; 3-1 RET,S,62,2,1,17,34,16,17,9,17,0,0,7,25,34,3,7,29,52,17,29,10,23,3,6,7,27,52
1995-06-12 00:00:00.000,Rosmalen The Netherlands ATP World Tour,GRASS,2,Karol Kucera,Henrik Holm,Karol Kucera,4-6; 6-3; 6-2,S,114,3,8,49,86,36,49,23,37,4,6,14,59,86,5,15,41,96,29,41,25,55,7,11,13,54,96
1995-06-12 00:00:00.000,Rosmalen The Netherlands ATP World Tour,GRASS,2,Karol Kucera,Anders Jarryd,Karol Kucera,7-6(7); 7-6(4),F,118,4,7,38,76,31,38,22,38,0,2,12,53,76,1,10,54,102,41,54,25,48,4,6,12,66,102
1995-06-19 00:00:00.000,Halle Germany ATP World Tour,GRASS,2,Yevgeny Kafelnikov,Daniel Vacek,Yevgeny Kafelnikov,6-4; 6-3,R32,59,8,2,21,49,19,21,19,28,1,1,9,38,49,5,10,35,60,29,35,7,25,6,9,10,36,60
1995-06-19 00:00:00.000,Halle Germany ATP World Tour,GRASS,2,Hendrik Dreekmann,Patrik Kuhnen,Hendrik Dreekmann,6-4; 6-4,R32,86,7,4,22,58,18,22,23,36,0,1,10,41,58,7,3,41,65,27,41,10,24,4,7,10,37,65
1995-06-19 00:00:00.000,Halle Germany ATP World Tour,GRASS,2,Paul Haarhuis,Anders Jarryd,Paul Haarhuis,4-6; 7-5; 6-3,R32,101,2,3,58,88,40,58,17,30,4,7,16,57,88,4,5,44,86,33,44,21,42,3,7,15,54,86
1995-06-19 00:00:00.000,Halle Germany ATP World Tour,GRASS,2,Patrick McEnroe,Bernd Karbacher,Patrick McEnroe,6-4; 6-1,R32,65,1,4,39,60,30,39,10,21,4,5,9,40,60,6,6,24,55,17,24,10,31,3,7,8,27,55
1995-06-19 00:00:00.000,Halle Germany ATP World Tour,GRASS,2,Michael Stich,David Prinosil,Michael Stich,7-5; 3-6; 6-3,R32,92,14,3,48,82,39,48,19,34,3,5,15,58,82,5,15,49,95,39,49,21,46,12,15,15,60,95
1995-06-19 00:00:00.000,Halle Germany ATP World Tour,GRASS,2,Sjeng Schalken,Henri Leconte,Sjeng Schalken,2-6; 7-5; 6-4,R32,124,11,4,63,99,41,63,23,36,3,5,15,64,99,6,11,63,111,46,63,24,48,13,15,15,70,111
1995-06-19 00:00:00.000,Halle Germany ATP World Tour,GRASS,2,Arnaud Boetsch,Guy Forget,Arnaud Boetsch,4-6; 7-5; 7-6(5),R32,130,7,8,63,104,48,63,27,41,4,5,17,75,104,11,9,72,113,62,72,17,41,7,8,17,79,113
1995-06-19 00:00:00.000,Halle Germany ATP World Tour,GRASS,2,Richey Reneberg,Jim Courier,Richey Reneberg,6-7(5); 6-3; 7-6(10),R32,133,13,4,54,101,44,54,35,47,1,1,16,79,101,9,6,64,109,50,64,28,45,0,2,17,78,109
1995-06-19 00:00:00.000,Halle Germany ATP World Tour,GRASS,2,Martin Sinner,Alberto Berasategui,Martin Sinner,6-3; 6-2,R32,59,7,9,32,72,25,32,20,40,5,6,9,45,72,3,1,29,44,16,29,7,15,3,7,8,23,44
1995-06-19 00:00:00.000,Halle Germany ATP World Tour,GRASS,2,Jimmy Connors,Sebastien Lareau,Jimmy Connors,6-4; 7-6(2),R32,99,5,6,49,87,34,49,19,38,6,8,11,53,87,14,7,37,67,30,37,11,30,3,6,11,41,67
1995-06-19 00:00:00.000,Halle Germany ATP World Tour,GRASS,2,Olivier Delaitre,Jan Siemerink,Olivier Delaitre,3-6; 6-2; 6-3,R32,93,2,9,43,76,35,43,17,33,3,4,13,52,76,12,7,50,93,38,50,18,43,7,10,13,56,93
1995-06-19 00:00:00.000,Halle Germany ATP World Tour,GRASS,2,Marc Rosset,Andrei Olhovskiy,Marc Rosset,6-4; 7-5,R32,64,13,6,35,61,28,35,16,26,3,4,11,44,61,7,3,30,61,21,30,18,31,3,6,11,39,61
1995-06-19 00:00:00.000,Halle Germany ATP World Tour,GRASS,2,Jacco Eltingh,Andrei Medvedev,Jacco Eltingh,7-6(1); 3-6; 6-3,R32,103,7,5,59,92,45,59,18,33,2,4,15,63,92,19,7,47,86,42,47,16,39,1,3,15,58,86
1995-06-19 00:00:00.000,Halle Germany ATP World Tour,GRASS,2,Sander Groen,Aleksandar Kitinov,Sander Groen,6-2; 6-1,R32,44,2,1,24,37,18,24,10,13,0,0,7,28,37,1,5,29,48,17,29,4,19,5,10,8,21,48
1995-06-19 00:00:00.000,Halle Germany ATP World Tour,GRASS,2,Brett Steven,Vincent Spadea,Brett Steven,6-4; 6-4,R32,77,0,3,37,63,29,37,17,26,4,4,10,46,63,3,2,45,66,32,45,10,21,7,9,10,42,66
1995-06-19 00:00:00.000,Halle Germany ATP World Tour,GRASS,2,Wayne Ferreira,Paul Wekesa,Wayne Ferreira,6-3; 3-6; 6-3,R32,98,8,5,34,84,29,34,27,50,5,7,14,56,84,0,6,47,76,31,47,14,29,2,5,13,45,76
1995-06-19 00:00:00.000,Halle Germany ATP World Tour,GRASS,2,Yevgeny Kafelnikov,Hendrik Dreekmann,Yevgeny Kafelnikov,6-4; 6-2,R16,66,5,3,31,57,23,31,15,26,3,4,9,38,57,4,6,28,60,19,28,13,32,5,9,9,32,60
1995-06-19 00:00:00.000,Halle Germany ATP World Tour,GRASS,2,Paul Haarhuis,Patrick McEnroe,Paul Haarhuis,4-6; 7-5; 6-4,R16,138,10,9,66,110,45,66,19,44,6,10,16,64,110,1,3,62,105,43,62,18,43,8,13,16,61,105
1995-06-19 00:00:00.000,Halle Germany ATP World Tour,GRASS,2,Michael Stich,Sjeng Schalken,Michael Stich,4-6; 6-4; 6-2,R16,112,10,5,54,86,40,54,19,32,4,6,14,59,86,4,11,67,118,40,67,24,51,10,14,14,64,118
1995-06-19 00:00:00.000,Halle Germany ATP World Tour,GRASS,2,Richey Reneberg,Arnaud Boetsch,Richey Reneberg,6-7(7); 7-6(5); 6-1,R16,124,7,9,69,128,50,69,26,59,11,14,16,76,128,7,5,69,99,42,69,16,30,2,7,15,58,99
1995-06-19 00:00:00.000,Halle Germany ATP World Tour,GRASS,2,Jimmy Connors,Martin Sinner,Jimmy Connors,7-6(9); 6-0,R16,89,2,4,37,70,29,37,16,33,2,3,9,45,70,6,11,25,64,19,25,15,39,2,6,9,34,64
1995-06-19 00:00:00.000,Halle Germany ATP World Tour,GRASS,2,Marc Rosset,Olivier Delaitre,Marc Rosset,7-5; 6-3,R16,74,14,10,38,68,31,38,14,30,1,2,11,45,68,2,3,31,66,22,31,16,35,2,5,10,38,66
1995-06-19 00:00:00.000,Halle Germany ATP World Tour,GRASS,2,Jacco Eltingh,Sander Groen,Jacco Eltingh,6-4; 7-6(5),R16,88,2,2,59,84,44,59,12,25,6,7,11,56,84,4,5,54,72,39,54,7,18,3,5,11,46,72
1995-06-19 00:00:00.000,Halle Germany ATP World Tour,GRASS,2,Brett Steven,Wayne Ferreira,Brett Steven,6-1; 7-6(1),R16,86,1,3,49,75,35,49,12,26,5,7,10,47,75,4,7,34,65,20,34,13,31,1,5,9,33,65
1995-06-19 00:00:00.000,Halle Germany ATP World Tour,GRASS,2,Paul Haarhuis,Yevgeny Kafelnikov,Paul Haarhuis,6-1; 7-6(5),Q,72,6,3,39,65,28,39,13,26,1,3,9,41,65,3,10,36,72,26,36,12,36,4,9,10,38,72
1995-06-19 00:00:00.000,Halle Germany ATP World Tour,GRASS,2,Michael Stich,Richey Reneberg,Michael Stich,6-3; 6-4,Q,75,6,4,32,61,27,32,16,29,4,5,10,43,61,2,4,31,61,20,31,14,30,4,7,9,34,61
1995-06-19 00:00:00.000,Halle Germany ATP World Tour,GRASS,2,Marc Rosset,Jimmy Connors,Marc Rosset,7-6(3); 6-3,Q,101,16,8,28,65,22,28,24,37,1,2,11,46,65,2,2,51,78,35,51,9,27,7,9,10,44,78
1995-06-19 00:00:00.000,Halle Germany ATP World Tour,GRASS,2,Jacco Eltingh,Brett Steven,Jacco Eltingh,6-3; 5-7; 6-4,Q,109,2,3,74,91,53,74,8,17,3,6,16,61,91,3,6,61,86,39,61,13,25,6,10,15,52,86
1995-06-19 00:00:00.000,Halle Germany ATP World Tour,GRASS,2,Michael Stich,Paul Haarhuis,Michael Stich,7-6(4); 6-1,S,74,5,3,29,61,22,29,25,32,1,1,10,47,61,2,3,27,52,21,27,13,25,0,2,9,34,52
1995-06-19 00:00:00.000,Halle Germany ATP World Tour,GRASS,2,Marc Rosset,Jacco Eltingh,Marc Rosset,7-6(4); 7-5,S,84,14,5,36,65,33,36,21,29,0,0,12,54,65,10,6,45,73,40,45,13,28,5,6,12,53,73
1995-06-19 00:00:00.000,Halle Germany ATP World Tour,GRASS,2,Marc Rosset,Michael Stich,Marc Rosset,3-6; 7-6(11); 7-6(8),F,136,14,10,66,118,55,66,28,52,4,5,16,83,118,9,4,66,116,58,66,33,50,2,2,17,91,116
1995-06-19 00:00:00.000,Nottingham England ATP World Tour,GRASS,2,Thomas Enqvist,Colin Beecher,Thomas Enqvist,6-2; 6-3,R32,67,8,4,23,56,20,23,17,33,4,5,9,37,56,2,2,24,46,15,24,8,22,0,4,8,23,46
1995-06-19 00:00:00.000,Nottingham England ATP World Tour,GRASS,2,Byron Black,Jan Apell,Byron Black,7-6(4); 6-3,R32,14,3,2,43,69,36,43,17,26,0,0,11,53,69,9,5,33,60,27,33,15,27,2,3,10,42,60
1995-06-19 00:00:00.000,Nottingham England ATP World Tour,GRASS,2,Tommy Ho,Nick Gould,Tommy Ho,6-3; 6-3,R32,77,11,1,30,52,23,30,14,22,0,0,9,37,52,2,3,36,72,25,36,13,36,7,10,9,38,72
1995-06-19 00:00:00.000,Nottingham England ATP World Tour,GRASS,2,Marcelo Rios,Cedric Pioline,Marcelo Rios,6-2; 7-5,R32,81,1,4,56,76,37,56,9,20,9,11,10,46,76,3,5,32,59,21,32,8,27,3,8,10,29,59
1995-06-19 00:00:00.000,Nottingham England ATP World Tour,GRASS,2,Alexander Volkov,Jeremy Bates,Alexander Volkov,7-5; 7-5,R32,79,9,6,38,70,30,38,15,32,6,9,12,45,70,5,5,39,76,25,39,16,37,5,10,12,41,76
1995-06-19 00:00:00.000,Nottingham England ATP World Tour,GRASS,2,Gianluca Pozzi,Jonathan Stark,Gianluca Pozzi,6-7(5); 7-6(0); 6-4,R32,129,4,7,68,126,56,68,29,58,5,6,17,85,126,15,10,66,104,56,66,14,38,3,5,17,70,104
1995-06-19 00:00:00.000,Nottingham England ATP World Tour,GRASS,2,Javier Frana,Greg Rusedski,Javier Frana,6-3; 7-6(4),R32,74,3,3,29,64,25,29,21,35,4,4,10,46,64,11,7,43,78,33,43,15,35,9,11,11,48,78
1995-06-19 00:00:00.000,Nottingham England ATP World Tour,GRASS,2,Patrick Rafter,Bryan Shelton,Patrick Rafter,6-7(3); 6-1; 6-2,R32,107,12,3,42,80,36,42,20,38,1,2,13,56,80,6,9,46,91,28,46,21,45,4,10,14,49,91
1995-06-19 00:00:00.000,Nottingham England ATP World Tour,GRASS,2,MaliVai Washington,Lionel Roux,MaliVai Washington,6-4; 6-2,R32,57,7,1,30,42,27,30,9,12,0,0,9,36,42,2,3,25,58,18,25,16,33,5,8,9,34,58
1995-06-19 00:00:00.000,Nottingham England ATP World Tour,GRASS,2,Shuzo Matsuoka,Jared Palmer,Shuzo Matsuoka,4-6; 6-4; 6-3,R32,111,9,5,58,90,46,58,20,32,6,7,15,66,90,5,8,40,84,32,40,23,44,5,7,14,55,84
1995-06-19 00:00:00.000,Nottingham England ATP World Tour,GRASS,2,Kenneth Carlsen,Karol Kucera,Kenneth Carlsen,6-2; 6-2,R32,55,4,0,30,48,23,30,12,18,4,4,8,35,48,1,2,34,48,20,34,5,14,1,5,8,25,48
1995-06-19 00:00:00.000,Nottingham England ATP World Tour,GRASS,2,Mark Woodforde,Chris Wilkinson,Mark Woodforde,7-6(4); 2-6; 6-3,R32,111,3,6,58,90,45,58,18,32,4,6,15,63,90,10,2,55,89,36,55,25,34,2,3,14,61,89
1995-06-19 00:00:00.000,Nottingham England ATP World Tour,GRASS,2,Todd Woodbridge,Oliver Gross,Todd Woodbridge,6-2; 3-6; 6-3,R32,86,3,5,38,72,32,38,18,34,5,7,13,50,72,8,9,57,89,42,57,11,32,4,8,13,53,89
1995-06-19 00:00:00.000,Nottingham England ATP World Tour,GRASS,2,Guillaume Raoux,Danny Sapsford,Guillaume Raoux,5-7; 7-6(5); 6-3,R32,116,12,6,54,94,39,54,23,40,0,3,16,62,94,5,3,42,101,30,42,33,59,3,7,17,63,101
1995-06-19 00:00:00.000,Nottingham England ATP World Tour,GRASS,2,Martin Damm,Mark Petchey,Martin Damm,3-6; 6-3; 6-1,R32,112,5,4,45,72,35,45,12,27,4,6,12,47,72,7,6,70,110,45,70,14,40,19,24,13,59,110
1995-06-19 00:00:00.000,Nottingham England ATP World Tour,GRASS,2,Tim Henman,Jonas Bjorkman,Tim Henman,7-6(7); 7-5,R32,95,2,4,40,75,32,40,19,35,3,5,12,51,75,2,7,47,88,33,47,18,41,5,8,12,51,88
1995-06-19 00:00:00.000,Nottingham England ATP World Tour,GRASS,2,Byron Black,Thomas Enqvist,Byron Black,5-7; 6-3; 7-6(8),R16,120,4,2,71,108,51,71,20,37,3,5,16,71,108,21,10,61,109,45,61,22,48,1,4,17,67,109
1995-06-19 00:00:00.000,Nottingham England ATP World Tour,GRASS,2,Tommy Ho,Marcelo Rios,Tommy Ho,6-4; 6-0,R16,44,5,5,30,45,26,30,8,15,1,1,8,34,45,3,1,25,46,14,25,11,21,2,6,8,25,46
1995-06-19 00:00:00.000,Nottingham England ATP World Tour,GRASS,2,Alexander Volkov,Gianluca Pozzi,Alexander Volkov,6-3; 4-6; 6-4,R16,15,5,8,55,99,38,55,18,44,6,10,14,56,99,10,9,48,98,37,48,19,50,10,16,15,56,98
1995-06-19 00:00:00.000,Nottingham England ATP World Tour,GRASS,2,Javier Frana,Patrick Rafter,Javier Frana,6-2; 7-6(4),R16,76,6,1,30,59,25,30,19,29,0,0,10,44,59,3,4,37,70,30,37,13,33,2,4,10,43,70
1995-06-19 00:00:00.000,Nottingham England ATP World Tour,GRASS,2,Shuzo Matsuoka,MaliVai Washington,Shuzo Matsuoka,6-2; 7-6(4),R16,83,11,0,41,67,32,41,17,26,6,6,10,49,67,3,2,34,58,24,34,14,24,1,3,10,38,58
1995-06-19 00:00:00.000,Nottingham England ATP World Tour,GRASS,2,Mark Woodforde,Kenneth Carlsen,Mark Woodforde,6-4; 6-2,R16,80,1,4,27,45,22,27,11,18,0,1,9,33,45,8,3,57,87,35,57,9,30,9,13,9,44,87
1995-06-19 00:00:00.000,Nottingham England ATP World Tour,GRASS,2,Todd Woodbridge,Guillaume Raoux,Todd Woodbridge,6-3; 7-6(1),R16,79,6,6,37,66,32,37,14,29,4,5,10,46,66,3,4,42,69,31,42,10,27,2,5,11,41,69
1995-06-19 00:00:00.000,Nottingham England ATP World Tour,GRASS,2,Tim Henman,Martin Damm,Tim Henman,W/O,R16,0,0,0,0,0,0,0,0,0,0,0,0,0,0,0,0,0,0,0,0,0,0,0,0,0,0,0
1995-06-19 00:00:00.000,Nottingham England ATP World Tour,GRASS,2,Byron Black,Tommy Ho,Byron Black,6-3; 6-4,Q,65,1,4,32,58,27,32,17,26,1,1,10,44,58,5,2,32,56,22,32,13,24,3,5,9,35,56
1995-06-19 00:00:00.000,Nottingham England ATP World Tour,GRASS,2,Javier Frana,Alexander Volkov,Javier Frana,6-3; 7-6(3),Q,68,14,2,32,59,28,32,18,27,1,2,11,46,59,7,6,37,70,27,37,14,33,2,4,10,41,70
1995-06-19 00:00:00.000,Nottingham England ATP World Tour,GRASS,2,Mark Woodforde,Shuzo Matsuoka,Mark Woodforde,6-7(3); 7-6(8); 7-6(4),Q,160,3,9,70,120,55,70,32,50,4,5,18,87,120,11,4,85,135,64,85,28,50,11,12,18,92,135
1995-06-19 00:00:00.000,Nottingham England ATP World Tour,GRASS,2,Todd Woodbridge,Tim Henman,Todd Woodbridge,6-3; 7-6(4),Q,82,3,5,39,60,32,39,8,21,1,3,10,40,60,2,5,47,81,29,47,16,34,8,12,11,45,81
1995-06-19 00:00:00.000,Nottingham England ATP World Tour,GRASS,2,Javier Frana,Byron Black,Javier Frana,7-6(2); 7-5,S,87,12,0,50,76,35,50,14,26,6,8,12,49,76,2,3,49,82,29,49,22,33,8,11,12,51,82
1995-06-19 00:00:00.000,Nottingham England ATP World Tour,GRASS,2,Todd Woodbridge,Mark Woodforde,Todd Woodbridge,6-3; 2-6; 6-4,S,127,9,13,46,94,33,46,23,48,6,10,14,56,94,4,6,58,111,39,58,24,53,13,17,13,63,111
1995-06-19 00:00:00.000,Nottingham England ATP World Tour,GRASS,2,Javier Frana,Todd Woodbridge,Javier Frana,7-6(4); 6-3,F,82,5,2,36,72,27,36,23,36,1,3,11,50,72,3,6,28,61,19,28,20,33,5,8,10,39,61
1995-06-19 00:00:00.000,St. Poelten Austria ATP World Tour,CLAY,2,Thomas Muster,Filip Dewulf,Thomas Muster,4-6; 7-6(7); 6-3,R32,138,7,6,46,98,35,46,31,52,6,8,15,66,98,12,7,83,141,59,83,23,58,13,16,16,82,141
1995-06-19 00:00:00.000,St. Poelten Austria ATP World Tour,CLAY,2,Alex Lopez Moron,Galo Blanco,Alex Lopez Moron,6-3; 6-4,R32,67,5,2,34,55,30,34,13,21,5,5,10,43,55,2,1,39,55,26,39,7,16,3,5,9,33,55
1995-06-19 00:00:00.000,St. Poelten Austria ATP World Tour,CLAY,2,Rodolphe Gilbert,Daniele Bracciali,Rodolphe Gilbert,6-3; 6-4,R32,73,2,1,28,50,22,28,12,22,1,2,9,34,50,5,1,30,58,19,30,11,28,2,6,10,30,58
1995-06-19 00:00:00.000,St. Poelten Austria ATP World Tour,CLAY,2,Sandor Noszaly,Christian Ruud,Sandor Noszaly,6-2; 6-4,R32,73,15,1,44,69,30,44,14,25,5,5,9,44,69,0,4,39,68,23,39,14,29,6,9,9,37,68
1995-06-19 00:00:00.000,St. Poelten Austria ATP World Tour,CLAY,2,Gilbert Schaller,Iztok Bozic,Gilbert Schaller,4-6; 6-3; 6-1,R32,111,3,0,56,76,38,56,13,20,2,4,13,51,76,2,6,63,103,40,63,15,40,12,17,13,55,103
1995-06-19 00:00:00.000,St. Poelten Austria ATP World Tour,CLAY,2,Alejo Mancisidor,Jan Kroslak,Alejo Mancisidor,6-1; 6-4,R32,0,0,0,0,0,0,0,0,0,0,0,0,0,0,0,0,0,0,0,0,0,0,0,0,0,0,0
1995-06-19 00:00:00.000,St. Poelten Austria ATP World Tour,CLAY,2,Stefano Pescosolido,Sasa Hirszon,Stefano Pescosolido,6-2; 6-7(8); 7-6(5),R32,156,8,2,58,106,48,58,29,48,7,9,16,77,106,5,3,70,119,51,70,23,49,11,15,16,74,119
1995-06-19 00:00:00.000,St. Poelten Austria ATP World Tour,CLAY,2,Fabrice Santoro,Carlos Costa,Fabrice Santoro,6-3; 6-3,R32,75,2,2,28,58,18,28,17,30,1,3,9,35,58,4,0,33,61,18,33,13,28,9,14,9,31,61
1995-06-19 00:00:00.000,St. Poelten Austria ATP World Tour,CLAY,2,Javier Sanchez,Carsten Arriens,Javier Sanchez,6-0; 4-6; 6-3,R32,79,1,1,43,64,35,43,13,21,0,2,13,48,64,0,3,43,72,25,43,15,29,5,10,12,40,72
1995-06-19 00:00:00.000,St. Poelten Austria ATP World Tour,CLAY,2,Bohdan Ulihrach,Herbert Wiltschnig,Bohdan Ulihrach,2-6; 6-4; 6-1,R32,106,2,5,53,92,44,53,8,39,9,13,12,52,92,6,3,46,87,28,46,16,41,4,10,13,44,87
1995-06-19 00:00:00.000,St. Poelten Austria ATP World Tour,CLAY,2,Carlos Moya,Andrew Ilie,Carlos Moya,6-4; 1-6; 7-6(0),R32,0,0,0,0,0,0,0,0,0,0,0,0,0,0,0,0,0,0,0,0,0,0,0,0,0,0,0
1995-06-19 00:00:00.000,St. Poelten Austria ATP World Tour,CLAY,2,Francisco Clavet,Nuno Marques,Francisco Clavet,7-6(10); 3-6; 6-4,R32,131,3,2,61,94,42,61,16,33,3,7,15,58,94,4,4,76,113,51,76,13,37,8,12,16,64,113
1995-06-19 00:00:00.000,St. Poelten Austria ATP World Tour,CLAY,2,Slava Dosedel,Franco Davin,Slava Dosedel,5-7; 6-2; 7-5,R32,102,2,4,67,99,40,67,16,32,10,16,16,56,99,4,4,59,94,31,59,16,35,2,10,16,47,94
1995-06-19 00:00:00.000,St. Poelten Austria ATP World Tour,CLAY,2,Oscar Martinez,Hernan Gumy,Oscar Martinez,6-3; 1-6; 6-1,R32,100,2,4,50,90,30,50,22,40,6,9,12,52,90,0,3,48,70,27,48,13,22,3,7,11,40,70
1995-06-19 00:00:00.000,St. Poelten Austria ATP World Tour,CLAY,2,Jordi Burillo,Emilio Sanchez,Jordi Burillo,7-6(3); 6-1,R32,85,13,0,32,67,27,32,22,35,4,4,10,49,67,4,2,46,75,31,46,13,29,6,8,9,44,75
1995-06-19 00:00:00.000,St. Poelten Austria ATP World Tour,CLAY,2,Jordi Arrese,Andrea Gaudenzi,Jordi Arrese,6-3; 6-7(4); 6-4,R32,143,3,3,70,94,44,70,15,24,5,9,16,59,94,4,7,73,105,47,73,11,32,4,10,15,58,105
1995-06-19 00:00:00.000,St. Poelten Austria ATP World Tour,CLAY,2,Thomas Muster,Alex Lopez Moron,Thomas Muster,6-2; 6-2,R16,55,8,0,28,52,20,28,16,24,5,5,8,36,52,3,8,22,47,15,22,9,25,3,7,8,24,47
1995-06-19 00:00:00.000,St. Poelten Austria ATP World Tour,CLAY,2,Rodolphe Gilbert,Sandor Noszaly,Rodolphe Gilbert,6-4; 7-5,R16,113,7,1,41,85,27,41,23,44,11,14,11,50,85,3,6,48,80,30,48,13,32,8,13,11,43,80
1995-06-19 00:00:00.000,St. Poelten Austria ATP World Tour,CLAY,2,Gilbert Schaller,Alejo Mancisidor,Gilbert Schaller,6-4; 7-5,R16,116,2,0,48,70,32,48,8,22,2,6,11,40,70,2,4,30,69,21,30,14,39,8,14,11,35,69
1995-06-19 00:00:00.000,St. Poelten Austria ATP World Tour,CLAY,2,Stefano Pescosolido,Fabrice Santoro,Stefano Pescosolido,6-3; 6-3,R16,77,3,0,27,47,23,27,13,20,0,0,9,36,47,2,1,34,54,22,34,10,20,3,6,9,32,54
1995-06-19 00:00:00.000,St. Poelten Austria ATP World Tour,CLAY,2,Bohdan Ulihrach,Javier Sanchez,Bohdan Ulihrach,3-6; 6-3; 6-3,R16,94,5,1,38,70,28,38,21,32,4,6,13,49,70,2,2,53,86,35,53,15,33,5,9,14,50,86
1995-06-19 00:00:00.000,St. Poelten Austria ATP World Tour,CLAY,2,Carlos Moya,Francisco Clavet,Carlos Moya,7-5; 7-5,R16,98,5,2,40,74,25,40,21,34,4,7,12,46,74,0,1,42,71,27,42,11,29,4,9,12,38,71
1995-06-19 00:00:00.000,St. Poelten Austria ATP World Tour,CLAY,2,Slava Dosedel,Oscar Martinez,Slava Dosedel,6-1; 6-1,R16,32,1,1,27,38,20,27,8,11,0,0,7,28,38,0,2,25,36,10,25,3,11,0,5,7,13,36
1995-06-19 00:00:00.000,St. Poelten Austria ATP World Tour,CLAY,2,Jordi Burillo,Jordi Arrese,Jordi Burillo,6-3; 6-2,R16,62,3,4,31,52,23,31,13,21,1,2,9,36,52,1,0,32,47,19,32,6,15,0,4,8,25,47
1995-06-19 00:00:00.000,St. Poelten Austria ATP World Tour,CLAY,2,Thomas Muster,Rodolphe Gilbert,Thomas Muster,6-2; 6-2,Q,63,4,3,30,46,26,30,9,16,0,0,8,35,46,3,3,25,60,16,25,13,35,3,7,8,29,60
1995-06-19 00:00:00.000,St. Poelten Austria ATP World Tour,CLAY,2,Stefano Pescosolido,Gilbert Schaller,Stefano Pescosolido,6-1; 7-6(6),Q,99,2,3,32,66,19,32,22,34,4,7,10,41,66,2,0,62,76,34,62,5,14,4,9,9,39,76
1995-06-19 00:00:00.000,St. Poelten Austria ATP World Tour,CLAY,2,Bohdan Ulihrach,Carlos Moya,Bohdan Ulihrach,6-3; 6-1,Q,67,0,2,27,53,17,27,19,26,2,2,8,36,53,2,1,46,62,22,46,9,16,6,10,8,31,62
1995-06-19 00:00:00.000,St. Poelten Austria ATP World Tour,CLAY,2,Slava Dosedel,Jordi Burillo,Slava Dosedel,6-3; 6-7(7); 6-4,Q,112,0,1,86,117,52,86,19,31,8,11,16,71,117,9,5,58,96,44,58,14,38,3,8,15,58,96
1995-06-19 00:00:00.000,St. Poelten Austria ATP World Tour,CLAY,2,Thomas Muster,Stefano Pescosolido,Thomas Muster,6-0; 3-6; 6-4,S,118,8,4,53,77,41,53,7,24,7,9,12,48,77,5,6,50,102,28,50,27,52,12,17,13,55,102
1995-06-19 00:00:00.000,St. Poelten Austria ATP World Tour,CLAY,2,Bohdan Ulihrach,Slava Dosedel,Bohdan Ulihrach,7-5; 6-0,S,64,2,3,41,67,29,41,13,26,10,12,9,42,67,0,0,35,46,13,35,6,11,1,7,9,19,46
1995-06-19 00:00:00.000,St. Poelten Austria ATP World Tour,CLAY,2,Thomas Muster,Bohdan Ulihrach,Thomas Muster,6-3; 3-6; 6-1,F,85,4,0,46,76,31,46,19,30,4,7,13,50,76,2,3,53,75,34,53,6,22,5,10,12,40,75
1995-06-26 00:00:00.000,Wimbledon England Grand Slams,GRASS,3,Andre Agassi,Andrew Painter,Andre Agassi,6-2; 6-2; 6-1,R128,77,3,0,37,62,31,37,18,25,3,3,11,49,62,11,17,52,117,37,52,15,65,6,13,12,52,117
1995-06-26 00:00:00.000,Wimbledon England Grand Slams,GRASS,3,Patrick McEnroe,Richey Reneberg,Patrick McEnroe,7-6(7); 6-2; 6-3,R128,127,10,4,55,114,45,55,30,59,4,6,15,75,114,10,9,63,128,46,63,23,65,8,13,14,69,128
1995-06-26 00:00:00.000,Wimbledon England Grand Slams,GRASS,3,David Wheaton,Ross Matheson,David Wheaton,3-6; 7-5; 7-6(4); 6-3,R128,145,13,7,109,160,87,109,21,51,6,8,22,108,160,19,9,83,141,71,83,29,58,1,3,20,100,141
1995-06-26 00:00:00.000,Wimbledon England Grand Slams,GRASS,3,Byron Black,Barry Cowan,Byron Black,6-4; 7-5; 6-1,R128,109,5,2,61,92,46,61,20,31,6,7,14,66,92,10,7,59,119,44,59,22,60,6,12,15,66,119
1995-06-26 00:00:00.000,Wimbledon England Grand Slams,GRASS,3,Kenneth Carlsen,Bohdan Ulihrach,Kenneth Carlsen,6-1; 6-2; 6-1,R128,62,9,4,39,63,38,39,15,24,0,0,11,53,63,1,3,36,70,21,36,7,34,5,12,11,28,70
1995-06-26 00:00:00.000,Wimbledon England Grand Slams,GRASS,3,Alexander Mronz,Sjeng Schalken,Alexander Mronz,6-3; 7-6(4); 1-6; 6-3,R128,155,19,8,96,150,75,96,20,54,8,12,17,95,150,10,10,109,158,78,109,14,49,15,20,19,92,158
1995-06-26 00:00:00.000,Wimbledon England Grand Slams,GRASS,3,Jeff Tarango,Sandor Noszaly,Jeff Tarango,6-4; 3-6; 4-6; 6-4; 6-2,R128,183,6,15,102,189,72,102,34,87,21,27,24,106,189,17,11,116,189,83,116,29,73,7,14,23,112,189
1995-06-26 00:00:00.000,Wimbledon England Grand Slams,GRASS,3,Andrei Medvedev,Christian Ruud,Andrei Medvedev,6-4; 6-2; 6-1,R128,77,5,4,32,73,29,32,24,41,3,4,12,53,73,5,6,45,86,27,45,17,41,5,12,13,44,86
1995-06-26 00:00:00.000,Wimbledon England Grand Slams,GRASS,3,Jacco Eltingh,Michael Stich,Jacco Eltingh,6-4; 7-6(3); 6-1,R128,96,6,4,61,100,53,61,23,39,1,1,15,76,100,6,0,48,85,39,48,20,37,3,6,14,59,85
1995-06-26 00:00:00.000,Wimbledon England Grand Slams,GRASS,3,Andrei Olhovskiy,Fabrice Santoro,Andrei Olhovskiy,6-4; 7-5; 4-6; 6-3,R128,135,10,9,103,151,76,103,17,48,6,10,21,93,151,3,8,112,148,68,112,12,36,8,14,20,80,148
1995-06-26 00:00:00.000,Wimbledon England Grand Slams,GRASS,3,Marc-Kevin Goellner,David Prinosil,Marc-Kevin Goellner,6-4; 6-7(7); 4-6; 6-3; 13-11,R128,216,23,21,92,185,83,92,31,93,5,8,21,114,185,10,21,68,163,57,68,36,95,4,8,20,93,163
1995-06-26 00:00:00.000,Wimbledon England Grand Slams,GRASS,3,Mats Wilander,Mark Petchey,Mats Wilander,7-6(3); 6-1; 6-2,R128,104,2,4,66,104,52,66,18,38,11,12,14,70,104,4,7,51,86,40,51,8,35,5,10,13,48,86
1995-06-26 00:00:00.000,Wimbledon England Grand Slams,GRASS,3,Paul Haarhuis,Vincent Spadea,Paul Haarhuis,6-4; 7-6(1); 5-7; 6-3,R128,170,3,9,111,170,74,111,21,59,13,20,22,95,170,5,3,85,137,49,85,28,52,5,13,21,77,137
1995-06-26 00:00:00.000,Wimbledon England Grand Slams,GRASS,3,Mark Woodforde,Patrick Rafter,Mark Woodforde,3-6; 6-1; 7-6(2); 6-4,R128,151,3,7,63,117,53,63,27,54,3,5,19,80,117,12,8,77,150,57,77,33,73,4,8,19,90,150
1995-06-26 00:00:00.000,Wimbledon England Grand Slams,GRASS,3,Jonas Bjorkman,Lars Burgsmuller,Jonas Bjorkman,6-1; 6-1; 6-1,R128,90,4,5,33,68,31,33,15,35,1,2,11,46,68,3,5,51,95,25,51,16,44,6,14,10,41,95
1995-06-26 00:00:00.000,Wimbledon England Grand Slams,GRASS,3,Wayne Ferreira,Daniel Vacek,Wayne Ferreira,6-2; 6-4; 5-7; 6-4,R128,116,13,7,79,122,64,79,18,43,2,6,20,82,122,9,9,85,140,54,85,25,55,6,13,20,79,140
1995-06-26 00:00:00.000,Wimbledon England Grand Slams,GRASS,3,Boris Becker,Emilio Benfele Alvarez,Boris Becker,6-3; 6-3; 6-4,R128,124,14,9,69,118,54,69,22,49,6,7,14,76,118,4,8,71,122,46,71,20,51,8,13,14,66,122
1995-06-26 00:00:00.000,Wimbledon England Grand Slams,GRASS,3,Jan Apell,Jamie Morgan,Jan Apell,6-7(5); 4-6; 7-6(1); 6-4; 6-3,R128,179,12,6,98,173,81,98,46,75,5,6,26,127,173,28,18,101,201,90,101,49,100,4,7,27,139,201
1995-06-26 00:00:00.000,Wimbledon England Grand Slams,GRASS,3,Jan Siemerink,Andrei Chesnokov,Jan Siemerink,6-1; 7-5; 3-6; 6-3,R128,130,4,3,80,121,62,80,18,41,5,8,19,80,121,6,4,87,126,58,87,13,39,7,13,18,71,126
1995-06-26 00:00:00.000,Wimbledon England Grand Slams,GRASS,3,Slava Dosedel,Jan Kroslak,Slava Dosedel,6-1; 3-6; 7-6(2); 6-0,R128,127,4,8,84,140,59,84,26,56,13,16,17,85,140,7,16,77,151,56,77,20,74,12,19,17,76,151
1995-06-26 00:00:00.000,Wimbledon England Grand Slams,GRASS,3,Gianluca Pozzi,Lionel Barthez,Gianluca Pozzi,7-5; 1-6; 6-4; 7-5,R128,160,3,15,63,156,47,63,38,93,9,15,21,85,156,11,17,89,170,70,89,23,81,17,23,20,93,170
1995-06-26 00:00:00.000,Wimbledon England Grand Slams,GRASS,3,Todd Woodbridge,Peter Tramacchi,Todd Woodbridge,4-6; 6-4; 6-2; 6-2,R128,143,5,10,61,121,46,61,31,60,4,7,18,77,121,8,6,87,157,55,87,33,70,20,27,18,88,157
1995-06-26 00:00:00.000,Wimbledon England Grand Slams,GRASS,3,Dick Norman,Pat Cash,Dick Norman,7-6(6) RET,R128,59,3,0,32,54,24,32,15,22,4,4,6,39,54,5,3,38,58,32,38,7,20,4,4,7,39,58
1995-06-26 00:00:00.000,Wimbledon England Grand Slams,GRASS,3,Stefan Edberg,Oscar Martinez,Stefan Edberg,6-3; 6-3; 6-4,R128,107,1,5,55,92,39,55,19,37,3,5,14,58,92,2,4,59,112,34,59,22,53,7,13,14,56,112
1995-06-26 00:00:00.000,Wimbledon England Grand Slams,GRASS,3,Jim Courier,Ken Flach,Jim Courier,7-6(3); 3-6; 6-3; 3-6; 6-4,R128,197,5,10,103,172,71,103,30,69,10,17,25,101,172,10,14,87,181,66,87,39,94,8,14,24,105,181
1995-06-26 00:00:00.000,Wimbledon England Grand Slams,GRASS,3,Cedric Pioline,Alex Lopez Moron,Cedric Pioline,6-1; 6-2; 6-4,R128,105,9,8,46,98,40,46,27,52,6,6,13,67,98,3,6,48,100,30,48,19,52,9,14,12,49,100
1995-06-26 00:00:00.000,Wimbledon England Grand Slams,GRASS,3,Patrick Baur,Neil Borwick,Patrick Baur,6-2; 6-4; 6-1,R128,90,5,3,52,84,42,52,19,32,2,2,13,61,84,4,3,61,86,34,61,10,25,4,9,12,44,86
1995-06-26 00:00:00.000,Wimbledon England Grand Slams,GRASS,3,Cristiano Caratti,Guillaume Raoux,Cristiano Caratti,6-4; 0-1 RET,R128,46,1,3,15,36,12,15,10,21,0,1,6,22,36,3,1,19,37,14,19,8,18,1,3,6,22,37
1995-06-26 00:00:00.000,Wimbledon England Grand Slams,GRASS,3,Brett Steven,Markus Zoecke,Brett Steven,4-6; 4-6; 6-4; 6-2; 7-5,R128,204,5,7,97,155,74,97,29,58,6,10,25,103,155,14,10,122,209,83,122,38,87,11,17,25,121,209
1995-06-26 00:00:00.000,Wimbledon England Grand Slams,GRASS,3,Jason Stoltenberg,Andrea Gaudenzi,Jason Stoltenberg,7-6(3); 6-3; 6-3,R128,120,10,5,65,109,48,65,19,44,3,8,15,67,109,0,6,69,120,40,69,16,51,8,16,15,56,120
1995-06-26 00:00:00.000,Wimbledon England Grand Slams,GRASS,3,Petr Korda,Diego Nargiso,Petr Korda,4-6; 6-4; 6-1; 7-5,R128,161,6,10,92,142,64,92,24,50,11,15,20,88,142,11,13,85,166,59,85,30,81,8,15,19,89,166
1995-06-26 00:00:00.000,Wimbledon England Grand Slams,GRASS,3,Michael Chang,Lionel Roux,Michael Chang,6-3; 6-4; 4-6; 6-2,R128,122,14,1,61,112,53,61,36,51,3,5,19,89,112,1,8,61,123,39,61,28,62,5,10,18,67,123
1995-06-26 00:00:00.000,Wimbledon England Grand Slams,GRASS,3,Yevgeny Kafelnikov,Filip Dewulf,Yevgeny Kafelnikov,6-3; 7-5; 6-3,R128,81,6,5,59,99,44,59,19,40,5,8,15,63,99,7,4,47,96,32,47,18,49,0,7,15,50,96
1995-06-26 00:00:00.000,Wimbledon England Grand Slams,GRASS,3,Bernd Karbacher,Jakob Hlasek,Bernd Karbacher,4-6; 7-5; 6-4; 2-6; 6-4,R128,165,15,16,97,186,73,97,36,89,8,14,25,109,186,15,12,112,184,88,112,27,72,7,13,25,115,184
1995-06-26 00:00:00.000,Wimbledon England Grand Slams,GRASS,3,Louis Gloria,Joern Renzenbrink,Louis Gloria,6-4; 3-6; 1-6; 6-3; 6-2,R128,150,7,14,90,158,67,90,22,68,10,16,21,89,158,9,19,73,158,58,73,28,85,3,10,22,86,158
1995-06-26 00:00:00.000,Wimbledon England Grand Slams,GRASS,3,Alexander Volkov,MaliVai Washington,Alexander Volkov,4-6; 7-6(9); 6-4; 4-6; 12-10,R128,241,10,9,80,156,63,80,35,76,3,6,21,98,156,18,4,110,162,82,110,27,52,6,8,21,109,162
1995-06-26 00:00:00.000,Wimbledon England Grand Slams,GRASS,3,Aaron Krickstein,Christian Bergstrom,Aaron Krickstein,4-6; 0-6; 7-6(4); 6-2; 6-2,R128,172,12,1,115,164,73,115,20,49,13,23,22,93,164,3,7,87,146,46,87,23,59,6,16,22,69,146
1995-06-26 00:00:00.000,Wimbledon England Grand Slams,GRASS,3,Karol Kucera,Marcos Ondruska,Karol Kucera,6-1; 6-4; 7-5,R128,113,4,7,48,102,33,48,30,54,3,5,14,63,102,5,11,49,113,38,49,15,64,9,16,15,53,113
1995-06-26 00:00:00.000,Wimbledon England Grand Slams,GRASS,3,Tomas Carbonell,Wally Masur,Tomas Carbonell,6-7(10); 7-5; 6-7(0); 6-4; 6-2,R128,210,6,9,116,198,83,116,35,82,8,14,27,118,198,8,16,122,211,86,122,30,89,7,17,27,116,211
1995-06-26 00:00:00.000,Wimbledon England Grand Slams,GRASS,3,Bryan Shelton,Richard Krajicek,Bryan Shelton,7-6(2); 6-3; 6-3,R128,115,6,7,79,135,60,79,23,56,12,14,15,83,135,14,7,77,113,58,77,10,36,7,12,15,68,113
1995-06-26 00:00:00.000,Wimbledon England Grand Slams,GRASS,3,Todd Martin,Nicolas Pereira,Todd Martin,6-1; 3-6; 7-6(4); 7-5,R128,143,20,4,91,137,73,91,21,46,1,5,20,94,137,8,7,93,145,67,93,18,52,7,13,20,85,145
1995-06-26 00:00:00.000,Wimbledon England Grand Slams,GRASS,3,Daniel Nestor,Danny Sapsford,Daniel Nestor,7-5; 6-2; 6-3,R128,115,1,6,55,101,42,55,23,46,3,5,15,65,101,6,8,50,107,35,50,21,57,8,14,14,56,107
1995-06-26 00:00:00.000,Wimbledon England Grand Slams,GRASS,3,Lars Jonsson,Michael Tebbutt,Lars Jonsson,4-6; 6-1; 7-6(6); 6-4,R128,159,9,3,105,168,65,105,33,63,14,19,20,98,168,19,19,84,175,64,84,29,91,16,23,19,93,175
1995-06-26 00:00:00.000,Wimbledon England Grand Slams,GRASS,3,Derrick Rostagno,Jeremy Bates,Derrick Rostagno,7-6(3); 6-4; 7-5,R128,127,9,4,78,118,53,78,18,40,3,7,17,71,118,8,7,84,129,57,84,15,45,8,14,17,72,129
1995-06-26 00:00:00.000,Wimbledon England Grand Slams,GRASS,3,Arnaud Boetsch,Nuno Marques,Arnaud Boetsch,7-6(6); 6-2; 6-2,R128,89,2,1,52,85,42,52,21,33,3,4,14,63,85,2,2,55,87,36,55,14,32,1,6,14,50,87
1995-06-26 00:00:00.000,Wimbledon England Grand Slams,GRASS,3,Tommy Ho,Albert Chang,Tommy Ho,3-6; 6-2; 6-3; 7-5,R128,135,1,3,73,123,49,73,24,50,4,9,19,73,123,4,7,65,115,42,65,20,50,2,10,19,62,115
1995-06-26 00:00:00.000,Wimbledon England Grand Slams,GRASS,3,Jonathan Stark,Radomir Vasek,Jonathan Stark,4-6; 2-6; 6-4; 3-0 RET,R128,122,6,7,59,99,46,59,14,40,2,7,16,60,99,7,11,66,116,48,66,19,50,10,14,16,67,116
1995-06-26 00:00:00.000,Wimbledon England Grand Slams,GRASS,3,Goran Ivanisevic,Sebastien Lareau,Goran Ivanisevic,6-2; 6-4; 6-4,R128,85,21,7,66,106,61,66,17,40,3,4,14,78,106,10,7,55,99,41,55,16,44,5,10,14,57,99
1995-06-26 00:00:00.000,Wimbledon England Grand Slams,GRASS,3,Anders Jarryd,Thomas Enqvist,Anders Jarryd,1-6; 6-3; 6-4; 6-2,R128,132,6,12,83,155,64,83,20,72,12,16,17,84,155,6,11,51,119,36,51,28,68,4,10,17,64,119
1995-06-26 00:00:00.000,Wimbledon England Grand Slams,GRASS,3,Javier Frana,Henri Leconte,Javier Frana,6-3; 6-4; 6-4,R128,90,10,5,59,104,51,59,19,45,3,5,15,70,104,2,4,39,75,27,39,17,36,2,7,14,44,75
1995-06-26 00:00:00.000,Wimbledon England Grand Slams,GRASS,3,Shuzo Matsuoka,Karel Novacek,Shuzo Matsuoka,6-4; 6-7(5); 3-6; 6-3; 6-4,R128,188,9,6,106,168,85,106,32,62,2,3,25,117,168,24,9,125,199,101,125,34,74,7,10,25,135,199
1995-06-26 00:00:00.000,Wimbledon England Grand Slams,GRASS,3,Mark Knowles,Marcelo Rios,Mark Knowles,4-6; 6-3; 6-4; 7-6(4),R128,155,7,14,99,182,72,99,32,83,14,19,21,104,182,3,6,82,137,53,82,27,55,8,14,20,80,137
1995-06-26 00:00:00.000,Wimbledon England Grand Slams,GRASS,3,Miles MacLagan,Renzo Furlan,Miles MacLagan,2-6; 6-2; 7-6(5); 6-3,R128,142,6,6,70,117,60,70,18,47,3,6,18,78,117,7,9,103,156,72,103,17,53,9,14,19,89,156
1995-06-26 00:00:00.000,Wimbledon England Grand Slams,GRASS,3,Chris Wilkinson,Hendrik Dreekmann,Chris Wilkinson,6-3; 6-4; 7-5,R128,131,8,5,76,113,57,76,14,37,5,9,16,71,113,3,6,48,120,31,48,30,72,9,16,15,61,120
1995-06-26 00:00:00.000,Wimbledon England Grand Slams,GRASS,3,Jordi Burillo,Sandon Stolle,Jordi Burillo,6-2; 3-6; 7-6(4); 6-3,R128,120,17,6,80,133,67,80,23,53,3,6,18,90,133,11,9,88,139,65,88,21,51,6,12,20,86,139
1995-06-26 00:00:00.000,Wimbledon England Grand Slams,GRASS,3,Michael Joyce,Marc Rosset,Michael Joyce,6-0; 6-7(8); 7-5; 6-2,R128,142,7,6,76,136,55,76,34,60,3,6,19,89,136,23,26,78,171,65,78,24,93,5,14,19,89,171
1995-06-26 00:00:00.000,Wimbledon England Grand Slams,GRASS,3,Guy Forget,Gary Henderson,Guy Forget,6-1; 6-3; 7-6(5),R128,105,5,3,64,96,48,64,19,32,4,6,14,67,96,9,5,64,102,46,64,13,38,2,8,14,59,102
1995-06-26 00:00:00.000,Wimbledon England Grand Slams,GRASS,3,Greg Rusedski,Stephane Simian,Greg Rusedski,6-3; 6-3; 6-3,R128,75,12,4,53,91,47,53,24,38,4,4,14,71,91,1,5,45,74,33,45,10,29,0,4,13,43,74
1995-06-26 00:00:00.000,Wimbledon England Grand Slams,GRASS,3,Olivier Delaitre,Alex O'Brien,Olivier Delaitre,6-4; 2-6; 1-6; 6-4; 6-2,R128,165,9,16,94,189,63,94,39,95,14,20,22,102,189,10,8,91,154,66,91,28,63,7,12,21,94,154
1995-06-26 00:00:00.000,Wimbledon England Grand Slams,GRASS,3,Arne Thoms,Eyal Erlich,Arne Thoms,6-3; 6-2; 6-2,R128,92,6,7,70,104,52,70,16,34,5,5,13,68,104,1,8,54,90,33,54,10,36,8,13,12,43,90
1995-06-26 00:00:00.000,Wimbledon England Grand Slams,GRASS,3,Jared Palmer,Scott Draper,Jared Palmer,5-7; 3-6; 7-5; 6-2; 6-3,R128,165,9,11,87,169,67,87,39,82,3,7,25,106,169,13,9,80,155,70,80,28,75,3,9,25,98,155
1995-06-26 00:00:00.000,Wimbledon England Grand Slams,GRASS,3,Frederik Fetterlein,Martin Sinner,Frederik Fetterlein,6-4; 7-6(4); 6-3,R128,100,20,8,84,132,74,84,20,48,6,7,16,94,132,4,11,50,102,40,50,21,52,2,5,15,61,102
1995-06-26 00:00:00.000,Wimbledon England Grand Slams,GRASS,3,Tim Henman,Paul Wekesa,Tim Henman,7-6(3); 6-0; 6-4,R128,91,3,3,51,86,40,51,21,35,1,2,14,61,86,1,3,49,83,34,49,10,34,1,6,14,44,83
1995-06-26 00:00:00.000,Wimbledon England Grand Slams,GRASS,3,Pete Sampras,Karsten Braasch,Pete Sampras,7-6(4); 6-7(2); 6-4; 6-1,R128,147,19,5,88,141,81,88,28,53,3,4,21,109,141,11,4,89,157,64,89,38,68,6,10,20,102,157
1995-06-26 00:00:00.000,Wimbledon England Grand Slams,GRASS,3,Andre Agassi,Patrick McEnroe,Andre Agassi,6-1; 6-1; 6-3,R64,96,7,0,52,62,46,52,5,10,0,0,11,51,62,4,7,73,109,42,73,7,36,16,23,12,49,109
1995-06-26 00:00:00.000,Wimbledon England Grand Slams,GRASS,3,David Wheaton,Byron Black,David Wheaton,6-3; 6-2; 3-6; 6-4,R64,139,20,3,93,134,79,93,18,41,6,8,18,97,134,6,8,89,142,65,89,15,53,6,11,18,80,142
1995-06-26 00:00:00.000,Wimbledon England Grand Slams,GRASS,3,Alexander Mronz,Kenneth Carlsen,Alexander Mronz,2-6; 7-6(1); 7-5; 5-7; 6-3,R64,233,12,13,94,202,72,94,54,108,5,9,27,126,202,21,7,100,197,83,100,48,97,8,11,26,131,197
1995-06-26 00:00:00.000,Wimbledon England Grand Slams,GRASS,3,Jeff Tarango,Andrei Medvedev,Jeff Tarango,6-4; 6-3; 4-6; 6-2,R64,125,8,3,86,116,67,86,17,30,1,3,19,84,116,18,18,91,178,76,91,21,87,9,14,18,97,178
1995-06-26 00:00:00.000,Wimbledon England Grand Slams,GRASS,3,Jacco Eltingh,Andrei Olhovskiy,Jacco Eltingh,5-7; 6-3; 6-4; 7-6(4),R64,4,13,5,105,166,82,105,31,61,6,8,22,113,166,11,4,69,133,56,69,35,64,4,7,21,91,133
1995-06-26 00:00:00.000,Wimbledon England Grand Slams,GRASS,3,Mats Wilander,Marc-Kevin Goellner,Mats Wilander,4-6; 5-7; 6-3; 7-5; 6-4,R64,166,12,4,127,163,96,127,19,36,4,7,27,115,163,32,20,123,224,107,123,34,101,9,13,26,141,224
1995-06-26 00:00:00.000,Wimbledon England Grand Slams,GRASS,3,Mark Woodforde,Paul Haarhuis,Mark Woodforde,6-3; 7-6(7); 6-3,R64,100,9,4,67,98,51,67,14,31,3,6,14,65,98,4,3,79,107,45,79,12,28,3,10,16,57,107
1995-06-26 00:00:00.000,Wimbledon England Grand Slams,GRASS,3,Wayne Ferreira,Jonas Bjorkman,Wayne Ferreira,6-2; 6-4; 6-3,R64,89,16,4,62,98,54,62,19,36,2,2,13,73,98,5,6,52,99,39,52,17,47,4,9,14,56,99
1995-06-26 00:00:00.000,Wimbledon England Grand Slams,GRASS,3,Boris Becker,Jan Apell,Boris Becker,6-3; 3-6; 6-1; 6-2,R64,123,15,11,67,126,58,67,25,59,4,6,17,83,126,2,6,65,105,35,65,19,40,4,10,16,54,105
1995-06-26 00:00:00.000,Wimbledon England Grand Slams,GRASS,3,Jan Siemerink,Slava Dosedel,Jan Siemerink,6-3; 6-2; 6-2,R64,74,8,1,53,79,46,53,15,26,0,0,13,61,79,0,5,46,74,28,46,10,28,3,8,12,38,74
1995-06-26 00:00:00.000,Wimbledon England Grand Slams,GRASS,3,Todd Woodbridge,Gianluca Pozzi,Todd Woodbridge,6-3; 6-4; 4-6; 6-2,R64,136,7,13,62,131,51,62,25,69,6,11,19,76,131,4,12,49,125,30,49,31,76,3,11,18,61,125
1995-06-26 00:00:00.000,Wimbledon England Grand Slams,GRASS,3,Dick Norman,Stefan Edberg,Dick Norman,6-3; 6-4; 6-4,R64,98,8,8,57,103,50,57,23,46,3,3,15,73,103,4,5,59,94,42,59,16,35,5,8,14,58,94
1995-06-26 00:00:00.000,Wimbledon England Grand Slams,GRASS,3,Cedric Pioline,Jim Courier,Cedric Pioline,6-4; 6-4; 6-4,R64,123,19,9,76,127,64,76,23,51,5,6,15,87,127,7,7,55,100,38,55,21,45,4,8,15,59,100
1995-06-26 00:00:00.000,Wimbledon England Grand Slams,GRASS,3,Patrick Baur,Cristiano Caratti,Patrick Baur,6-1; 6-4; 3-6; 6-3,R64,124,6,6,101,128,70,101,10,27,9,12,18,80,128,2,1,79,106,47,79,16,27,6,12,17,63,106
1995-06-26 00:00:00.000,Wimbledon England Grand Slams,GRASS,3,Brett Steven,Jason Stoltenberg,Brett Steven,6-2; 6-2; 6-2,R64,88,5,3,63,81,49,63,9,18,4,4,12,58,81,4,7,49,90,29,49,15,41,6,12,12,44,90
1995-06-26 00:00:00.000,Wimbledon England Grand Slams,GRASS,3,Petr Korda,Michael Chang,Petr Korda,6-4; 6-4; 6-4,R64,121,7,11,70,126,57,70,21,56,7,8,15,78,126,1,2,54,100,31,54,29,46,4,8,15,60,100
1995-06-26 00:00:00.000,Wimbledon England Grand Slams,GRASS,3,Yevgeny Kafelnikov,Bernd Karbacher,Yevgeny Kafelnikov,6-4; 6-4; 7-5,R64,114,3,9,62,111,47,62,16,49,7,11,16,63,111,7,6,66,122,45,66,21,56,6,13,16,66,122
1995-06-26 00:00:00.000,Wimbledon England Grand Slams,GRASS,3,Alexander Volkov,Louis Gloria,Alexander Volkov,1-6; 6-1; 6-3; 6-7(4); 6-4,R64,171,6,6,72,148,55,72,35,76,2,8,23,90,148,8,7,101,173,64,101,34,72,17,25,22,98,173
1995-06-26 00:00:00.000,Wimbledon England Grand Slams,GRASS,3,Aaron Krickstein,Karol Kucera,Aaron Krickstein,6-0; 7-6(5); 7-6(6),R64,129,7,9,73,137,54,73,27,64,9,12,15,81,137,17,8,72,125,54,72,19,53,3,9,15,73,125
1995-06-26 00:00:00.000,Wimbledon England Grand Slams,GRASS,3,Tomas Carbonell,Bryan Shelton,Tomas Carbonell,6-4; 6-1; 6-3,R64,95,4,6,77,110,57,77,11,33,8,9,13,68,110,6,4,52,93,35,52,12,41,3,9,13,47,93
1995-06-26 00:00:00.000,Wimbledon England Grand Slams,GRASS,3,Todd Martin,Daniel Nestor,Todd Martin,6-4; 7-6(4); 6-3,R64,108,21,3,75,118,67,75,29,43,2,2,16,96,118,8,7,64,105,52,64,17,41,1,3,15,69,105
1995-06-26 00:00:00.000,Wimbledon England Grand Slams,GRASS,3,Derrick Rostagno,Lars Jonsson,Derrick Rostagno,6-1; 6-2; 7-5,R64,88,10,3,52,86,42,52,18,34,7,9,13,60,86,3,3,75,107,43,75,10,32,9,17,14,53,107
1995-06-26 00:00:00.000,Wimbledon England Grand Slams,GRASS,3,Arnaud Boetsch,Tommy Ho,Arnaud Boetsch,6-4; 3-6; 6-2; 7-6(4),R64,140,10,7,85,148,66,85,28,63,8,12,20,94,148,10,4,89,144,62,89,27,55,7,12,19,89,144
1995-06-26 00:00:00.000,Wimbledon England Grand Slams,GRASS,3,Goran Ivanisevic,Jonathan Stark,Goran Ivanisevic,6-4; 6-2; 7-6(1),R64,102,27,6,76,127,67,76,27,51,3,4,15,94,127,8,1,62,90,44,62,13,28,0,4,15,57,90
1995-06-26 00:00:00.000,Wimbledon England Grand Slams,GRASS,3,Javier Frana,Anders Jarryd,Javier Frana,6-1; 6-2; 6-4,R64,88,8,2,54,84,44,54,18,30,2,2,13,62,84,3,12,44,96,32,44,15,52,3,8,12,47,96
1995-06-26 00:00:00.000,Wimbledon England Grand Slams,GRASS,3,Shuzo Matsuoka,Mark Knowles,Shuzo Matsuoka,6-1; 6-4; 6-2,R64,95,10,2,60,83,49,60,15,23,2,2,13,64,83,0,7,48,87,30,48,14,39,6,11,12,44,87
1995-06-26 00:00:00.000,Wimbledon England Grand Slams,GRASS,3,Chris Wilkinson,Miles MacLagan,Chris Wilkinson,6-1; 6-0; 6-2,R64,76,11,5,50,80,43,50,16,30,0,0,11,59,80,0,7,38,69,21,38,3,31,3,10,10,24,69
1995-06-26 00:00:00.000,Wimbledon England Grand Slams,GRASS,3,Michael Joyce,Jordi Burillo,Michael Joyce,7-6(4); 6-4; 6-1,R64,94,8,1,65,101,47,65,16,36,1,5,14,63,101,13,10,69,119,47,69,12,50,6,14,15,59,119
1995-06-26 00:00:00.000,Wimbledon England Grand Slams,GRASS,3,Greg Rusedski,Guy Forget,Greg Rusedski,1-6; 7-6(5); 7-6(4); 7-5,R64,145,28,13,100,165,95,100,26,65,1,3,21,121,165,13,4,104,155,85,104,28,51,4,5,22,113,155
1995-06-26 00:00:00.000,Wimbledon England Grand Slams,GRASS,3,Olivier Delaitre,Arne Thoms,Olivier Delaitre,6-3; 6-4; 6-4,R64,90,3,3,51,84,39,51,18,33,0,3,15,57,84,8,9,54,90,36,54,11,36,0,6,14,47,90
1995-06-26 00:00:00.000,Wimbledon England Grand Slams,GRASS,3,Jared Palmer,Frederik Fetterlein,Jared Palmer,6-3; 7-6(0); 6-3,R64,105,5,5,68,108,56,68,22,40,3,3,16,78,108,5,5,52,94,37,52,24,42,3,5,14,61,94
1995-06-26 00:00:00.000,Wimbledon England Grand Slams,GRASS,3,Pete Sampras,Tim Henman,Pete Sampras,6-2; 6-3; 7-6(3),R64,116,11,5,61,94,53,61,17,33,3,4,14,70,94,6,12,79,137,55,79,16,58,12,17,15,71,137
1995-06-26 00:00:00.000,Wimbledon England Grand Slams,GRASS,3,Andre Agassi,David Wheaton,Andre Agassi,6-2; 3-6; 6-4; 6-2,R32,140,6,5,77,120,56,77,21,43,4,7,17,77,120,14,5,98,148,66,98,19,50,10,17,18,85,148
1995-06-26 00:00:00.000,Wimbledon England Grand Slams,GRASS,3,Alexander Mronz,Jeff Tarango,Alexander Mronz,7-6(6); 3-1 DEF,R32,75,8,5,46,73,40,46,8,27,2,3,9,48,73,4,2,40,58,31,40,7,18,4,6,8,38,58
1995-06-26 00:00:00.000,Wimbledon England Grand Slams,GRASS,3,Jacco Eltingh,Mats Wilander,Jacco Eltingh,7-6(5); 6-3; 7-6(4),R32,136,8,8,75,119,58,75,17,44,2,5,16,75,119,3,2,82,118,53,82,16,36,3,8,17,69,118
1995-06-26 00:00:00.000,Wimbledon England Grand Slams,GRASS,3,Wayne Ferreira,Mark Woodforde,Wayne Ferreira,6-1; 1-6; 6-4; 6-7(5); 6-2,R32,205,14,11,108,196,77,108,40,88,14,19,22,117,196,2,6,84,164,54,84,37,80,12,20,22,91,164
1995-06-26 00:00:00.000,Wimbledon England Grand Slams,GRASS,3,Boris Becker,Jan Siemerink,Boris Becker,2-6; 6-2; 6-2; 6-4,R32,138,8,6,57,119,43,57,35,62,3,5,17,78,119,4,3,93,124,59,93,14,31,6,11,17,73,124
1995-06-26 00:00:00.000,Wimbledon England Grand Slams,GRASS,3,Dick Norman,Todd Woodbridge,Dick Norman,6-4; 6-4; 3-6; 6-3,R32,126,17,7,81,137,69,81,28,56,3,4,19,97,137,5,11,57,122,45,57,32,65,3,6,19,77,122
1995-06-26 00:00:00.000,Wimbledon England Grand Slams,GRASS,3,Cedric Pioline,Patrick Baur,Cedric Pioline,6-4; 6-4; 6-3,R32,109,5,8,55,97,46,55,18,42,4,5,15,64,97,4,2,64,94,43,64,15,30,3,7,14,58,94
1995-06-26 00:00:00.000,Wimbledon England Grand Slams,GRASS,3,Petr Korda,Brett Steven,Petr Korda,6-4; 6-2; 6-1,R32,86,5,3,50,75,40,50,10,25,4,6,12,50,75,0,2,55,87,26,55,14,32,4,12,13,40,87
1995-06-26 00:00:00.000,Wimbledon England Grand Slams,GRASS,3,Yevgeny Kafelnikov,Alexander Volkov,Yevgeny Kafelnikov,7-6(2); 6-2; 6-4,R32,95,17,3,66,103,54,66,25,37,4,5,15,79,103,8,6,64,109,41,64,24,45,6,10,15,65,109
1995-06-26 00:00:00.000,Wimbledon England Grand Slams,GRASS,3,Aaron Krickstein,Tomas Carbonell,Aaron Krickstein,6-7(2); 7-5; 5-7; 6-3; 6-2,R32,195,12,11,111,191,83,111,29,80,7,14,26,112,191,26,14,148,238,114,148,23,90,10,21,27,137,238
1995-06-26 00:00:00.000,Wimbledon England Grand Slams,GRASS,3,Todd Martin,Derrick Rostagno,Todd Martin,6-3; 4-6; 4-6; 6-2; 6-4,R32,186,21,7,108,173,89,108,25,65,5,10,24,114,173,11,10,96,170,73,96,27,74,11,18,23,100,170
1995-06-26 00:00:00.000,Wimbledon England Grand Slams,GRASS,3,Goran Ivanisevic,Arnaud Boetsch,Goran Ivanisevic,6-4; 6-4; 6-4,R32,85,20,5,68,100,66,68,16,32,2,2,15,82,100,7,8,60,110,44,60,23,50,4,7,15,67,110
1995-06-26 00:00:00.000,Wimbledon England Grand Slams,GRASS,3,Shuzo Matsuoka,Javier Frana,Shuzo Matsuoka,7-6(3); 3-6; 6-7(6); 7-6(4); 6-3,R32,225,19,9,130,205,113,130,35,75,7,8,27,148,205,16,6,129,198,102,129,39,69,4,5,27,141,198
1995-06-26 00:00:00.000,Wimbledon England Grand Slams,GRASS,3,Michael Joyce,Chris Wilkinson,Michael Joyce,5-7; 6-4; 7-6(3); 6-4,R32,175,10,6,113,182,90,113,28,69,11,13,22,118,182,18,7,117,173,87,117,28,56,3,6,22,115,173
1995-06-26 00:00:00.000,Wimbledon England Grand Slams,GRASS,3,Greg Rusedski,Olivier Delaitre,Greg Rusedski,6-7(6); 6-4; 6-4; 7-6(3),R32,151,33,11,112,171,104,112,27,59,1,2,22,131,171,4,14,87,177,67,87,40,90,7,10,22,107,177
1995-06-26 00:00:00.000,Wimbledon England Grand Slams,GRASS,3,Pete Sampras,Jared Palmer,Pete Sampras,4-6; 6-4; 6-1; 6-2,R32,119,18,9,63,131,59,63,34,68,5,6,18,93,131,8,10,65,121,49,65,18,56,6,11,17,67,121
1995-06-26 00:00:00.000,Wimbledon England Grand Slams,GRASS,3,Andre Agassi,Alexander Mronz,Andre Agassi,6-3; 6-3; 6-3,R16,95,3,2,48,86,39,48,23,38,4,4,14,62,86,10,2,60,97,45,60,15,37,5,9,13,60,97
1995-06-26 00:00:00.000,Wimbledon England Grand Slams,GRASS,3,Jacco Eltingh,Wayne Ferreira,Jacco Eltingh,6-4; 4-6; 7-6(4); 6-3,R16,146,12,4,100,145,83,100,22,45,5,6,21,105,145,16,8,75,145,65,75,36,70,7,9,20,101,145
1995-06-26 00:00:00.000,Wimbledon England Grand Slams,GRASS,3,Boris Becker,Dick Norman,Boris Becker,7-6(6); 6-3; 6-4,R16,120,17,9,75,128,71,75,22,53,4,4,16,93,128,7,7,74,122,57,74,22,48,5,7,15,79,122
1995-06-26 00:00:00.000,Wimbledon England Grand Slams,GRASS,3,Cedric Pioline,Petr Korda,Cedric Pioline,7-6(1); 6-3; 6-2,R16,122,7,9,72,128,55,72,24,56,8,10,15,79,128,1,9,55,112,36,55,21,57,4,9,14,57,112
1995-06-26 00:00:00.000,Wimbledon England Grand Slams,GRASS,3,Yevgeny Kafelnikov,Aaron Krickstein,Yevgeny Kafelnikov,6-3; 6-3; 6-2,R16,93,7,7,48,93,42,48,21,45,1,1,13,63,93,2,4,48,90,32,48,17,42,5,10,13,49,90
1995-06-26 00:00:00.000,Wimbledon England Grand Slams,GRASS,3,Goran Ivanisevic,Todd Martin,Goran Ivanisevic,6-4; 7-6(4); 6-7(5); 7-6(3),R16,145,31,10,106,188,99,106,38,82,7,8,23,137,188,24,9,110,174,93,110,31,64,3,5,23,124,174
1995-06-26 00:00:00.000,Wimbledon England Grand Slams,GRASS,3,Shuzo Matsuoka,Michael Joyce,Shuzo Matsuoka,6-3; 6-2; 6-4,R16,91,15,1,66,92,56,66,17,26,1,1,14,73,92,1,3,44,78,29,44,17,34,3,7,13,46,78
1995-06-26 00:00:00.000,Wimbledon England Grand Slams,GRASS,3,Pete Sampras,Greg Rusedski,Pete Sampras,6-4; 6-3; 7-5,R16,94,9,2,59,96,53,59,21,37,3,3,15,74,96,11,6,71,112,54,71,16,41,2,6,16,70,112
1995-06-26 00:00:00.000,Wimbledon England Grand Slams,GRASS,3,Andre Agassi,Jacco Eltingh,Andre Agassi,6-2; 6-3; 6-4,Q,102,7,2,65,95,48,65,15,30,4,5,13,63,95,9,6,73,112,52,73,9,39,8,14,14,61,112
1995-06-26 00:00:00.000,Wimbledon England Grand Slams,GRASS,3,Boris Becker,Cedric Pioline,Boris Becker,6-3; 6-1; 6-7(6); 6-7(10); 9-7,Q,254,18,12,89,164,75,89,41,75,4,4,20,116,164,9,6,97,170,69,97,38,73,10,14,20,107,170
1995-06-26 00:00:00.000,Wimbledon England Grand Slams,GRASS,3,Goran Ivanisevic,Yevgeny Kafelnikov,Goran Ivanisevic,7-5; 7-6(11); 6-3,Q,107,31,8,101,150,91,101,24,49,4,4,17,115,150,18,3,88,126,74,88,17,38,5,7,16,91,126
1995-06-26 00:00:00.000,Wimbledon England Grand Slams,GRASS,3,Pete Sampras,Shuzo Matsuoka,Pete Sampras,6-7(5); 6-3; 6-4; 6-2,Q,145,6,3,82,135,67,82,22,53,7,10,20,89,135,18,7,97,144,73,97,13,47,5,12,19,86,144
1995-06-26 00:00:00.000,Wimbledon England Grand Slams,GRASS,3,Boris Becker,Andre Agassi,Boris Becker,2-6; 7-6(1); 6-4; 7-6(1),S,175,22,10,108,175,84,108,29,67,10,14,21,113,175,4,6,106,165,78,106,21,59,13,16,21,99,165
1995-06-26 00:00:00.000,Wimbledon England Grand Slams,GRASS,3,Pete Sampras,Goran Ivanisevic,Pete Sampras,7-6(7); 4-6; 6-3; 4-6; 6-3,S,153,20,4,119,179,100,119,30,60,6,8,25,130,179,36,9,116,181,102,116,34,65,2,5,25,136,181
1995-06-26 00:00:00.000,Wimbledon England Grand Slams,GRASS,3,Pete Sampras,Boris Becker,Pete Sampras,6-7(5); 6-2; 6-4; 6-2,F,149,23,7,79,136,71,79,34,57,0,0,19,105,136,17,16,87,173,73,87,28,86,11,16,19,101,173
1995-07-10 00:00:00.000,Bastad Sweden ATP World Tour,CLAY,2,Kris Goossens,Jonas Bjorkman,Kris Goossens,6-2; 6-4,R32,72,3,2,35,56,26,35,12,21,0,1,9,38,56,2,3,28,57,16,28,15,29,3,7,9,31,57
1995-07-10 00:00:00.000,Bastad Sweden ATP World Tour,CLAY,2,Hernan Gumy,Jordi Burillo,Hernan Gumy,6-4; 6-4,R32,74,6,3,32,58,20,32,13,26,4,7,10,33,58,5,5,34,65,18,34,15,31,5,10,10,33,65
1995-07-10 00:00:00.000,Bastad Sweden ATP World Tour,CLAY,2,Lars Jonsson,Alex Lopez Moron,Lars Jonsson,6-4; 6-2,R32,88,2,5,39,58,24,39,10,19,4,6,9,34,58,5,6,34,82,23,34,18,48,11,16,9,41,82
1995-07-10 00:00:00.000,Bastad Sweden ATP World Tour,CLAY,2,Marc-Kevin Goellner,Mats Wilander,Marc-Kevin Goellner,7-5; 6-3,R32,87,7,3,35,66,24,35,17,31,8,11,11,41,66,2,2,36,64,20,36,14,28,4,9,10,34,64
1995-07-10 00:00:00.000,Bastad Sweden ATP World Tour,CLAY,2,Bohdan Ulihrach,Emilio Sanchez,Bohdan Ulihrach,6-3; 6-1,R32,60,2,1,17,41,14,17,13,24,4,6,8,27,41,1,1,28,45,14,28,4,17,0,6,8,18,45
1995-07-10 00:00:00.000,Bastad Sweden ATP World Tour,CLAY,2,Frederik Fetterlein,Carsten Arriens,Frederik Fetterlein,7-6(8); 6-4,R32,111,3,6,44,73,34,44,14,29,1,3,11,48,73,3,3,49,80,31,49,17,31,4,7,11,48,80
1995-07-10 00:00:00.000,Bastad Sweden ATP World Tour,CLAY,2,Magnus Gustafsson,Marcelo Filippini,Magnus Gustafsson,6-4; 6-7(3); 6-3,R32,136,2,3,65,96,45,65,10,31,1,6,16,55,96,2,3,78,105,41,78,12,27,6,13,15,53,105
1995-07-10 00:00:00.000,Bastad Sweden ATP World Tour,CLAY,2,Christian Ruud,Lars-Anders Wahlgren,Christian Ruud,6-3; 6-0,R32,73,1,4,28,51,21,28,11,23,3,4,7,32,51,2,0,27,49,13,27,6,22,4,10,8,19,49
1995-07-10 00:00:00.000,Bastad Sweden ATP World Tour,CLAY,2,Carlos Costa,Patrik Fredriksson,Carlos Costa,4-6; 6-3; 6-1,R32,96,3,2,43,80,28,43,18,37,1,5,13,46,80,3,8,40,74,27,40,9,34,2,9,13,36,74
1995-07-10 00:00:00.000,Bastad Sweden ATP World Tour,CLAY,2,Christian Bergstrom,Jan Apell,Christian Bergstrom,7-6(4); 6-4,R32,106,1,0,64,84,41,64,13,20,3,5,11,54,84,6,0,49,81,32,49,16,32,4,7,11,48,81
1995-07-10 00:00:00.000,Bastad Sweden ATP World Tour,CLAY,2,Tomas Carbonell,Sandor Noszaly,Tomas Carbonell,7-6(1); 6-1,R32,78,0,2,39,59,29,39,10,20,0,2,10,39,59,2,5,31,58,19,31,11,27,1,5,9,30,58
1995-07-10 00:00:00.000,Bastad Sweden ATP World Tour,CLAY,2,Bernd Karbacher,Mikael Pernfors,Bernd Karbacher,6-1; 7-5,R32,83,3,2,37,76,30,37,14,39,10,12,10,44,76,0,2,42,62,23,42,8,20,4,9,9,31,62
1995-07-10 00:00:00.000,Bastad Sweden ATP World Tour,CLAY,2,Magnus Norman,Anders Jarryd,Magnus Norman,6-4; 6-3,R32,78,2,1,26,53,16,26,17,27,1,3,9,33,53,3,7,23,64,14,23,20,41,3,8,10,34,64
1995-07-10 00:00:00.000,Bastad Sweden ATP World Tour,CLAY,2,Mikael Tillstrom,Ronald Agenor,Mikael Tillstrom,6-4; 7-6(9),R32,96,4,3,40,75,31,40,20,35,2,3,11,51,75,1,1,46,82,32,46,19,36,2,4,11,51,82
1995-07-10 00:00:00.000,Bastad Sweden ATP World Tour,CLAY,2,Oscar Martinez,David Engel,Oscar Martinez,1-6; 6-2; 7-5(1),R32,100,2,9,51,96,36,51,19,45,2,7,14,55,96,3,2,41,74,25,41,17,33,4,8,13,42,74
1995-07-10 00:00:00.000,Bastad Sweden ATP World Tour,CLAY,2,Fernando Meligeni,Gilbert Schaller,Fernando Meligeni,1-6; 6-3; 6-4,R32,120,6,3,40,81,28,40,17,41,7,12,13,45,81,1,2,59,87,29,59,20,28,5,10,13,49,87
1995-07-10 00:00:00.000,Bastad Sweden ATP World Tour,CLAY,2,Kris Goossens,Hernan Gumy,Kris Goossens,W/O,R16,0,0,0,0,0,0,0,0,0,0,0,1,0,0,0,0,0,0,0,0,0,0,0,0,0,0,0
1995-07-10 00:00:00.000,Bastad Sweden ATP World Tour,CLAY,2,Marc-Kevin Goellner,Lars Jonsson,Marc-Kevin Goellner,6-4; 6-1,R16,52,11,4,22,42,21,22,15,20,0,0,9,36,42,2,0,35,55,20,35,10,20,5,8,8,30,55
1995-07-10 00:00:00.000,Bastad Sweden ATP World Tour,CLAY,2,Frederik Fetterlein,Bohdan Ulihrach,Frederik Fetterlein,7-6(11); 7-5,R16,104,3,4,53,80,35,53,13,27,5,9,12,48,80,0,2,44,86,26,44,20,42,6,11,12,46,86
1995-07-10 00:00:00.000,Bastad Sweden ATP World Tour,CLAY,2,Christian Ruud,Magnus Gustafsson,Christian Ruud,6-4; 1-6; 6-3,R16,136,2,7,86,108,52,86,5,22,12,17,13,57,108,3,6,66,100,39,66,16,34,13,18,13,55,100
1995-07-10 00:00:00.000,Bastad Sweden ATP World Tour,CLAY,2,Carlos Costa,Christian Bergstrom,Carlos Costa,6-4; 7-6(2),R16,99,5,1,37,76,27,37,23,39,2,4,11,50,76,1,0,47,73,30,47,13,26,10,13,11,43,73
1995-07-10 00:00:00.000,Bastad Sweden ATP World Tour,CLAY,2,Tomas Carbonell,Bernd Karbacher,Tomas Carbonell,5-7; 6-2; 6-1,R16,125,2,3,55,91,38,55,18,36,14,17,13,56,91,4,3,60,106,36,60,17,46,15,22,14,53,106
1995-07-10 00:00:00.000,Bastad Sweden ATP World Tour,CLAY,2,Magnus Norman,Mikael Tillstrom,Magnus Norman,6-3; 6-2,R16,77,6,0,37,60,27,37,9,23,8,9,8,36,60,2,1,28,54,14,28,12,26,6,11,9,26,54
1995-07-10 00:00:00.000,Bastad Sweden ATP World Tour,CLAY,2,Fernando Meligeni,Oscar Martinez,Fernando Meligeni,7-5; 6-1,R16,83,1,3,30,62,21,30,15,32,5,7,9,36,62,0,8,28,66,17,28,13,38,6,12,10,30,66
1995-07-10 00:00:00.000,Bastad Sweden ATP World Tour,CLAY,2,Kris Goossens,Marc-Kevin Goellner,Kris Goossens,6-4; 6-3,Q,75,3,1,21,45,19,21,17,24,0,0,9,36,45,16,7,36,82,32,36,15,46,4,7,10,47,82
1995-07-10 00:00:00.000,Bastad Sweden ATP World Tour,CLAY,2,Christian Ruud,Frederik Fetterlein,Christian Ruud,7-5; 7-6(4),Q,132,0,6,64,90,39,64,9,26,6,11,12,48,90,2,5,48,76,27,48,9,28,2,8,12,36,76
1995-07-10 00:00:00.000,Bastad Sweden ATP World Tour,CLAY,2,Carlos Costa,Tomas Carbonell,Carlos Costa,7-5; 7-5,Q,101,3,3,36,77,25,36,24,41,3,5,12,49,77,3,4,44,74,27,44,15,30,2,6,12,42,74
1995-07-10 00:00:00.000,Bastad Sweden ATP World Tour,CLAY,2,Fernando Meligeni,Magnus Norman,Fernando Meligeni,6-4; 6-3,Q,87,0,4,30,65,20,30,16,35,3,6,9,36,65,2,3,34,63,19,34,10,29,5,11,10,29,63
1995-07-10 00:00:00.000,Bastad Sweden ATP World Tour,CLAY,2,Christian Ruud,Kris Goossens,Christian Ruud,7-6(5); 7-5,S,138,0,0,73,103,41,73,14,30,7,11,12,55,103,0,2,46,88,28,46,19,42,5,10,12,47,88
1995-07-10 00:00:00.000,Bastad Sweden ATP World Tour,CLAY,2,Fernando Meligeni,Carlos Costa,Fernando Meligeni,4-6; 6-0; 6-2,S,108,2,3,48,90,36,48,19,42,12,14,12,55,90,4,2,47,85,28,47,15,38,8,14,12,43,85
1995-07-10 00:00:00.000,Bastad Sweden ATP World Tour,CLAY,2,Fernando Meligeni,Christian Ruud,Fernando Meligeni,6-4; 6-4,F,89,2,2,25,58,17,25,16,33,1,5,10,33,58,0,2,45,65,24,45,7,20,9,15,10,31,65
1995-07-10 00:00:00.000,Gstaad Switzerland ATP World Tour,CLAY,2,Alex Corretja,Thomas Muster,Alex Corretja,7-5; 6-1,R32,92,4,1,45,67,34,45,9,22,1,2,10,43,67,4,3,48,80,30,48,12,32,10,14,9,42,80
1995-07-10 00:00:00.000,Gstaad Switzerland ATP World Tour,CLAY,2,Jakob Hlasek,Thierry Guardiola,Jakob Hlasek,6-7(0); 6-2; 6-2,R32,109,7,5,50,86,40,50,18,36,5,6,14,58,86,1,2,45,84,31,45,21,39,6,11,14,52,84
1995-07-10 00:00:00.000,Gstaad Switzerland ATP World Tour,CLAY,2,Marcelo Rios,Patrick Mohr,Marcelo Rios,6-4; 6-4,R32,81,5,3,31,58,24,31,16,27,1,2,10,40,58,5,3,36,73,29,36,13,37,5,8,10,42,73
1995-07-10 00:00:00.000,Gstaad Switzerland ATP World Tour,CLAY,2,Guy Forget,Jaime Yzaga,Guy Forget,6-1; 6-1,R32,39,9,1,17,33,16,17,12,16,0,0,7,28,33,0,4,22,41,10,22,8,19,0,5,7,18,41
1995-07-10 00:00:00.000,Gstaad Switzerland ATP World Tour,CLAY,2,Marc Rosset,Karel Novacek,Marc Rosset,2-6; 6-3; 6-4,R32,108,13,10,43,83,39,43,17,40,3,5,14,56,83,8,1,44,87,31,44,24,43,3,5,13,55,87
1995-07-10 00:00:00.000,Gstaad Switzerland ATP World Tour,CLAY,2,Francisco Clavet,Fabrice Santoro,Francisco Clavet,7-6(0); 6-0,R32,86,3,2,42,67,28,42,14,25,6,8,9,42,67,3,5,27,55,19,27,9,28,1,6,9,28,55
1995-07-10 00:00:00.000,Gstaad Switzerland ATP World Tour,CLAY,2,Arnaud Boetsch,Aaron Krickstein,Arnaud Boetsch,6-4; 6-2,R32,74,5,2,23,55,16,23,16,32,3,7,9,32,55,4,3,47,80,26,47,9,33,9,16,9,35,80
1995-07-10 00:00:00.000,Gstaad Switzerland ATP World Tour,CLAY,2,Andrei Medvedev,Stefano Pescosolido,Andrei Medvedev,6-4; 3-6; 6-2,R32,96,16,5,44,84,34,44,23,40,6,7,13,57,84,8,6,43,84,36,43,18,41,4,7,14,54,84
1995-07-10 00:00:00.000,Gstaad Switzerland ATP World Tour,CLAY,2,Lionel Roux,Alberto Berasategui,Lionel Roux,6-3; 7-6(4),R32,90,2,3,48,80,36,48,16,32,2,3,11,52,80,2,1,47,67,29,47,12,20,4,6,10,41,67
1995-07-10 00:00:00.000,Gstaad Switzerland ATP World Tour,CLAY,2,Javier Sanchez,Nicklas Kulti,Javier Sanchez,6-2; 6-2,R32,61,2,0,37,50,25,37,10,13,1,1,8,35,50,4,3,20,49,15,20,10,29,4,8,8,25,49
1995-07-10 00:00:00.000,Gstaad Switzerland ATP World Tour,CLAY,2,Albert Costa,Martin Sinner,Albert Costa,6-1; 6-4,R32,57,3,3,32,49,25,32,12,17,1,1,9,37,49,2,7,21,46,17,21,11,25,1,4,8,28,46
1995-07-10 00:00:00.000,Gstaad Switzerland ATP World Tour,CLAY,2,Sergi Bruguera,Francisco Montana,Sergi Bruguera,6-3; 1-6; 6-2,R32,81,8,2,32,67,26,32,14,35,2,5,12,40,67,3,5,41,75,26,41,16,34,3,7,12,42,75
1995-07-10 00:00:00.000,Gstaad Switzerland ATP World Tour,CLAY,2,Andrea Gaudenzi,Slava Dosedel,Andrea Gaudenzi,7-5; 6-2,R32,65,5,1,43,62,32,43,11,19,5,5,10,43,62,1,1,44,59,25,44,10,15,5,8,10,35,59
1995-07-10 00:00:00.000,Gstaad Switzerland ATP World Tour,CLAY,2,Cedric Pioline,Yannick Noah,Cedric Pioline,6-3; 7-6(7),R32,80,3,3,40,66,35,40,15,26,0,0,11,50,66,3,2,37,63,29,37,15,26,1,2,10,44,63
1995-07-10 00:00:00.000,Gstaad Switzerland ATP World Tour,CLAY,2,Vincent Spadea,Sjeng Schalken,Vincent Spadea,6-3; 6-4,R32,68,2,2,34,70,24,34,23,36,9,9,10,47,70,6,3,28,51,25,28,10,23,0,2,9,35,51
1995-07-10 00:00:00.000,Gstaad Switzerland ATP World Tour,CLAY,2,Yevgeny Kafelnikov,Galo Blanco,Yevgeny Kafelnikov,4-6; 6-2; 6-3,R32,97,9,5,52,93,39,52,20,41,3,5,14,59,93,2,0,55,80,34,55,14,25,5,9,13,48,80
1995-07-10 00:00:00.000,Gstaad Switzerland ATP World Tour,CLAY,2,Jakob Hlasek,Alex Corretja,Jakob Hlasek,7-6(2); 6-3,R16,91,10,4,39,76,33,39,21,37,5,5,11,54,76,2,0,44,65,33,44,11,21,2,3,10,44,65
1995-07-10 00:00:00.000,Gstaad Switzerland ATP World Tour,CLAY,2,Marcelo Rios,Guy Forget,Marcelo Rios,6-2; 6-3,R16,57,1,1,24,46,19,24,16,22,4,4,8,35,46,5,4,31,58,19,31,13,27,4,8,9,32,58
1995-07-10 00:00:00.000,Gstaad Switzerland ATP World Tour,CLAY,2,Marc Rosset,Francisco Clavet,Marc Rosset,6-4; 6-3,R16,84,6,3,24,57,21,24,19,33,0,1,10,40,57,0,5,38,66,27,38,11,28,5,8,9,38,66
1995-07-10 00:00:00.000,Gstaad Switzerland ATP World Tour,CLAY,2,Arnaud Boetsch,Andrei Medvedev,Arnaud Boetsch,6-1; 6-3,R16,53,1,2,22,44,17,22,16,22,0,0,8,33,44,4,5,25,48,18,25,6,23,4,8,8,24,48
1995-07-10 00:00:00.000,Gstaad Switzerland ATP World Tour,CLAY,2,Javier Sanchez,Lionel Roux,Javier Sanchez,7-6(3); 6-3,R16,80,8,1,48,65,41,48,8,17,2,3,11,49,65,0,2,39,67,26,39,13,28,4,6,10,39,67
1995-07-10 00:00:00.000,Gstaad Switzerland ATP World Tour,CLAY,2,Sergi Bruguera,Albert Costa,Sergi Bruguera,6-4; 6-1,R16,64,6,2,32,56,28,32,12,24,1,1,9,40,56,0,2,29,48,17,29,10,19,0,3,8,27,48
1995-07-10 00:00:00.000,Gstaad Switzerland ATP World Tour,CLAY,2,Andrea Gaudenzi,Cedric Pioline,Andrea Gaudenzi,7-5; 6-4,R16,83,2,1,37,60,30,37,14,23,1,2,11,44,60,3,3,44,66,29,44,10,22,3,6,11,39,66
1995-07-10 00:00:00.000,Gstaad Switzerland ATP World Tour,CLAY,2,Yevgeny Kafelnikov,Vincent Spadea,Yevgeny Kafelnikov,6-3; 6-4,R16,66,4,6,32,53,23,32,11,21,4,6,9,34,53,4,1,31,63,19,31,13,32,6,11,10,32,63
1995-07-10 00:00:00.000,Gstaad Switzerland ATP World Tour,CLAY,2,Jakob Hlasek,Marcelo Rios,Jakob Hlasek,7-6(5); 3-6; 6-2,Q,141,5,5,43,99,30,43,30,56,6,9,14,60,99,2,5,88,136,55,88,21,48,13,17,15,76,136
1995-07-10 00:00:00.000,Gstaad Switzerland ATP World Tour,CLAY,2,Marc Rosset,Arnaud Boetsch,Marc Rosset,6-3; 6-4,Q,65,5,2,33,57,26,33,16,24,1,1,10,42,57,3,1,27,47,18,27,13,20,0,2,9,31,47
1995-07-10 00:00:00.000,Gstaad Switzerland ATP World Tour,CLAY,2,Sergi Bruguera,Javier Sanchez,Sergi Bruguera,7-5; 6-1,Q,64,4,0,32,57,26,32,15,25,3,3,10,41,57,2,4,37,58,26,37,8,21,4,7,9,34,58
1995-07-10 00:00:00.000,Gstaad Switzerland ATP World Tour,CLAY,2,Yevgeny Kafelnikov,Andrea Gaudenzi,Yevgeny Kafelnikov,6-1; 6-4,Q,58,7,4,33,57,24,33,11,24,4,6,9,35,57,1,5,28,47,18,28,4,19,2,7,8,22,47
1995-07-10 00:00:00.000,Gstaad Switzerland ATP World Tour,CLAY,2,Jakob Hlasek,Marc Rosset,Jakob Hlasek,6-3; 6-4,S,73,3,1,41,67,29,41,17,26,1,1,10,46,67,7,2,25,52,21,25,14,27,2,4,9,35,52
1995-07-10 00:00:00.000,Gstaad Switzerland ATP World Tour,CLAY,2,Yevgeny Kafelnikov,Sergi Bruguera,Yevgeny Kafelnikov,6-4; 6-3,S,56,1,2,35,64,26,35,15,29,3,4,10,41,64,4,1,30,47,22,30,8,17,2,5,9,30,47
1995-07-10 00:00:00.000,Gstaad Switzerland ATP World Tour,CLAY,2,Yevgeny Kafelnikov,Jakob Hlasek,Yevgeny Kafelnikov,6-3; 6-4; 3-6; 6-3,F,153,4,8,55,137,43,55,46,82,11,12,19,89,137,14,6,78,135,56,78,26,57,9,12,18,82,135
1995-07-10 00:00:00.000,Newport RI; U.S.A. ATP World Tour,GRASS,2,David Wheaton,Jamie Morgan,David Wheaton,6-4; 6-2,R32,75,5,1,31,53,26,31,14,22,3,3,9,40,53,9,12,31,63,24,31,13,32,2,5,9,37,63
1995-07-10 00:00:00.000,Newport RI; U.S.A. ATP World Tour,GRASS,2,Alex O'Brien,Wally Masur,Alex O'Brien,4-6; 6-3; 6-4,R32,110,6,3,49,89,35,49,23,40,6,8,14,58,89,7,4,64,91,42,64,13,27,2,6,15,55,91
1995-07-10 00:00:00.000,Newport RI; U.S.A. ATP World Tour,GRASS,2,Laurence Tieleman,Paul Kilderry,Laurence Tieleman,6-2; 3-6; 7-5,R32,94,13,7,42,86,35,42,25,44,3,5,14,60,86,11,7,41,86,35,41,18,45,1,4,14,53,86
1995-07-10 00:00:00.000,Newport RI; U.S.A. ATP World Tour,GRASS,2,Patrick Baur,Scott Draper,Patrick Baur,6-2; 3-6; 7-5,R32,89,2,5,36,71,32,36,22,35,1,2,14,54,71,11,4,43,84,37,43,20,41,3,6,15,57,84
1995-07-10 00:00:00.000,Newport RI; U.S.A. ATP World Tour,GRASS,2,Byron Black,Nuno Marques,Byron Black,6-4; 6-3,R32,60,5,4,31,49,23,31,9,18,0,2,9,32,49,2,6,33,62,19,33,12,29,1,6,10,31,62
1995-07-10 00:00:00.000,Newport RI; U.S.A. ATP World Tour,GRASS,2,David Adams,Louis Gloria,David Adams,6-3; 6-1,R32,64,4,2,25,46,17,25,14,21,1,2,8,31,46,1,7,38,59,19,38,8,21,4,9,8,27,59
1995-07-10 00:00:00.000,Newport RI; U.S.A. ATP World Tour,GRASS,2,Chris Wilkinson,Leander Paes,Chris Wilkinson,6-3; 6-2,R32,62,8,1,26,47,21,26,17,21,1,1,9,38,47,3,3,30,53,17,30,10,23,4,7,8,27,53
1995-07-10 00:00:00.000,Newport RI; U.S.A. ATP World Tour,GRASS,2,Daniel Vacek,Oscar Ortiz,Daniel Vacek,6-3; 6-2,R32,46,6,1,25,43,22,25,15,18,1,1,9,37,43,1,0,36,46,19,36,5,10,2,5,8,24,46
1995-07-10 00:00:00.000,Newport RI; U.S.A. ATP World Tour,GRASS,2,David Prinosil,Grant Stafford,David Prinosil,7-6(4); 6-2,R32,80,10,10,27,75,24,27,23,48,6,8,10,47,75,2,7,37,66,27,37,9,29,3,7,10,36,66
1995-07-10 00:00:00.000,Newport RI; U.S.A. ATP World Tour,GRASS,2,Henrik Holm,Sandon Stolle,Henrik Holm,2-6; 6-4; 6-4,R32,102,7,11,35,79,29,35,27,44,2,4,14,56,79,4,7,50,86,39,50,18,36,3,5,14,57,86
1995-07-10 00:00:00.000,Newport RI; U.S.A. ATP World Tour,GRASS,2,Joern Renzenbrink,Scott Humphries,Joern Renzenbrink,6-3; 3-6; 7-6(4),R32,111,5,5,60,92,45,60,20,32,4,5,15,65,92,12,3,51,86,42,51,20,35,0,1,15,62,86
1995-07-10 00:00:00.000,Newport RI; U.S.A. ATP World Tour,GRASS,2,Todd Woodbridge,Donald Johnson,Todd Woodbridge,6-4; 7-6(3),R32,84,6,8,36,70,30,36,18,34,1,2,11,48,70,2,2,37,66,28,37,13,29,1,3,11,41,66
1995-07-10 00:00:00.000,Newport RI; U.S.A. ATP World Tour,GRASS,2,Marcos Ondruska,Michael Tebbutt,Marcos Ondruska,6-0; 6-3,R32,59,3,3,23,44,17,23,8,21,0,2,7,25,44,0,8,25,56,13,25,8,31,4,11,8,21,56
1995-07-10 00:00:00.000,Newport RI; U.S.A. ATP World Tour,GRASS,2,Mark Philippoussis,Kenny Thorne,Mark Philippoussis,6-3; 6-4,R32,71,7,10,39,70,31,39,16,31,0,0,10,47,70,6,3,35,57,26,35,11,22,2,4,9,37,57
1995-07-10 00:00:00.000,Newport RI; U.S.A. ATP World Tour,GRASS,2,Derrick Rostagno,Markus Zoecke,Derrick Rostagno,6-3; 6-4,R32,62,16,4,41,57,35,41,8,16,1,1,10,43,57,6,2,35,54,26,35,7,19,3,5,9,33,54
1995-07-10 00:00:00.000,Newport RI; U.S.A. ATP World Tour,GRASS,2,Javier Frana,Wade McGuire,Javier Frana,6-1; 6-3,R32,61,6,1,18,46,17,18,14,28,0,1,8,31,46,2,6,22,55,15,22,11,33,3,8,8,26,55
1995-07-10 00:00:00.000,Newport RI; U.S.A. ATP World Tour,GRASS,2,David Wheaton,Alex O'Brien,David Wheaton,7-6(6); 6-4,R16,100,13,3,43,64,39,43,12,21,4,4,11,51,64,9,6,49,79,39,49,12,30,10,11,11,51,79
1995-07-10 00:00:00.000,Newport RI; U.S.A. ATP World Tour,GRASS,2,Laurence Tieleman,Patrick Baur,Laurence Tieleman,7-5; 7-6(5),R16,98,6,4,45,84,33,45,20,39,8,10,12,53,84,5,9,46,87,37,46,17,41,8,11,12,54,87
1995-07-10 00:00:00.000,Newport RI; U.S.A. ATP World Tour,GRASS,2,Byron Black,David Adams,Byron Black,7-5; 6-2,R16,73,1,5,31,60,25,31,13,29,4,6,10,38,60,2,7,28,68,21,28,13,40,5,10,10,34,68
1995-07-10 00:00:00.000,Newport RI; U.S.A. ATP World Tour,GRASS,2,Chris Wilkinson,Daniel Vacek,Chris Wilkinson,3-6; 7-6(4); 6-2,R16,116,5,7,57,97,44,57,18,40,5,9,15,62,97,12,8,66,108,44,66,16,42,14,18,14,60,108
1995-07-10 00:00:00.000,Newport RI; U.S.A. ATP World Tour,GRASS,2,David Prinosil,Henrik Holm,David Prinosil,7-5; 6-2,R16,70,2,8,35,64,29,35,14,29,2,3,10,43,64,6,7,33,60,20,33,13,27,3,7,10,33,60
1995-07-10 00:00:00.000,Newport RI; U.S.A. ATP World Tour,GRASS,2,Todd Woodbridge,Joern Renzenbrink,Todd Woodbridge,6-3; 7-6(3),R16,89,6,8,52,82,39,52,15,30,8,9,11,54,82,3,9,47,81,29,47,18,34,5,7,10,47,81
1995-07-10 00:00:00.000,Newport RI; U.S.A. ATP World Tour,GRASS,2,Marcos Ondruska,Mark Philippoussis,Marcos Ondruska,6-3; 6-4,R16,70,8,6,37,67,33,37,17,30,9,9,10,50,67,12,2,31,51,24,31,8,20,0,2,9,32,51
1995-07-10 00:00:00.000,Newport RI; U.S.A. ATP World Tour,GRASS,2,Derrick Rostagno,Javier Frana,Derrick Rostagno,7-5; 6-4,R16,77,7,2,38,65,31,38,14,27,2,3,11,45,65,5,4,40,67,30,40,11,27,4,7,11,41,67
1995-07-10 00:00:00.000,Newport RI; U.S.A. ATP World Tour,GRASS,2,David Wheaton,Laurence Tieleman,David Wheaton,6-3; 6-2,Q,67,6,3,28,44,26,28,8,16,0,1,9,34,44,8,4,32,60,20,32,9,28,8,12,8,29,60
1995-07-10 00:00:00.000,Newport RI; U.S.A. ATP World Tour,GRASS,2,Byron Black,Chris Wilkinson,Byron Black,6-7(9); 6-4; 6-0,Q,127,9,8,63,109,42,63,21,46,7,10,14,63,109,5,10,42,95,30,42,19,53,6,13,14,49,95
1995-07-10 00:00:00.000,Newport RI; U.S.A. ATP World Tour,GRASS,2,David Prinosil,Todd Woodbridge,David Prinosil,6-4; 6-2,Q,54,9,4,34,54,28,34,11,20,3,3,9,39,54,4,5,25,47,17,25,10,22,0,3,9,27,47
1995-07-10 00:00:00.000,Newport RI; U.S.A. ATP World Tour,GRASS,2,Derrick Rostagno,Marcos Ondruska,Derrick Rostagno,6-4; 6-4,Q,79,5,5,49,70,34,49,8,21,5,7,10,42,70,4,6,33,56,24,33,6,23,2,6,10,30,56
1995-07-10 00:00:00.000,Newport RI; U.S.A. ATP World Tour,GRASS,2,David Wheaton,Byron Black,David Wheaton,6-4; 6-1,S,61,7,1,31,45,24,31,11,14,2,3,9,35,45,4,3,35,53,24,35,3,18,2,6,8,27,53
1995-07-10 00:00:00.000,Newport RI; U.S.A. ATP World Tour,GRASS,2,David Prinosil,Derrick Rostagno,David Prinosil,6-3; 7-6(4),S,85,9,7,43,77,37,43,14,34,2,4,11,51,77,1,4,41,68,30,41,12,27,2,5,10,42,68
1995-07-10 00:00:00.000,Newport RI; U.S.A. ATP World Tour,GRASS,2,David Prinosil,David Wheaton,David Prinosil,7-6(3); 5-7; 6-2,F,125,16,10,52,107,44,52,29,55,10,12,16,73,107,5,2,76,105,51,76,14,29,5,8,16,65,105
1995-07-17 00:00:00.000,Stuttgart Outdoor Germany ATP World Tour,CLAY,2,Thomas Muster,N/A Bye,Thomas Muster,,R64,0,0,0,0,0,0,0,0,0,0,0,0,0,0,0,0,0,0,0,0,0,0,0,0,0,0,0
1995-07-17 00:00:00.000,Stuttgart Outdoor Germany ATP World Tour,CLAY,2,Marcelo Rios,Javier Sanchez,Marcelo Rios,6-2; 6-2,R64,57,2,2,26,49,19,26,16,23,3,3,8,35,49,3,3,40,55,22,40,7,15,7,11,8,29,55
1995-07-17 00:00:00.000,Stuttgart Outdoor Germany ATP World Tour,CLAY,2,Martin Sinner,Karsten Braasch,Martin Sinner,6-3; 6-4,R64,71,1,2,37,59,27,37,13,22,3,4,10,40,59,6,1,29,58,21,29,12,29,2,5,9,33,58
1995-07-17 00:00:00.000,Stuttgart Outdoor Germany ATP World Tour,CLAY,2,Bernd Karbacher,N/A Bye,Bernd Karbacher,,R64,0,0,0,0,0,0,0,0,0,0,0,0,0,0,0,0,0,0,0,0,0,0,0,0,0,0,0
1995-07-17 00:00:00.000,Stuttgart Outdoor Germany ATP World Tour,CLAY,2,Paul Haarhuis,N/A Bye,Paul Haarhuis,,R64,0,0,0,0,0,0,0,0,0,0,0,0,0,0,0,0,0,0,0,0,0,0,0,0,0,0,0
1995-07-17 00:00:00.000,Stuttgart Outdoor Germany ATP World Tour,CLAY,2,Tomas Carbonell,Jan Siemerink,Tomas Carbonell,6-2; 3-6; 6-2,R64,91,3,2,46,66,33,46,16,20,4,5,12,49,66,4,5,59,87,41,59,10,28,4,8,13,51,87
1995-07-17 00:00:00.000,Stuttgart Outdoor Germany ATP World Tour,CLAY,2,Carlos Costa,Fernando Meligeni,Carlos Costa,6-7(3); 7-5; 7-6(8),R64,180,6,8,68,136,44,68,34,68,11,16,18,78,136,3,6,55,121,41,55,28,66,5,11,18,69,121
1995-07-17 00:00:00.000,Stuttgart Outdoor Germany ATP World Tour,CLAY,2,Jacco Eltingh,N/A Bye,Jacco Eltingh,,R64,0,0,0,0,0,0,0,0,0,0,0,0,0,0,0,0,0,0,0,0,0,0,0,0,0,0,0
1995-07-17 00:00:00.000,Stuttgart Outdoor Germany ATP World Tour,CLAY,2,Sergi Bruguera,N/A Bye,Sergi Bruguera,,R64,0,0,0,0,0,0,0,0,0,0,0,0,0,0,0,0,0,0,0,0,0,0,0,0,0,0,0
1995-07-17 00:00:00.000,Stuttgart Outdoor Germany ATP World Tour,CLAY,2,Jaime Yzaga,Hendrik Jan Davids,Jaime Yzaga,7-6(6); 7-6(3),R64,96,1,1,44,75,32,44,18,31,1,4,12,50,75,8,2,45,78,31,45,17,33,4,7,12,48,78
1995-07-17 00:00:00.000,Stuttgart Outdoor Germany ATP World Tour,CLAY,2,Bohdan Ulihrach,Emilio Sanchez,Bohdan Ulihrach,4-6; 7-6(5); 7-6(6),R64,149,7,6,53,114,44,53,33,61,5,8,17,77,114,4,0,70,106,51,70,22,36,3,5,17,73,106
1995-07-17 00:00:00.000,Stuttgart Outdoor Germany ATP World Tour,CLAY,2,Gilbert Schaller,N/A Bye,Gilbert Schaller,,R64,0,0,0,0,0,0,0,0,0,0,0,0,0,0,0,0,0,0,0,0,0,0,0,0,0,0,0
1995-07-17 00:00:00.000,Stuttgart Outdoor Germany ATP World Tour,CLAY,2,Francisco Clavet,N/A Bye,Francisco Clavet,,R64,0,0,0,0,0,0,0,0,0,0,0,0,0,0,0,0,0,0,0,0,0,0,0,0,0,0,0
1995-07-17 00:00:00.000,Stuttgart Outdoor Germany ATP World Tour,CLAY,2,Carl-Uwe Steeb,Jean-Philippe Fleurian,Carl-Uwe Steeb,6-2; 6-1,R64,56,1,3,25,47,21,25,12,22,5,5,7,33,47,2,1,40,50,18,40,5,10,3,8,8,23,50
1995-07-17 00:00:00.000,Stuttgart Outdoor Germany ATP World Tour,CLAY,2,Marc-Kevin Goellner,Ellis Ferreira,Marc-Kevin Goellner,6-3; 6-4,R64,66,9,3,32,64,25,32,17,32,4,5,10,42,64,3,5,41,60,25,41,8,19,6,9,9,33,60
1995-07-17 00:00:00.000,Stuttgart Outdoor Germany ATP World Tour,CLAY,2,Andrea Gaudenzi,N/A Bye,Andrea Gaudenzi,,R64,0,0,0,0,0,0,0,0,0,0,0,0,0,0,0,0,0,0,0,0,0,0,0,0,0,0,0
1995-07-17 00:00:00.000,Stuttgart Outdoor Germany ATP World Tour,CLAY,2,Andrei Medvedev,N/A Bye,Andrei Medvedev,,R64,0,0,0,0,0,0,0,0,0,0,0,0,0,0,0,0,0,0,0,0,0,0,0,0,0,0,0
1995-07-17 00:00:00.000,Stuttgart Outdoor Germany ATP World Tour,CLAY,2,Arnaud Boetsch,Karol Kucera,Arnaud Boetsch,6-3; 6-2,R64,80,2,1,21,42,16,21,13,21,0,1,8,29,42,1,5,27,76,19,27,19,49,8,13,9,38,76
1995-07-17 00:00:00.000,Stuttgart Outdoor Germany ATP World Tour,CLAY,2,Renzo Furlan,Sasa Hirszon,Renzo Furlan,6-3; 4-6; 6-4,R64,118,4,1,51,84,33,51,21,33,4,7,14,54,84,2,1,43,87,32,43,20,44,5,10,15,52,87
1995-07-17 00:00:00.000,Stuttgart Outdoor Germany ATP World Tour,CLAY,2,Karel Novacek,N/A Bye,Karel Novacek,,R64,0,0,0,0,0,0,0,0,0,0,0,0,0,0,0,0,0,0,0,0,0,0,0,0,0,0,0
1995-07-17 00:00:00.000,Stuttgart Outdoor Germany ATP World Tour,CLAY,2,Albert Costa,N/A Bye,Albert Costa,,R64,0,0,0,0,0,0,0,0,0,0,0,0,0,0,0,0,0,0,0,0,0,0,0,0,0,0,0
1995-07-17 00:00:00.000,Stuttgart Outdoor Germany ATP World Tour,CLAY,2,Andrei Chesnokov,Patrik Kuhnen,Andrei Chesnokov,3-6; 6-4; 6-4,R64,109,7,2,62,98,42,62,21,36,8,10,15,63,98,10,2,47,83,36,47,18,36,3,5,14,54,83
1995-07-17 00:00:00.000,Stuttgart Outdoor Germany ATP World Tour,CLAY,2,Oscar Martinez,Bill Behrens,Oscar Martinez,6-2; 2-6; 6-4,R64,88,2,5,53,91,36,53,18,38,6,9,13,54,91,4,0,47,76,33,47,14,29,5,9,13,47,76
1995-07-17 00:00:00.000,Stuttgart Outdoor Germany ATP World Tour,CLAY,2,Alberto Berasategui,N/A Bye,Alberto Berasategui,,R64,0,0,0,0,0,0,0,0,0,0,0,0,0,0,0,0,0,0,0,0,0,0,0,0,0,0,0
1995-07-17 00:00:00.000,Stuttgart Outdoor Germany ATP World Tour,CLAY,2,Alex Corretja,N/A Bye,Alex Corretja,,R64,0,0,0,0,0,0,0,0,0,0,0,0,0,0,0,0,0,0,0,0,0,0,0,0,0,0,0
1995-07-17 00:00:00.000,Stuttgart Outdoor Germany ATP World Tour,CLAY,2,Jan Apell,Henri Leconte,Jan Apell,6-3; 3-6; 7-5,R64,102,3,1,59,88,43,59,16,29,4,7,15,59,88,6,8,46,90,35,46,19,44,3,7,15,54,90
1995-07-17 00:00:00.000,Stuttgart Outdoor Germany ATP World Tour,CLAY,2,Slava Dosedel,Andrei Olhovskiy,Slava Dosedel,6-3; 6-1,R64,45,5,0,28,43,24,28,10,15,1,1,8,34,43,5,5,28,51,16,28,11,23,3,7,8,27,51
1995-07-17 00:00:00.000,Stuttgart Outdoor Germany ATP World Tour,CLAY,2,Jonas Bjorkman,N/A Bye,Jonas Bjorkman,,R64,0,0,0,0,0,0,0,0,0,0,0,0,0,0,0,0,0,0,0,0,0,0,0,0,0,0,0
1995-07-17 00:00:00.000,Stuttgart Outdoor Germany ATP World Tour,CLAY,2,Fabrice Santoro,N/A Bye,Fabrice Santoro,,R64,0,0,0,0,0,0,0,0,0,0,0,0,0,0,0,0,0,0,0,0,0,0,0,0,0,0,0
1995-07-17 00:00:00.000,Stuttgart Outdoor Germany ATP World Tour,CLAY,2,Marcelo Filippini,Alex Antonitsch,Marcelo Filippini,6-1; 1-0 RET,R64,29,3,0,18,28,13,18,6,10,3,3,5,19,28,0,4,12,24,8,12,2,12,0,3,4,10,24
1995-07-17 00:00:00.000,Stuttgart Outdoor Germany ATP World Tour,CLAY,2,Magnus Gustafsson,Lionel Roux,Magnus Gustafsson,6-3; 7-5,R64,93,3,2,48,63,31,48,7,15,2,4,10,38,63,3,5,42,79,27,42,14,37,6,11,11,41,79
1995-07-17 00:00:00.000,Stuttgart Outdoor Germany ATP World Tour,CLAY,2,Thierry Guardiola,N/A Bye,Thierry Guardiola,,R64,0,0,0,0,0,0,0,0,0,0,0,0,0,0,0,0,0,0,0,0,0,0,0,0,0,0,0
1995-07-17 00:00:00.000,Stuttgart Outdoor Germany ATP World Tour,CLAY,2,Thomas Muster,Marcelo Rios,Thomas Muster,6-2; 6-4,R32,75,2,1,31,57,20,31,16,26,2,4,9,36,57,3,1,41,65,18,41,14,24,9,14,9,32,65
1995-07-17 00:00:00.000,Stuttgart Outdoor Germany ATP World Tour,CLAY,2,Bernd Karbacher,Martin Sinner,Bernd Karbacher,6-1; 6-1,R32,64,5,1,23,42,18,23,11,19,1,1,7,29,42,5,2,26,54,15,26,8,28,1,6,7,23,54
1995-07-17 00:00:00.000,Stuttgart Outdoor Germany ATP World Tour,CLAY,2,Tomas Carbonell,Paul Haarhuis,Tomas Carbonell,6-4; 4-6; 6-2,R32,130,3,2,69,96,45,69,12,27,4,8,14,57,96,3,2,69,115,41,69,20,46,15,21,14,61,115
1995-07-17 00:00:00.000,Stuttgart Outdoor Germany ATP World Tour,CLAY,2,Carlos Costa,Jacco Eltingh,Carlos Costa,6-4; 6-2,R32,64,5,1,42,57,31,42,8,15,6,7,9,39,57,5,6,29,57,17,29,13,28,3,7,9,30,57
1995-07-17 00:00:00.000,Stuttgart Outdoor Germany ATP World Tour,CLAY,2,Sergi Bruguera,Jaime Yzaga,Sergi Bruguera,6-4; 6-3,R32,79,3,2,37,65,28,37,15,28,2,3,10,43,65,3,1,24,59,18,24,18,35,3,6,9,36,59
1995-07-17 00:00:00.000,Stuttgart Outdoor Germany ATP World Tour,CLAY,2,Gilbert Schaller,Bohdan Ulihrach,Gilbert Schaller,6-4; 6-2,R32,5,0,1,43,59,27,43,10,16,3,5,9,37,59,3,2,31,58,21,31,7,27,5,10,9,28,58
1995-07-17 00:00:00.000,Stuttgart Outdoor Germany ATP World Tour,CLAY,2,Carl-Uwe Steeb,Francisco Clavet,Carl-Uwe Steeb,6-4; 6-7(5); 6-2,R32,127,2,2,60,96,51,60,20,36,7,7,15,71,96,1,4,68,96,44,68,19,28,8,11,15,63,96
1995-07-17 00:00:00.000,Stuttgart Outdoor Germany ATP World Tour,CLAY,2,Marc-Kevin Goellner,Andrea Gaudenzi,Marc-Kevin Goellner,4-6; 6-3; 6-2,R32,104,12,4,42,92,33,42,27,50,3,4,14,60,92,3,2,48,78,35,48,13,30,4,7,13,48,78
1995-07-17 00:00:00.000,Stuttgart Outdoor Germany ATP World Tour,CLAY,2,Arnaud Boetsch,Andrei Medvedev,Arnaud Boetsch,1-6; 6-1; 6-4,R32,83,5,2,33,66,24,33,16,33,4,8,12,40,66,4,3,38,70,22,38,16,32,4,9,12,38,70
1995-07-17 00:00:00.000,Stuttgart Outdoor Germany ATP World Tour,CLAY,2,Karel Novacek,Renzo Furlan,Karel Novacek,6-3; 3-6; 6-4,R32,105,12,1,41,72,34,41,19,31,2,5,14,53,72,4,0,42,79,29,42,20,37,6,10,14,49,79
1995-07-17 00:00:00.000,Stuttgart Outdoor Germany ATP World Tour,CLAY,2,Albert Costa,Andrei Chesnokov,Albert Costa,6-2; 7-6(4),R32,92,7,1,59,77,38,59,11,18,8,10,10,49,77,7,1,37,69,25,37,13,32,7,11,10,38,69
1995-07-17 00:00:00.000,Stuttgart Outdoor Germany ATP World Tour,CLAY,2,Oscar Martinez,Alberto Berasategui,Oscar Martinez,7-6(1); 7-6(6),R32,95,3,2,50,88,30,50,18,38,7,13,12,48,88,2,1,77,92,40,77,6,15,10,16,12,46,92
1995-07-17 00:00:00.000,Stuttgart Outdoor Germany ATP World Tour,CLAY,2,Jan Apell,Alex Corretja,Jan Apell,2-6; 6-4; 6-3,R32,102,0,1,53,84,37,53,14,31,2,6,13,51,84,1,2,49,79,33,49,12,30,4,9,14,45,79
1995-07-17 00:00:00.000,Stuttgart Outdoor Germany ATP World Tour,CLAY,2,Slava Dosedel,Jonas Bjorkman,Slava Dosedel,6-3; 6-2,R32,60,4,0,32,50,20,32,12,18,1,3,9,32,50,0,3,27,48,14,27,8,21,2,7,8,22,48
1995-07-17 00:00:00.000,Stuttgart Outdoor Germany ATP World Tour,CLAY,2,Marcelo Filippini,Fabrice Santoro,Marcelo Filippini,6-0; 3-0 RET,R32,47,0,1,12,27,9,12,9,15,0,0,5,18,27,0,3,11,34,5,11,5,23,2,7,5,10,34
1995-07-17 00:00:00.000,Stuttgart Outdoor Germany ATP World Tour,CLAY,2,Magnus Gustafsson,Thierry Guardiola,Magnus Gustafsson,6-3; 6-4,R32,73,0,1,43,66,31,43,16,23,7,7,10,47,66,4,0,35,51,25,35,9,16,2,4,9,34,51
1995-07-17 00:00:00.000,Stuttgart Outdoor Germany ATP World Tour,CLAY,2,Thomas Muster,Bernd Karbacher,Thomas Muster,6-4; 6-2,R16,72,1,2,36,61,28,36,10,25,3,5,9,38,61,4,4,16,49,13,16,10,33,3,8,9,23,49
1995-07-17 00:00:00.000,Stuttgart Outdoor Germany ATP World Tour,CLAY,2,Tomas Carbonell,Carlos Costa,Tomas Carbonell,6-3; 6-2,R16,61,1,1,44,50,34,44,4,6,1,1,9,38,50,2,2,36,53,18,36,10,17,1,4,8,28,53
1995-07-17 00:00:00.000,Stuttgart Outdoor Germany ATP World Tour,CLAY,2,Sergi Bruguera,Gilbert Schaller,Sergi Bruguera,6-1; 6-1,R16,78,9,0,41,61,32,41,8,20,9,9,7,40,61,1,0,42,53,20,42,3,11,6,11,7,23,53
1995-07-17 00:00:00.000,Stuttgart Outdoor Germany ATP World Tour,CLAY,2,Carl-Uwe Steeb,Marc-Kevin Goellner,Carl-Uwe Steeb,7-5; 6-2,R16,74,1,0,29,60,22,29,16,31,3,5,10,38,60,4,4,30,66,21,30,12,36,6,11,10,33,66
1995-07-17 00:00:00.000,Stuttgart Outdoor Germany ATP World Tour,CLAY,2,Arnaud Boetsch,Karel Novacek,Arnaud Boetsch,6-4; 5-7; 7-5,R16,127,10,5,50,93,37,50,22,43,1,5,17,59,93,11,3,74,123,47,74,24,49,10,15,17,71,123
1995-07-17 00:00:00.000,Stuttgart Outdoor Germany ATP World Tour,CLAY,2,Albert Costa,Oscar Martinez,Albert Costa,6-2; 6-4,R16,68,1,2,40,55,27,40,10,15,3,4,9,37,55,1,4,35,62,20,35,12,27,3,7,9,32,62
1995-07-17 00:00:00.000,Stuttgart Outdoor Germany ATP World Tour,CLAY,2,Jan Apell,Slava Dosedel,Jan Apell,6-3; 2-6; 6-3,R16,98,1,3,63,89,44,63,11,26,6,8,13,55,89,2,2,50,74,36,50,11,24,5,8,13,47,74
1995-07-17 00:00:00.000,Stuttgart Outdoor Germany ATP World Tour,CLAY,2,Magnus Gustafsson,Marcelo Filippini,Magnus Gustafsson,6-4; 1-6; 6-1,R16,94,0,4,45,68,29,45,11,23,3,7,12,40,68,4,0,52,68,28,52,8,16,1,6,12,36,68
1995-07-17 00:00:00.000,Stuttgart Outdoor Germany ATP World Tour,CLAY,2,Thomas Muster,Tomas Carbonell,Thomas Muster,6-2; 6-0,Q,54,0,0,27,39,18,27,8,12,1,2,7,26,39,2,1,31,46,15,31,3,15,0,6,7,18,46
1995-07-17 00:00:00.000,Stuttgart Outdoor Germany ATP World Tour,CLAY,2,Sergi Bruguera,Carl-Uwe Steeb,Sergi Bruguera,6-3; 6-4,Q,70,5,1,34,61,28,34,14,27,2,4,10,42,61,0,2,27,51,16,27,11,24,3,7,9,27,51
1995-07-17 00:00:00.000,Stuttgart Outdoor Germany ATP World Tour,CLAY,2,Arnaud Boetsch,Albert Costa,Arnaud Boetsch,4-6; 6-3; 6-4,Q,113,7,2,48,88,40,48,24,40,4,5,15,64,88,2,1,69,94,41,69,16,25,8,10,14,57,94
1995-07-17 00:00:00.000,Stuttgart Outdoor Germany ATP World Tour,CLAY,2,Jan Apell,Magnus Gustafsson,Jan Apell,6-3; 3-6; 6-3,Q,105,4,4,74,98,50,74,9,24,5,8,14,59,98,4,4,49,68,36,49,6,19,2,6,13,42,68
1995-07-17 00:00:00.000,Stuttgart Outdoor Germany ATP World Tour,CLAY,2,Thomas Muster,Sergi Bruguera,Thomas Muster,6-7(5); 7-6(5); 6-2,S,176,3,3,78,119,49,78,15,41,8,15,16,64,119,10,2,79,120,42,79,18,41,6,15,16,60,120
1995-07-17 00:00:00.000,Stuttgart Outdoor Germany ATP World Tour,CLAY,2,Jan Apell,Arnaud Boetsch,Jan Apell,6-2; 6-4,S,77,1,1,34,52,26,34,11,18,0,0,9,37,52,6,1,24,54,17,24,15,30,6,9,9,32,54
1995-07-17 00:00:00.000,Stuttgart Outdoor Germany ATP World Tour,CLAY,2,Thomas Muster,Jan Apell,Thomas Muster,6-2; 6-2,F,55,0,1,30,48,22,30,13,18,3,3,8,35,48,0,0,30,45,16,30,8,15,2,6,8,24,45
1995-07-17 00:00:00.000,Washington DC; U.S.A. ATP World Tour,HARD,2,Andre Agassi,N/A Bye,Andre Agassi,,R64,0,0,0,0,0,0,0,0,0,0,0,0,0,0,0,0,0,0,0,0,0,0,0,0,0,0,0
1995-07-17 00:00:00.000,Washington DC; U.S.A. ATP World Tour,HARD,2,Rodolphe Gilbert,Henrik Holm,Rodolphe Gilbert,6-2; 6-7(2); 6-2,R64,133,1,4,61,98,42,61,21,37,5,7,14,63,98,8,15,55,109,38,55,21,54,13,19,14,59,109
1995-07-17 00:00:00.000,Washington DC; U.S.A. ATP World Tour,HARD,2,Michael Joyce,Grant Connell,Michael Joyce,6-4; 6-2,R64,61,5,1,31,52,25,31,14,21,0,0,9,39,52,4,3,32,54,22,32,8,22,2,5,9,30,54
1995-07-17 00:00:00.000,Washington DC; U.S.A. ATP World Tour,HARD,2,Jamie Morgan,Vincent Spadea,Jamie Morgan,6-4; 6-1,R64,57,6,2,23,48,21,23,16,25,1,1,9,37,48,0,1,19,40,10,19,13,21,0,3,8,23,40
1995-07-17 00:00:00.000,Washington DC; U.S.A. ATP World Tour,HARD,2,Aaron Krickstein,Marcos Ondruska,Aaron Krickstein,6-3; 6-3,R64,64,7,4,23,50,16,23,18,27,0,1,9,34,50,2,1,24,50,17,24,11,26,3,7,9,28,50
1995-07-17 00:00:00.000,Washington DC; U.S.A. ATP World Tour,HARD,2,Mauricio Hadad,Kenny Thorne,Mauricio Hadad,6-3; 6-4,R64,68,1,1,37,52,22,37,9,15,3,6,9,31,52,0,3,32,56,18,32,8,24,0,6,10,26,56
1995-07-17 00:00:00.000,Washington DC; U.S.A. ATP World Tour,HARD,2,Mark Philippoussis,Rob Givone,Mark Philippoussis,6-7(7); 6-2; 6-4,R64,114,9,3,57,85,47,57,17,28,2,3,15,64,85,10,9,50,94,37,50,21,44,4,8,15,58,94
1995-07-17 00:00:00.000,Washington DC; U.S.A. ATP World Tour,HARD,2,Olivier Delaitre,N/A Bye,Olivier Delaitre,,R64,0,0,0,0,0,0,0,0,0,0,0,0,0,0,0,0,0,0,0,0,0,0,0,0,0,0,0
1995-07-17 00:00:00.000,Washington DC; U.S.A. ATP World Tour,HARD,2,Todd Martin,N/A Bye,Todd Martin,,R64,0,0,0,0,0,0,0,0,0,0,0,0,0,0,0,0,0,0,0,0,0,0,0,0,0,0,0
1995-07-17 00:00:00.000,Washington DC; U.S.A. ATP World Tour,HARD,2,Jordi Burillo,Markus Zoecke,Jordi Burillo,6-4; 6-2,R64,54,9,1,26,43,21,26,13,17,2,3,9,34,43,5,2,36,56,24,36,6,20,4,8,9,30,56
1995-07-17 00:00:00.000,Washington DC; U.S.A. ATP World Tour,HARD,2,Nicolas Pereira,Paul Goldstein,Nicolas Pereira,4-6; 6-4; 6-3,R64,100,2,6,50,86,36,50,18,36,2,6,15,54,86,2,2,52,83,35,52,14,31,6,11,14,49,83
1995-07-17 00:00:00.000,Washington DC; U.S.A. ATP World Tour,HARD,2,Byron Black,Jeff Tarango,Byron Black,6-3; 5-7; 6-3,R64,131,11,3,62,111,45,62,21,49,14,17,15,66,111,8,8,53,99,39,53,19,46,5,10,15,58,99
1995-07-17 00:00:00.000,Washington DC; U.S.A. ATP World Tour,HARD,2,Martin Damm,Jim Grabb,Martin Damm,6-2; 4-6; 6-3,R64,122,10,2,53,98,37,53,25,45,8,10,14,62,98,12,1,42,73,28,42,16,31,7,11,13,44,73
1995-07-17 00:00:00.000,Washington DC; U.S.A. ATP World Tour,HARD,2,Gianluca Pozzi,Scott Draper,Gianluca Pozzi,6-2; 6-1,R64,52,1,0,18,39,14,18,15,21,1,1,7,29,39,5,2,35,55,21,35,5,20,9,14,8,26,55
1995-07-17 00:00:00.000,Washington DC; U.S.A. ATP World Tour,HARD,2,Derrick Rostagno,Joern Renzenbrink,Derrick Rostagno,6-2; 6-0,R64,51,2,1,31,51,24,31,10,20,5,5,7,34,51,0,2,17,33,8,17,3,16,1,6,7,11,33
1995-07-17 00:00:00.000,Washington DC; U.S.A. ATP World Tour,HARD,2,Jason Stoltenberg,N/A Bye,Jason Stoltenberg,,R64,0,0,0,0,0,0,0,0,0,0,0,0,0,0,0,0,0,0,0,0,0,0,0,0,0,0,0
1995-07-17 00:00:00.000,Washington DC; U.S.A. ATP World Tour,HARD,2,MaliVai Washington,N/A Bye,MaliVai Washington,,R64,0,0,0,0,0,0,0,0,0,0,0,0,0,0,0,0,0,0,0,0,0,0,0,0,0,0,0
1995-07-17 00:00:00.000,Washington DC; U.S.A. ATP World Tour,HARD,2,Carsten Arriens,Filip Dewulf,Carsten Arriens,6-3; 6-3,R64,83,7,5,37,72,26,37,15,35,5,7,9,41,72,3,7,29,63,17,29,16,34,8,13,9,33,63
1995-07-17 00:00:00.000,Washington DC; U.S.A. ATP World Tour,HARD,2,Rogier Wassen,Patrick Baur,Rogier Wassen,3-6; 6-0; 6-3,R64,107,6,3,39,74,28,39,18,35,4,7,12,46,74,10,4,44,82,25,44,17,38,3,9,12,42,82
1995-07-17 00:00:00.000,Washington DC; U.S.A. ATP World Tour,HARD,2,Patrick McEnroe,Alexander Mronz,Patrick McEnroe,6-3; 6-2,R64,67,6,1,35,56,23,35,17,21,5,6,9,40,56,6,6,22,47,14,22,9,25,0,4,8,23,47
1995-07-17 00:00:00.000,Washington DC; U.S.A. ATP World Tour,HARD,2,Patrick Rafter,Donald Johnson,Patrick Rafter,1-6; 7-5; 6-3,R64,114,3,6,47,80,32,47,13,33,3,8,14,45,80,2,10,51,87,33,51,16,36,4,9,14,49,87
1995-07-17 00:00:00.000,Washington DC; U.S.A. ATP World Tour,HARD,2,Jonathan Stark,Scott Humphries,Jonathan Stark,6-1; 6-3,R64,59,12,4,26,39,23,26,9,13,0,0,8,32,39,3,3,27,53,14,27,13,26,2,6,8,27,53
1995-07-17 00:00:00.000,Washington DC; U.S.A. ATP World Tour,HARD,2,Wade McGuire,Oscar Ortiz,Wade McGuire,3-6; 6-2; 6-3,R64,107,5,2,38,76,32,38,17,38,4,7,13,49,76,1,0,48,81,25,48,19,33,5,10,13,44,81
1995-07-17 00:00:00.000,Washington DC; U.S.A. ATP World Tour,HARD,2,Thomas Enqvist,N/A Bye,Thomas Enqvist,,R64,0,0,0,0,0,0,0,0,0,0,0,0,0,0,0,0,0,0,0,0,0,0,0,0,0,0,0
1995-07-17 00:00:00.000,Washington DC; U.S.A. ATP World Tour,HARD,2,Richey Reneberg,N/A Bye,Richey Reneberg,,R64,0,0,0,0,0,0,0,0,0,0,0,0,0,0,0,0,0,0,0,0,0,0,0,0,0,0,0
1995-07-17 00:00:00.000,Washington DC; U.S.A. ATP World Tour,HARD,2,Grant Stafford,David Prinosil,Grant Stafford,4-6; 7-6(4); 6-0,R64,106,6,3,58,94,42,58,22,36,4,5,14,64,94,10,11,45,102,33,45,27,57,5,8,14,60,102
1995-07-17 00:00:00.000,Washington DC; U.S.A. ATP World Tour,HARD,2,Cristiano Caratti,Sandor Noszaly,Cristiano Caratti,4-6; 7-6(3); 6-0,R64,123,4,3,61,90,46,61,17,29,6,8,14,63,90,6,7,61,95,41,61,15,34,7,11,14,56,95
1995-07-17 00:00:00.000,Washington DC; U.S.A. ATP World Tour,HARD,2,Nuno Marques,Petr Korda,Nuno Marques,4-6; 6-4; 6-4,R64,105,3,1,64,90,39,64,18,26,1,4,15,57,90,1,8,42,87,29,42,24,45,5,9,15,53,87
1995-07-17 00:00:00.000,Washington DC; U.S.A. ATP World Tour,HARD,2,Adrian Voinea,David Nainkin,Adrian Voinea,4-6; 6-1; 6-2,R64,96,11,1,44,77,34,44,17,33,9,12,13,51,77,3,6,52,80,29,52,12,28,11,17,12,41,80
1995-07-17 00:00:00.000,Washington DC; U.S.A. ATP World Tour,HARD,2,Paul Wekesa,David Adams,Paul Wekesa,6-2; 6-3,R64,64,1,1,22,44,17,22,17,22,1,1,8,34,44,0,6,25,60,20,25,12,35,3,7,9,32,60
1995-07-17 00:00:00.000,Washington DC; U.S.A. ATP World Tour,HARD,2,Michael Tebbutt,Wally Masur,Michael Tebbutt,6-3; 6-2,R64,67,10,0,31,49,22,31,16,18,1,1,9,38,49,1,6,27,50,18,27,10,23,4,7,8,28,50
1995-07-17 00:00:00.000,Washington DC; U.S.A. ATP World Tour,HARD,2,Stefan Edberg,N/A Bye,Stefan Edberg,,R64,0,0,0,0,0,0,0,0,0,0,0,0,0,0,0,0,0,0,0,0,0,0,0,0,0,0,0
1995-07-17 00:00:00.000,Washington DC; U.S.A. ATP World Tour,HARD,2,Andre Agassi,Rodolphe Gilbert,Andre Agassi,6-2; 6-2,R32,58,3,0,20,37,19,20,13,17,0,0,8,32,37,1,3,21,54,14,21,13,33,7,11,8,27,54
1995-07-17 00:00:00.000,Washington DC; U.S.A. ATP World Tour,HARD,2,Michael Joyce,Jamie Morgan,Michael Joyce,6-4; 7-6(5),R32,77,4,4,42,73,32,42,18,31,3,4,11,50,73,17,3,38,64,28,38,16,26,0,2,11,44,64
1995-07-17 00:00:00.000,Washington DC; U.S.A. ATP World Tour,HARD,2,Mauricio Hadad,Aaron Krickstein,Mauricio Hadad,3-6; 6-1; 6-4,R32,116,9,3,44,82,29,44,21,38,4,7,13,50,82,0,2,55,100,35,55,21,45,14,19,13,56,100
1995-07-17 00:00:00.000,Washington DC; U.S.A. ATP World Tour,HARD,2,Mark Philippoussis,Olivier Delaitre,Mark Philippoussis,6-3; 6-2,R32,56,10,2,40,52,27,40,7,12,5,7,9,34,52,1,3,24,46,14,24,6,22,3,8,8,20,46
1995-07-17 00:00:00.000,Washington DC; U.S.A. ATP World Tour,HARD,2,Todd Martin,Jordi Burillo,Todd Martin,6-3; 6-4,R32,83,9,3,33,72,26,33,23,39,6,6,10,49,72,6,5,38,62,28,38,8,24,3,5,9,36,62
1995-07-17 00:00:00.000,Washington DC; U.S.A. ATP World Tour,HARD,2,Byron Black,Nicolas Pereira,Byron Black,6-2; 3-6; 6-3,R32,86,2,2,46,81,36,46,19,35,2,3,13,55,81,8,1,46,72,34,46,13,26,4,7,13,47,72
1995-07-17 00:00:00.000,Washington DC; U.S.A. ATP World Tour,HARD,2,Gianluca Pozzi,Martin Damm,Gianluca Pozzi,7-6(4); 6-2,R32,92,6,2,33,75,27,33,25,42,8,9,10,52,75,2,2,38,65,25,38,14,27,4,7,10,39,65
1995-07-17 00:00:00.000,Washington DC; U.S.A. ATP World Tour,HARD,2,Jason Stoltenberg,Derrick Rostagno,Jason Stoltenberg,6-2; 6-4,R32,77,1,3,37,59,24,37,11,22,5,7,9,35,59,2,4,34,59,19,34,10,25,5,10,9,29,59
1995-07-17 00:00:00.000,Washington DC; U.S.A. ATP World Tour,HARD,2,MaliVai Washington,Carsten Arriens,MaliVai Washington,6-2; 6-2,R32,61,3,1,25,43,19,25,11,18,2,3,8,30,43,1,4,29,59,17,29,10,30,2,7,8,27,59
1995-07-17 00:00:00.000,Washington DC; U.S.A. ATP World Tour,HARD,2,Patrick McEnroe,Rogier Wassen,Patrick McEnroe,6-4; 6-3,R32,80,8,5,38,70,30,38,14,32,6,7,10,44,70,3,5,34,61,22,34,14,27,1,4,9,36,61
1995-07-17 00:00:00.000,Washington DC; U.S.A. ATP World Tour,HARD,2,Patrick Rafter,Jonathan Stark,Patrick Rafter,6-1; 6-4,R32,77,7,4,38,66,29,38,15,28,3,3,9,44,66,2,6,21,46,17,21,10,25,1,4,8,27,46
1995-07-17 00:00:00.000,Washington DC; U.S.A. ATP World Tour,HARD,2,Thomas Enqvist,Wade McGuire,Thomas Enqvist,2-6; 6-2; 6-3,R32,109,7,5,43,90,32,43,27,47,7,9,13,59,90,10,5,48,82,32,48,19,34,4,7,12,51,82
1995-07-17 00:00:00.000,Washington DC; U.S.A. ATP World Tour,HARD,2,Grant Stafford,Richey Reneberg,Grant Stafford,3-6; 6-4; 6-2,R32,102,2,0,59,86,37,59,15,27,7,10,13,52,86,12,4,47,85,30,47,18,38,8,13,14,48,85
1995-07-17 00:00:00.000,Washington DC; U.S.A. ATP World Tour,HARD,2,Cristiano Caratti,Nuno Marques,Cristiano Caratti,6-2; 6-2,R32,64,0,1,33,47,27,33,8,14,3,3,8,35,47,3,4,42,57,26,42,4,15,4,8,8,30,57
1995-07-17 00:00:00.000,Washington DC; U.S.A. ATP World Tour,HARD,2,Paul Wekesa,Adrian Voinea,Paul Wekesa,6-4; 3-6; 7-6(4),R32,125,3,6,65,111,50,65,22,46,7,9,15,72,111,5,3,64,98,47,64,20,34,6,8,16,67,98
1995-07-17 00:00:00.000,Washington DC; U.S.A. ATP World Tour,HARD,2,Stefan Edberg,Michael Tebbutt,Stefan Edberg,6-2; 6-2,R32,74,1,5,21,52,18,21,19,31,3,3,8,37,52,2,10,33,68,26,33,9,35,5,9,8,35,68
1995-07-17 00:00:00.000,Washington DC; U.S.A. ATP World Tour,HARD,2,Andre Agassi,Michael Joyce,Andre Agassi,6-2; 6-2,R16,70,4,3,30,62,22,30,20,32,5,5,8,42,62,0,2,32,51,17,32,7,19,4,8,8,24,51
1995-07-17 00:00:00.000,Washington DC; U.S.A. ATP World Tour,HARD,2,Mauricio Hadad,Mark Philippoussis,Mauricio Hadad,1-6; 7-5; 7-6(3),R16,106,5,2,55,84,38,55,18,29,2,5,15,56,84,14,2,60,98,46,60,19,38,2,4,16,65,98
1995-07-17 00:00:00.000,Washington DC; U.S.A. ATP World Tour,HARD,2,Todd Martin,Byron Black,Todd Martin,4-6; 7-5; 6-1,R16,99,20,4,58,84,44,58,11,26,1,4,15,55,84,2,3,49,85,32,49,16,36,4,9,14,48,85
1995-07-17 00:00:00.000,Washington DC; U.S.A. ATP World Tour,HARD,2,Jason Stoltenberg,Gianluca Pozzi,Jason Stoltenberg,6-0; 6-4,R16,57,1,1,34,46,26,34,8,12,1,1,8,34,46,1,2,23,49,11,23,14,26,1,5,8,25,49
1995-07-17 00:00:00.000,Washington DC; U.S.A. ATP World Tour,HARD,2,Patrick McEnroe,MaliVai Washington,Patrick McEnroe,7-5; 6-3,R16,82,4,2,28,49,24,28,17,21,0,1,11,41,49,6,4,35,68,26,35,13,33,3,6,10,39,68
1995-07-17 00:00:00.000,Washington DC; U.S.A. ATP World Tour,HARD,2,Patrick Rafter,Thomas Enqvist,Patrick Rafter,6-2; 6-4,R16,61,10,1,31,48,27,31,10,17,0,0,9,37,48,3,3,31,53,22,31,10,22,2,5,9,32,53
1995-07-17 00:00:00.000,Washington DC; U.S.A. ATP World Tour,HARD,2,Cristiano Caratti,Grant Stafford,Cristiano Caratti,7-6(6); 6-1,R16,76,1,4,38,62,25,38,15,24,1,3,10,40,62,0,0,38,61,22,38,9,23,1,5,9,31,61
1995-07-17 00:00:00.000,Washington DC; U.S.A. ATP World Tour,HARD,2,Stefan Edberg,Paul Wekesa,Stefan Edberg,6-2; 6-1,R16,70,1,1,25,42,22,25,11,17,1,1,8,33,42,3,2,38,70,21,38,14,32,9,13,7,35,70
1995-07-17 00:00:00.000,Washington DC; U.S.A. ATP World Tour,HARD,2,Andre Agassi,Mauricio Hadad,Andre Agassi,6-3; 6-4,Q,74,1,1,47,70,32,47,13,23,5,6,10,45,70,3,0,32,53,19,32,10,21,2,5,9,29,53
1995-07-17 00:00:00.000,Washington DC; U.S.A. ATP World Tour,HARD,2,Todd Martin,Jason Stoltenberg,Todd Martin,6-2; 6-3,Q,71,4,0,33,51,23,33,11,18,4,5,8,34,51,1,3,39,68,20,39,13,29,4,9,9,33,68
1995-07-17 00:00:00.000,Washington DC; U.S.A. ATP World Tour,HARD,2,Patrick Rafter,Patrick McEnroe,Patrick Rafter,7-6(4); 6-0,Q,98,19,6,29,65,26,29,16,36,5,6,9,42,65,0,3,43,70,23,43,13,27,10,14,9,36,70
1995-07-17 00:00:00.000,Washington DC; U.S.A. ATP World Tour,HARD,2,Stefan Edberg,Cristiano Caratti,Stefan Edberg,6-4; 5-7; 7-6(1),Q,173,1,7,73,124,45,73,24,51,11,18,17,69,124,2,5,103,137,58,103,13,34,13,20,17,71,137
1995-07-17 00:00:00.000,Washington DC; U.S.A. ATP World Tour,HARD,2,Andre Agassi,Todd Martin,Andre Agassi,6-4; 7-6,S,0,0,0,0,0,0,0,0,0,0,0,0,0,0,0,0,0,0,0,0,0,0,0,0,0,0,0
1995-07-17 00:00:00.000,Washington DC; U.S.A. ATP World Tour,HARD,2,Stefan Edberg,Patrick Rafter,Stefan Edberg,7-5; 5-7; 6-2,S,132,3,5,64,101,48,64,20,37,6,8,16,68,101,3,8,70,110,49,70,17,40,10,14,16,66,110
1995-07-17 00:00:00.000,Washington DC; U.S.A. ATP World Tour,HARD,2,Andre Agassi,Stefan Edberg,Andre Agassi,6-4; 2-6; 7-5,F,125,4,7,54,99,36,54,22,45,7,11,15,58,99,6,4,65,101,44,65,15,36,6,10,15,59,101
1995-07-24 00:00:00.000,Amsterdam The Netherlands ATP World Tour,CLAY,2,Thomas Muster,Martin Sinner,Thomas Muster,6-2; 6-3,R32,72,6,2,27,48,22,27,10,21,0,1,8,32,48,2,4,43,64,21,43,8,21,5,10,9,29,64
1995-07-24 00:00:00.000,Amsterdam The Netherlands ATP World Tour,CLAY,2,Marcelo Filippini,Sjeng Schalken,Marcelo Filippini,6-3; 6-4,R32,97,0,1,69,87,44,69,9,18,7,8,10,53,87,6,1,37,55,26,37,6,18,4,7,9,32,55
1995-07-24 00:00:00.000,Amsterdam The Netherlands ATP World Tour,CLAY,2,Carlos Costa,Jaime Yzaga,Carlos Costa,6-3; 6-7(3); 7-5,R32,161,15,2,71,106,50,71,17,35,4,7,16,67,106,8,2,73,136,43,73,30,63,21,27,17,73,136
1995-07-24 00:00:00.000,Amsterdam The Netherlands ATP World Tour,CLAY,2,Fernando Meligeni,Francisco Clavet,Fernando Meligeni,3-6; 6-4; 6-3,R32,127,6,5,49,104,31,49,22,55,11,17,14,53,104,0,4,44,75,23,44,15,31,1,8,14,38,75
1995-07-24 00:00:00.000,Amsterdam The Netherlands ATP World Tour,CLAY,2,Bernd Karbacher,Jacco Eltingh,Bernd Karbacher,6-4; 6-4,R32,72,10,2,26,51,21,26,15,25,0,1,10,36,51,4,3,34,61,23,34,13,27,1,4,10,36,61
1995-07-24 00:00:00.000,Amsterdam The Netherlands ATP World Tour,CLAY,2,Slava Dosedel,Joost Winnink,Slava Dosedel,6-1; 6-2,R32,52,0,2,41,49,31,41,2,8,0,1,8,33,49,1,2,40,49,17,40,3,9,4,9,7,20,49
1995-07-24 00:00:00.000,Amsterdam The Netherlands ATP World Tour,CLAY,2,Marcelo Rios,Renzo Furlan,Marcelo Rios,6-3; 7-6(2),R32,75,4,1,36,59,34,36,12,23,0,1,11,46,59,7,2,40,63,25,40,15,23,1,3,10,40,63
1995-07-24 00:00:00.000,Amsterdam The Netherlands ATP World Tour,CLAY,2,Alex Corretja,Karol Kucera,Alex Corretja,6-1; 6-4,R32,85,1,0,36,57,21,36,12,21,4,6,8,33,57,3,10,31,71,19,31,12,40,6,12,9,31,71
1995-07-24 00:00:00.000,Amsterdam The Netherlands ATP World Tour,CLAY,2,Jan Siemerink,Paul Haarhuis,Jan Siemerink,6-3; 6-3,R32,68,3,2,33,61,27,33,13,28,4,5,9,40,61,0,5,30,57,16,30,11,27,3,7,9,27,57
1995-07-24 00:00:00.000,Amsterdam The Netherlands ATP World Tour,CLAY,2,Andrei Chesnokov,Albert Costa,Andrei Chesnokov,3-6; 6-2; 6-4,R32,107,7,1,52,83,33,52,20,31,6,9,13,53,83,3,1,72,91,41,72,10,19,4,9,14,51,91
1995-07-24 00:00:00.000,Amsterdam The Netherlands ATP World Tour,CLAY,2,Francisco Montana,Marc-Kevin Goellner,Francisco Montana,6-2; 5-7; 6-3,R32,100,5,5,62,98,42,62,21,36,6,7,14,63,98,13,3,44,80,34,44,19,36,1,5,15,53,80
1995-07-24 00:00:00.000,Amsterdam The Netherlands ATP World Tour,CLAY,2,Bohdan Ulihrach,Andrea Gaudenzi,Bohdan Ulihrach,6-2; 7-5,R32,77,3,1,40,61,26,40,12,21,4,6,10,38,61,0,5,33,61,17,33,13,28,2,7,10,30,61
1995-07-24 00:00:00.000,Amsterdam The Netherlands ATP World Tour,CLAY,2,Karel Novacek,Christian Ruud,Karel Novacek,6-3; 6-3,R32,66,5,1,19,47,15,19,15,28,0,2,9,30,47,2,1,28,52,17,28,8,24,2,7,9,25,52
1995-07-24 00:00:00.000,Amsterdam The Netherlands ATP World Tour,CLAY,2,Michael Geserer,Jerome Hanquez,Michael Geserer,6-3; 7-6(1),R32,96,2,3,46,61,36,46,8,15,4,5,10,44,61,1,2,36,86,25,36,24,50,11,14,11,49,86
1995-07-24 00:00:00.000,Amsterdam The Netherlands ATP World Tour,CLAY,2,Gilbert Schaller,Javier Sanchez,Gilbert Schaller,6-2; 6-2,R32,58,3,0,31,43,21,31,12,12,1,1,8,33,43,0,2,26,53,15,26,11,27,3,7,8,26,53
1995-07-24 00:00:00.000,Amsterdam The Netherlands ATP World Tour,CLAY,2,Alberto Berasategui,Emilio Sanchez,Alberto Berasategui,6-3; 6-4,R32,78,2,2,62,72,40,62,6,10,7,8,10,46,72,5,0,38,61,27,38,7,23,4,7,9,34,61
1995-07-24 00:00:00.000,Amsterdam The Netherlands ATP World Tour,CLAY,2,Marcelo Filippini,Thomas Muster,Marcelo Filippini,W/O,R16,0,0,0,0,0,0,0,0,0,0,0,0,0,0,0,0,0,0,0,0,0,0,0,0,0,0,0
1995-07-24 00:00:00.000,Amsterdam The Netherlands ATP World Tour,CLAY,2,Carlos Costa,Fernando Meligeni,Carlos Costa,4-6; 6-3; 6-0,R16,90,10,2,43,70,31,43,14,27,0,3,13,45,70,4,3,34,69,22,34,11,35,5,11,12,33,69
1995-07-24 00:00:00.000,Amsterdam The Netherlands ATP World Tour,CLAY,2,Bernd Karbacher,Slava Dosedel,Bernd Karbacher,6-3; 6-4,R16,77,7,6,33,65,28,33,15,32,3,4,10,43,65,0,1,45,59,26,45,7,14,5,8,9,33,59
1995-07-24 00:00:00.000,Amsterdam The Netherlands ATP World Tour,CLAY,2,Marcelo Rios,Alex Corretja,Marcelo Rios,7-6(3); 6-4,R16,102,3,1,45,78,29,45,21,33,3,5,11,50,78,8,1,49,74,29,49,12,25,6,9,11,41,74
1995-07-24 00:00:00.000,Amsterdam The Netherlands ATP World Tour,CLAY,2,Jan Siemerink,Andrei Chesnokov,Jan Siemerink,6-3; 6-4,R16,69,2,1,46,57,33,46,6,11,3,4,10,39,57,0,1,42,57,23,42,9,15,1,4,9,32,57
1995-07-24 00:00:00.000,Amsterdam The Netherlands ATP World Tour,CLAY,2,Bohdan Ulihrach,Francisco Montana,Bohdan Ulihrach,4-6; 6-1; 6-2,R16,95,6,3,42,76,32,42,19,34,2,3,12,51,76,1,2,37,79,22,37,22,42,6,11,13,44,79
1995-07-24 00:00:00.000,Amsterdam The Netherlands ATP World Tour,CLAY,2,Karel Novacek,Michael Geserer,Karel Novacek,6-4; 7-5,R16,79,4,0,36,55,32,36,13,19,1,1,11,45,55,8,1,54,78,35,54,12,24,6,8,11,47,78
1995-07-24 00:00:00.000,Amsterdam The Netherlands ATP World Tour,CLAY,2,Gilbert Schaller,Alberto Berasategui,Gilbert Schaller,6-7(5); 7-6(4); 6-3,R16,138,11,2,74,106,52,74,13,32,7,11,16,65,106,2,1,89,126,43,89,23,37,11,17,17,66,126
1995-07-24 00:00:00.000,Amsterdam The Netherlands ATP World Tour,CLAY,2,Carlos Costa,Marcelo Filippini,Carlos Costa,7-6(7); 6-2,Q,106,8,1,46,76,30,46,15,30,7,10,10,45,76,0,0,54,74,28,54,11,20,5,10,10,39,74
1995-07-24 00:00:00.000,Amsterdam The Netherlands ATP World Tour,CLAY,2,Marcelo Rios,Bernd Karbacher,Marcelo Rios,5-7; 7-6(2); 7-5,Q,144,2,3,61,116,42,61,29,55,8,13,17,71,116,10,6,55,112,34,55,31,57,2,7,17,65,112
1995-07-24 00:00:00.000,Amsterdam The Netherlands ATP World Tour,CLAY,2,Jan Siemerink,Bohdan Ulihrach,Jan Siemerink,6-3; 3-6; 6-3,Q,110,5,3,66,94,42,66,15,28,8,11,14,57,94,3,5,60,92,36,60,17,32,9,13,13,53,92
1995-07-24 00:00:00.000,Amsterdam The Netherlands ATP World Tour,CLAY,2,Gilbert Schaller,Karel Novacek,Gilbert Schaller,6-7(7); 6-4; 6-4,Q,143,1,0,77,101,52,77,13,24,5,8,16,65,101,12,0,65,110,44,65,24,45,11,16,16,68,110
1995-07-24 00:00:00.000,Amsterdam The Netherlands ATP World Tour,CLAY,2,Marcelo Rios,Carlos Costa,Marcelo Rios,7-6(1); 6-0,S,68,1,1,35,55,30,35,9,20,3,4,9,39,55,4,3,33,54,19,33,8,21,3,7,9,27,54
1995-07-24 00:00:00.000,Amsterdam The Netherlands ATP World Tour,CLAY,2,Jan Siemerink,Gilbert Schaller,Jan Siemerink,7-6(6); 6-7(4); 6-4,S,156,7,2,78,118,55,78,23,40,4,6,17,78,118,1,0,99,111,67,99,8,12,9,12,17,75,111
1995-07-24 00:00:00.000,Amsterdam The Netherlands ATP World Tour,CLAY,2,Marcelo Rios,Jan Siemerink,Marcelo Rios,6-4; 7-5; 6-4,F,119,2,2,70,96,54,70,16,26,3,3,16,70,96,7,3,58,99,41,58,21,41,1,4,16,62,99
1995-07-24 00:00:00.000,ATP Masters Series Canada Montreal; Canada ATP World Tour,HARD,2,Andre Agassi,N/A Bye,Andre Agassi,,R64,0,0,0,0,0,0,0,0,0,0,0,0,0,0,0,0,0,0,0,0,0,0,0,0,0,0,0
1995-07-24 00:00:00.000,ATP Masters Series Canada Montreal; Canada ATP World Tour,HARD,2,Jeff Tarango,Paul Wekesa,Jeff Tarango,6-1; 7-6(2),R64,62,10,2,38,56,33,38,11,18,0,0,10,44,56,8,2,43,59,30,43,5,16,1,3,9,35,59
1995-07-24 00:00:00.000,ATP Masters Series Canada Montreal; Canada ATP World Tour,HARD,2,Daniel Vacek,Andrew Sznajder,Daniel Vacek,6-7(4); 6-2; 6-4,R64,105,20,3,46,78,42,46,19,32,2,3,15,61,78,8,7,55,97,39,55,19,42,9,13,15,58,97
1995-07-24 00:00:00.000,ATP Masters Series Canada Montreal; Canada ATP World Tour,HARD,2,Arnaud Boetsch,Alexander Volkov,Arnaud Boetsch,6-1; 6-1,R64,52,3,2,23,49,19,23,14,26,2,2,7,33,49,1,3,25,44,16,25,4,19,5,10,7,20,44
1995-07-24 00:00:00.000,ATP Masters Series Canada Montreal; Canada ATP World Tour,HARD,2,Sergi Bruguera,Cristiano Caratti,Sergi Bruguera,6-1; 6-7(2); 6-4,R64,106,8,1,51,86,40,51,17,35,1,3,15,57,86,0,4,70,98,44,70,9,28,5,10,14,53,98
1995-07-24 00:00:00.000,ATP Masters Series Canada Montreal; Canada ATP World Tour,HARD,2,Aaron Krickstein,Jim Grabb,Aaron Krickstein,6-4; 6-4,R64,75,0,1,36,57,28,36,16,21,2,2,10,44,57,7,3,32,58,24,32,13,26,1,3,10,37,58
1995-07-24 00:00:00.000,ATP Masters Series Canada Montreal; Canada ATP World Tour,HARD,2,MaliVai Washington,Gianluca Pozzi,MaliVai Washington,6-2; 6-4,R64,72,2,0,38,57,27,38,10,19,2,3,9,37,57,2,0,19,50,14,19,15,31,4,8,9,29,50
1995-07-24 00:00:00.000,ATP Masters Series Canada Montreal; Canada ATP World Tour,HARD,2,Marc Rosset,N/A Bye,Marc Rosset,,R64,0,0,0,0,0,0,0,0,0,0,0,0,0,0,0,0,0,0,0,0,0,0,0,0,0,0,0
1995-07-24 00:00:00.000,ATP Masters Series Canada Montreal; Canada ATP World Tour,HARD,2,Yevgeny Kafelnikov,N/A Bye,Yevgeny Kafelnikov,,R64,0,0,0,0,0,0,0,0,0,0,0,0,0,0,0,0,0,0,0,0,0,0,0,0,0,0,0
1995-07-24 00:00:00.000,ATP Masters Series Canada Montreal; Canada ATP World Tour,HARD,2,Mark Philippoussis,Steve Herdoiza,Mark Philippoussis,6-3; 6-2,R64,65,10,2,32,46,27,32,9,14,0,0,9,36,46,4,3,31,63,19,31,16,32,4,7,8,35,63
1995-07-24 00:00:00.000,ATP Masters Series Canada Montreal; Canada ATP World Tour,HARD,2,Richard Krajicek,Jeremy Bates,Richard Krajicek,7-5; 6-2,R64,71,8,1,37,62,30,37,12,25,2,3,10,42,62,2,4,28,60,18,28,15,32,4,8,10,33,60
1995-07-24 00:00:00.000,ATP Masters Series Canada Montreal; Canada ATP World Tour,HARD,2,Brett Steven,David Wheaton,Brett Steven,6-4; 3-6; 6-3,R64,114,3,0,60,86,45,60,13,26,4,6,14,58,86,9,3,50,80,36,50,16,30,0,3,14,52,80
1995-07-24 00:00:00.000,ATP Masters Series Canada Montreal; Canada ATP World Tour,HARD,2,Stefan Edberg,Albert Chang,Stefan Edberg,2-6; 6-1; 6-1,R64,97,1,0,59,78,40,59,8,19,3,5,11,48,78,1,3,33,66,19,33,17,33,0,5,11,36,66
1995-07-24 00:00:00.000,ATP Masters Series Canada Montreal; Canada ATP World Tour,HARD,2,Mats Wilander,Mashiska Washington,Mats Wilander,6-0; 6-2,R64,68,1,3,18,44,12,18,16,26,0,1,7,28,44,0,3,19,38,6,19,6,19,5,11,7,12,38
1995-07-24 00:00:00.000,ATP Masters Series Canada Montreal; Canada ATP World Tour,HARD,2,Scott Draper,Andrei Olhovskiy,Scott Draper,6-7(4); 7-5; 7-6(3),R64,143,17,4,82,149,59,82,35,67,12,14,18,94,149,12,9,76,117,60,76,14,41,6,9,18,74,117
1995-07-24 00:00:00.000,ATP Masters Series Canada Montreal; Canada ATP World Tour,HARD,2,Wayne Ferreira,N/A Bye,Wayne Ferreira,,R64,0,0,0,0,0,0,0,0,0,0,0,0,0,0,0,0,0,0,0,0,0,0,0,0,0,0,0
1995-07-24 00:00:00.000,ATP Masters Series Canada Montreal; Canada ATP World Tour,HARD,2,Goran Ivanisevic,N/A Bye,Goran Ivanisevic,,R64,0,0,0,0,0,0,0,0,0,0,0,0,0,0,0,0,0,0,0,0,0,0,0,0,0,0,0
1995-07-24 00:00:00.000,ATP Masters Series Canada Montreal; Canada ATP World Tour,HARD,2,Michael Joyce,Greg Rusedski,Michael Joyce,7-6(2); 6-3,R64,88,1,3,45,70,33,45,15,25,3,4,10,48,70,14,3,41,80,32,41,16,39,8,11,11,48,80
1995-07-24 00:00:00.000,ATP Masters Series Canada Montreal; Canada ATP World Tour,HARD,2,Jamie Morgan,Martin Damm,Jamie Morgan,4-6; 6-3; 6-3,R64,124,16,3,70,112,53,70,18,42,7,8,14,71,112,6,3,47,83,34,47,17,36,4,7,14,51,83
1995-07-24 00:00:00.000,ATP Masters Series Canada Montreal; Canada ATP World Tour,HARD,2,Thomas Enqvist,Adrian Voinea,Thomas Enqvist,6-0; 6-2,R64,53,3,3,30,48,23,30,10,18,3,3,7,33,48,2,1,29,49,15,29,6,20,4,9,7,21,49
1995-07-24 00:00:00.000,ATP Masters Series Canada Montreal; Canada ATP World Tour,HARD,2,Todd Martin,Olivier Delaitre,Todd Martin,6-4; 6-4,R64,76,11,1,35,60,26,35,18,25,1,1,10,44,60,4,2,34,60,30,34,7,26,4,6,10,37,60
1995-07-24 00:00:00.000,ATP Masters Series Canada Montreal; Canada ATP World Tour,HARD,2,Byron Black,Jordi Burillo,Byron Black,7-5; 6-1,R64,62,4,1,44,62,33,44,9,18,1,2,10,42,62,8,3,26,57,20,26,10,31,5,9,9,30,57
1995-07-24 00:00:00.000,ATP Masters Series Canada Montreal; Canada ATP World Tour,HARD,2,Petr Korda,Patrick McEnroe,Petr Korda,6-3; 7-6(7),R64,103,9,1,58,87,43,58,12,29,5,6,11,55,87,0,2,57,80,36,57,11,23,5,7,10,47,80
1995-07-24 00:00:00.000,ATP Masters Series Canada Montreal; Canada ATP World Tour,HARD,2,Michael Chang,N/A Bye,Michael Chang,,R64,0,0,0,0,0,0,0,0,0,0,0,0,0,0,0,0,0,0,0,0,0,0,0,0,0,0,0
1995-07-24 00:00:00.000,ATP Masters Series Canada Montreal; Canada ATP World Tour,HARD,2,Michael Stich,N/A Bye,Michael Stich,,R64,0,0,0,0,0,0,0,0,0,0,0,0,0,0,0,0,0,0,0,0,0,0,0,0,0,0,0
1995-07-24 00:00:00.000,ATP Masters Series Canada Montreal; Canada ATP World Tour,HARD,2,Patrick Rafter,Michael Tebbutt,Patrick Rafter,6-3; 6-4,R64,72,4,0,30,55,24,30,19,25,2,2,10,43,55,8,9,26,56,22,26,13,30,1,3,9,35,56
1995-07-24 00:00:00.000,ATP Masters Series Canada Montreal; Canada ATP World Tour,HARD,2,Sebastien Lareau,Grant Connell,Sebastien Lareau,6-4; 6-3,R64,84,3,5,36,66,23,36,17,30,4,6,9,40,66,4,3,40,70,24,40,11,30,10,15,10,35,70
1995-07-24 00:00:00.000,ATP Masters Series Canada Montreal; Canada ATP World Tour,HARD,2,Jim Courier,Daniel Nestor,Jim Courier,7-6(1); 6-4,R64,102,8,2,45,69,31,45,14,24,2,4,11,45,69,1,6,45,82,31,45,17,37,7,10,11,48,82
1995-07-24 00:00:00.000,ATP Masters Series Canada Montreal; Canada ATP World Tour,HARD,2,Jason Stoltenberg,Lionel Roux,Jason Stoltenberg,6-4; 6-4,R64,94,2,3,35,64,26,35,15,29,4,6,10,41,64,0,2,40,74,23,40,15,34,8,12,10,38,74
1995-07-24 00:00:00.000,ATP Masters Series Canada Montreal; Canada ATP World Tour,HARD,2,Mauricio Hadad,Richey Reneberg,Mauricio Hadad,7-5; 6-3,R64,81,1,1,47,65,31,47,9,18,4,6,10,40,65,2,0,33,69,21,33,17,36,5,10,11,38,69
1995-07-24 00:00:00.000,ATP Masters Series Canada Montreal; Canada ATP World Tour,HARD,2,Jonathan Stark,Jakob Hlasek,Jonathan Stark,7-6(4); 3-6; 6-3,R64,123,12,7,49,94,41,49,19,45,2,5,15,60,94,11,2,65,100,47,65,14,35,7,10,15,61,100
1995-07-24 00:00:00.000,ATP Masters Series Canada Montreal; Canada ATP World Tour,HARD,2,Pete Sampras,N/A Bye,Pete Sampras,,R64,0,0,0,0,0,0,0,0,0,0,0,0,0,0,0,0,0,0,0,0,0,0,0,0,0,0,0
1995-07-24 00:00:00.000,ATP Masters Series Canada Montreal; Canada ATP World Tour,HARD,2,Andre Agassi,Jeff Tarango,Andre Agassi,6-3; 6-4,R32,77,9,5,34,60,26,34,13,26,2,4,10,39,60,3,5,34,62,23,34,9,28,5,9,9,32,62
1995-07-24 00:00:00.000,ATP Masters Series Canada Montreal; Canada ATP World Tour,HARD,2,Daniel Vacek,Arnaud Boetsch,Daniel Vacek,6-2; 6-4,R32,58,6,1,29,44,25,29,11,15,0,0,9,36,44,1,5,26,58,17,26,15,32,6,9,9,32,58
1995-07-24 00:00:00.000,ATP Masters Series Canada Montreal; Canada ATP World Tour,HARD,2,Sergi Bruguera,Aaron Krickstein,Sergi Bruguera,6-2; 7-6(4),R32,74,7,3,43,68,33,43,14,25,4,5,10,47,68,4,2,42,68,28,42,12,26,4,7,10,40,68
1995-07-24 00:00:00.000,ATP Masters Series Canada Montreal; Canada ATP World Tour,HARD,2,MaliVai Washington,Marc Rosset,MaliVai Washington,6-3; 7-6(4),R32,94,5,2,44,73,34,44,18,29,4,5,11,52,73,9,4,47,73,31,47,13,26,3,5,10,44,73
1995-07-24 00:00:00.000,ATP Masters Series Canada Montreal; Canada ATP World Tour,HARD,2,Yevgeny Kafelnikov,Mark Philippoussis,Yevgeny Kafelnikov,6-4; 6-7(6); 7-6(8),R32,141,8,3,64,117,53,64,30,53,5,6,17,83,117,16,9,68,118,52,68,28,50,9,11,17,80,118
1995-07-24 00:00:00.000,ATP Masters Series Canada Montreal; Canada ATP World Tour,HARD,2,Brett Steven,Richard Krajicek,Brett Steven,7-5(7); 3-1 RET,R32,66,3,0,42,53,31,42,7,11,2,3,8,38,53,8,2,34,60,25,34,13,26,6,8,9,38,60
1995-07-24 00:00:00.000,ATP Masters Series Canada Montreal; Canada ATP World Tour,HARD,2,Mats Wilander,Stefan Edberg,Mats Wilander,3-6; 6-3; 6-4,R32,128,7,3,63,97,47,63,16,34,9,11,14,63,97,1,4,75,109,50,75,15,34,10,13,14,65,109
1995-07-24 00:00:00.000,ATP Masters Series Canada Montreal; Canada ATP World Tour,HARD,2,Wayne Ferreira,Scott Draper,Wayne Ferreira,7-5; 6-1,R32,56,8,1,31,45,25,31,11,14,0,0,9,36,45,4,4,32,64,22,32,13,32,7,11,10,35,64
1995-07-24 00:00:00.000,ATP Masters Series Canada Montreal; Canada ATP World Tour,HARD,2,Goran Ivanisevic,Michael Joyce,Goran Ivanisevic,6-4; 3-6; 6-3,R32,79,21,1,36,71,30,36,22,35,4,6,14,52,71,5,5,54,84,38,54,16,30,4,7,14,54,84
1995-07-24 00:00:00.000,ATP Masters Series Canada Montreal; Canada ATP World Tour,HARD,2,Thomas Enqvist,Jamie Morgan,Thomas Enqvist,6-4; 6-4,R32,73,5,2,34,57,27,34,13,23,5,6,10,40,57,7,2,40,63,28,40,11,23,2,5,10,39,63
1995-07-24 00:00:00.000,ATP Masters Series Canada Montreal; Canada ATP World Tour,HARD,2,Todd Martin,Byron Black,Todd Martin,6-3; 6-1,R32,55,9,1,34,50,25,34,9,16,2,3,8,34,50,0,2,26,44,12,26,8,18,0,5,8,20,44
1995-07-24 00:00:00.000,ATP Masters Series Canada Montreal; Canada ATP World Tour,HARD,2,Michael Chang,Petr Korda,Michael Chang,7-5; 6-1,R32,83,4,5,27,59,21,27,20,32,1,2,10,41,59,3,6,37,66,24,37,9,29,7,11,9,33,66
1995-07-24 00:00:00.000,ATP Masters Series Canada Montreal; Canada ATP World Tour,HARD,2,Michael Stich,Patrick Rafter,Michael Stich,7-6(5); 7-5,R32,115,9,3,56,100,41,56,22,44,10,11,12,63,100,1,2,48,80,34,48,17,32,1,3,12,51,80
1995-07-24 00:00:00.000,ATP Masters Series Canada Montreal; Canada ATP World Tour,HARD,2,Jim Courier,Sebastien Lareau,Jim Courier,6-4; 6-3,R32,84,8,3,38,65,30,38,15,27,1,1,10,45,65,5,3,30,56,23,30,13,26,3,5,9,36,56
1995-07-24 00:00:00.000,ATP Masters Series Canada Montreal; Canada ATP World Tour,HARD,2,Mauricio Hadad,Jason Stoltenberg,Mauricio Hadad,4-6; 7-6(4); 7-5,R32,142,1,1,89,131,55,89,21,42,11,17,17,76,131,2,2,73,114,45,73,22,41,8,14,17,67,114
1995-07-24 00:00:00.000,ATP Masters Series Canada Montreal; Canada ATP World Tour,HARD,2,Pete Sampras,Jonathan Stark,Pete Sampras,6-3; 4-6; 6-4,R32,138,12,11,47,114,35,47,33,67,9,12,15,68,114,16,7,57,95,43,57,15,38,6,10,14,58,95
1995-07-24 00:00:00.000,ATP Masters Series Canada Montreal; Canada ATP World Tour,HARD,2,Andre Agassi,Daniel Vacek,Andre Agassi,6-4; 6-2,R16,61,3,1,40,52,30,40,8,12,2,2,9,38,52,7,3,35,58,25,35,9,23,6,9,9,34,58
1995-07-24 00:00:00.000,ATP Masters Series Canada Montreal; Canada ATP World Tour,HARD,2,MaliVai Washington,Sergi Bruguera,MaliVai Washington,6-4; 6-2,R16,61,1,1,36,48,23,36,7,12,2,4,9,30,48,1,1,33,57,19,33,8,24,2,7,9,27,57
1995-07-24 00:00:00.000,ATP Masters Series Canada Montreal; Canada ATP World Tour,HARD,2,Yevgeny Kafelnikov,Brett Steven,Yevgeny Kafelnikov,6-4; 1-6; 6-4,R16,108,5,2,61,99,40,61,17,38,6,10,14,57,99,9,1,56,75,39,56,12,19,0,3,13,51,75
1995-07-24 00:00:00.000,ATP Masters Series Canada Montreal; Canada ATP World Tour,HARD,2,Mats Wilander,Wayne Ferreira,Mats Wilander,6-3; 6-2,R16,64,3,0,33,48,27,33,8,15,3,3,8,35,48,6,2,35,61,22,35,9,26,1,5,9,31,61
1995-07-24 00:00:00.000,ATP Masters Series Canada Montreal; Canada ATP World Tour,HARD,2,Thomas Enqvist,Goran Ivanisevic,Thomas Enqvist,6-7(2); 7-6(3); 7-5,R16,141,12,6,59,128,47,59,34,69,6,9,18,81,128,30,8,61,121,51,61,27,60,12,16,18,78,121
1995-07-24 00:00:00.000,ATP Masters Series Canada Montreal; Canada ATP World Tour,HARD,2,Michael Chang,Todd Martin,Michael Chang,6-3; 6-2,R16,81,4,0,31,66,23,31,21,35,8,8,9,44,66,5,4,36,60,26,36,6,24,5,8,8,32,60
1995-07-24 00:00:00.000,ATP Masters Series Canada Montreal; Canada ATP World Tour,HARD,2,Michael Stich,Jim Courier,Michael Stich,6-3; 6-2,R16,62,5,1,27,47,25,27,12,20,0,0,9,37,47,3,2,26,46,21,26,6,20,6,9,8,27,46
1995-07-24 00:00:00.000,ATP Masters Series Canada Montreal; Canada ATP World Tour,HARD,2,Pete Sampras,Mauricio Hadad,Pete Sampras,6-2; 6-3,R16,74,8,5,25,63,21,25,20,38,3,4,9,41,63,1,0,39,58,18,39,11,19,5,9,8,29,58
1995-07-24 00:00:00.000,ATP Masters Series Canada Montreal; Canada ATP World Tour,HARD,2,Andre Agassi,MaliVai Washington,Andre Agassi,7-6(5); 6-3,Q,100,0,2,56,86,35,56,18,30,7,8,10,53,86,7,2,35,69,28,35,16,34,4,7,11,44,69
1995-07-24 00:00:00.000,ATP Masters Series Canada Montreal; Canada ATP World Tour,HARD,2,Mats Wilander,Yevgeny Kafelnikov,Mats Wilander,7-5; 7-6(4),Q,114,6,2,61,87,38,61,13,26,3,6,12,51,87,4,1,59,91,36,59,15,32,8,12,12,51,91
1995-07-24 00:00:00.000,ATP Masters Series Canada Montreal; Canada ATP World Tour,HARD,2,Thomas Enqvist,Michael Chang,Thomas Enqvist,6-3; 6-4,Q,102,3,2,40,67,31,40,13,27,6,7,10,44,67,7,3,42,83,28,42,17,41,5,8,9,45,83
1995-07-24 00:00:00.000,ATP Masters Series Canada Montreal; Canada ATP World Tour,HARD,2,Pete Sampras,Michael Stich,Pete Sampras,7-6(3); 6-2,Q,82,4,0,31,60,23,31,15,29,0,3,10,38,60,5,6,40,75,25,40,13,35,4,9,10,38,75
1995-07-24 00:00:00.000,ATP Masters Series Canada Montreal; Canada ATP World Tour,HARD,2,Andre Agassi,Mats Wilander,Andre Agassi,6-2; 6-0,S,56,1,1,27,43,22,27,9,16,1,1,7,31,43,0,1,25,41,13,25,3,16,1,6,7,16,41
1995-07-24 00:00:00.000,ATP Masters Series Canada Montreal; Canada ATP World Tour,HARD,2,Pete Sampras,Thomas Enqvist,Pete Sampras,3-6; 6-3; 7-6(3),S,121,22,4,61,104,50,61,20,43,6,7,15,70,104,12,5,56,93,44,56,20,37,2,3,15,64,93
1995-07-24 00:00:00.000,ATP Masters Series Canada Montreal; Canada ATP World Tour,HARD,2,Andre Agassi,Pete Sampras,Andre Agassi,3-6; 6-2; 6-3,F,113,6,0,64,84,42,64,13,20,6,7,13,55,84,12,3,40,84,30,40,22,44,9,12,13,52,84
1995-07-31 00:00:00.000,Kitzbuhel Austria ATP World Tour,CLAY,2,Thomas Muster,N/A Bye,Thomas Muster,,R64,0,0,0,0,0,0,0,0,0,0,0,0,0,0,0,0,0,0,0,0,0,0,0,0,0,0,0
1995-07-31 00:00:00.000,Kitzbuhel Austria ATP World Tour,CLAY,2,Steve Campbell,Thomas Buchmayer,Steve Campbell,2-6; 7-6(1); 6-4,R64,106,6,3,49,89,37,49,19,40,2,6,15,56,89,5,7,51,87,38,51,17,36,5,8,15,55,87
1995-07-31 00:00:00.000,Kitzbuhel Austria ATP World Tour,CLAY,2,Vaclav Roubicek,Alex Antonitsch,Vaclav Roubicek,6-3; 6-2,R64,59,5,0,29,43,24,29,13,14,2,2,9,37,43,5,7,31,51,22,31,8,20,2,5,8,30,51
1995-07-31 00:00:00.000,Kitzbuhel Austria ATP World Tour,CLAY,2,Frederik Fetterlein,N/A Bye,Frederik Fetterlein,,R64,0,0,0,0,0,0,0,0,0,0,0,0,0,0,0,0,0,0,0,0,0,0,0,0,0,0,0
1995-07-31 00:00:00.000,Kitzbuhel Austria ATP World Tour,CLAY,2,Renzo Furlan,N/A Bye,Renzo Furlan,,R64,0,0,0,0,0,0,0,0,0,0,0,0,0,0,0,0,0,0,0,0,0,0,0,0,0,0,0
1995-07-31 00:00:00.000,Kitzbuhel Austria ATP World Tour,CLAY,2,Carlos Moya,Dinu Pescariu,Carlos Moya,6-4; 4-6; 6-3,R64,99,4,2,64,93,41,64,16,29,5,9,15,57,93,4,2,43,79,29,43,18,36,3,8,14,47,79
1995-07-31 00:00:00.000,Kitzbuhel Austria ATP World Tour,CLAY,2,Sandor Noszaly,Daniele Balducci,Sandor Noszaly,6-3; 7-6(6),R64,106,5,4,49,65,39,49,10,16,0,0,11,49,65,0,0,66,81,40,66,10,15,6,7,10,50,81
1995-07-31 00:00:00.000,Kitzbuhel Austria ATP World Tour,CLAY,2,Francisco Clavet,N/A Bye,Francisco Clavet,,R64,0,0,0,0,0,0,0,0,0,0,0,0,0,0,0,0,0,0,0,0,0,0,0,0,0,0,0
1995-07-31 00:00:00.000,Kitzbuhel Austria ATP World Tour,CLAY,2,Alberto Berasategui,N/A Bye,Alberto Berasategui,,R64,0,0,0,0,0,0,0,0,0,0,0,0,0,0,0,0,0,0,0,0,0,0,0,0,0,0,0
1995-07-31 00:00:00.000,Kitzbuhel Austria ATP World Tour,CLAY,2,Gerard Solves,Juan Albert Viloca-Puig,Gerard Solves,6-4; 6-1,R64,60,3,3,36,48,27,36,6,12,4,5,8,33,48,1,4,38,60,20,38,9,22,5,10,9,29,60
1995-07-31 00:00:00.000,Kitzbuhel Austria ATP World Tour,CLAY,2,Thierry Guardiola,Emanuel Couto,Thierry Guardiola,6-3; 6-4,R64,92,1,1,39,75,26,39,20,36,4,5,10,46,75,2,0,46,60,26,46,7,14,3,6,9,33,60
1995-07-31 00:00:00.000,Kitzbuhel Austria ATP World Tour,CLAY,2,Marcelo Filippini,N/A Bye,Marcelo Filippini,,R64,0,0,0,0,0,0,0,0,0,0,0,0,0,0,0,0,0,0,0,0,0,0,0,0,0,0,0
1995-07-31 00:00:00.000,Kitzbuhel Austria ATP World Tour,CLAY,2,Jordi Arrese,N/A Bye,Jordi Arrese,,R64,0,0,0,0,0,0,0,0,0,0,0,0,0,0,0,0,0,0,0,0,0,0,0,0,0,0,0
1995-07-31 00:00:00.000,Kitzbuhel Austria ATP World Tour,CLAY,2,Emilio Benfele Alvarez,Clemens Trimmel,Emilio Benfele Alvarez,7-5; 6-4,R64,79,6,5,31,55,27,31,14,24,0,1,11,41,55,4,5,44,80,25,44,22,36,4,7,11,47,80
1995-07-31 00:00:00.000,Kitzbuhel Austria ATP World Tour,CLAY,2,Daniele Musa,Herbert Wiltschnig,Daniele Musa,6-7(8); 6-1; 6-4,R64,142,4,1,49,103,39,49,31,54,6,7,15,70,103,2,2,49,95,37,49,23,46,3,7,14,60,95
1995-07-31 00:00:00.000,Kitzbuhel Austria ATP World Tour,CLAY,2,Gilbert Schaller,N/A Bye,Gilbert Schaller,,R64,0,0,0,0,0,0,0,0,0,0,0,0,0,0,0,0,0,0,0,0,0,0,0,0,0,0,0
1995-07-31 00:00:00.000,Kitzbuhel Austria ATP World Tour,CLAY,2,Albert Costa,N/A Bye,Albert Costa,,R64,0,0,0,0,0,0,0,0,0,0,0,0,0,0,0,0,0,0,0,0,0,0,0,0,0,0,0
1995-07-31 00:00:00.000,Kitzbuhel Austria ATP World Tour,CLAY,2,David Nainkin,Nicklas Utgren,David Nainkin,4-6; 7-6(6); 6-4,R64,150,4,8,55,115,42,55,35,60,5,7,16,77,115,16,7,58,110,45,58,28,52,10,12,16,73,110
1995-07-31 00:00:00.000,Kitzbuhel Austria ATP World Tour,CLAY,2,Marcelo Charpentier,Alejo Mancisidor,Marcelo Charpentier,7-6(5); 4-6; 6-3,R64,169,1,12,69,125,47,69,24,56,9,14,16,71,125,3,9,50,119,37,50,31,69,12,17,15,68,119
1995-07-31 00:00:00.000,Kitzbuhel Austria ATP World Tour,CLAY,2,Adrian Voinea,N/A Bye,Adrian Voinea,,R64,0,0,0,0,0,0,0,0,0,0,0,0,0,0,0,0,0,0,0,0,0,0,0,0,0,0,0
1995-07-31 00:00:00.000,Kitzbuhel Austria ATP World Tour,CLAY,2,Tomas Carbonell,N/A Bye,Tomas Carbonell,,R64,0,0,0,0,0,0,0,0,0,0,0,0,0,0,0,0,0,0,0,0,0,0,0,0,0,0,0
1995-07-31 00:00:00.000,Kitzbuhel Austria ATP World Tour,CLAY,2,Andrew Ilie,Eyal Ran,Andrew Ilie,6-4; 7-6(5),R64,99,2,5,33,80,22,33,26,47,6,9,11,48,80,6,4,42,75,28,42,16,33,6,10,11,44,75
1995-07-31 00:00:00.000,Kitzbuhel Austria ATP World Tour,CLAY,2,Patrick Baur,Diego Nargiso,Patrick Baur,7-6(0); 6-4,R64,94,2,3,39,70,28,39,20,31,5,7,11,48,70,2,6,44,87,25,44,22,43,7,10,11,47,87
1995-07-31 00:00:00.000,Kitzbuhel Austria ATP World Tour,CLAY,2,Andrea Gaudenzi,N/A Bye,Andrea Gaudenzi,,R64,0,0,0,0,0,0,0,0,0,0,0,0,0,0,0,0,0,0,0,0,0,0,0,0,0,0,0
1995-07-31 00:00:00.000,Kitzbuhel Austria ATP World Tour,CLAY,2,Bernd Karbacher,N/A Bye,Bernd Karbacher,,R64,0,0,0,0,0,0,0,0,0,0,0,0,0,0,0,0,0,0,0,0,0,0,0,0,0,0,0
1995-07-31 00:00:00.000,Kitzbuhel Austria ATP World Tour,CLAY,2,Alex Lopez Moron,Dimitri Poliakov,Alex Lopez Moron,7-6(5); 7-5,R64,82,0,6,55,79,35,55,12,24,3,6,12,47,79,5,6,34,80,23,34,22,46,1,5,12,45,80
1995-07-31 00:00:00.000,Kitzbuhel Austria ATP World Tour,CLAY,2,Andrei Pavel,Hicham Arazi,Andrei Pavel,7-5; 3-6; 6-3,R64,107,4,2,50,83,41,50,15,33,4,6,15,56,83,3,1,46,95,34,46,28,49,4,7,15,62,95
1995-07-31 00:00:00.000,Kitzbuhel Austria ATP World Tour,CLAY,2,Fernando Meligeni,N/A Bye,Fernando Meligeni,,R64,0,0,0,0,0,0,0,0,0,0,0,0,0,0,0,0,0,0,0,0,0,0,0,0,0,0,0
1995-07-31 00:00:00.000,Kitzbuhel Austria ATP World Tour,CLAY,2,Emilio Sanchez,N/A Bye,Emilio Sanchez,,R64,0,0,0,0,0,0,0,0,0,0,0,0,0,0,0,0,0,0,0,0,0,0,0,0,0,0,0
1995-07-31 00:00:00.000,Kitzbuhel Austria ATP World Tour,CLAY,2,Stefano Pescosolido,Davide Sanguinetti,Stefano Pescosolido,6-3; 6-2,R64,76,3,3,30,66,24,30,21,36,2,2,9,45,66,4,1,30,52,22,30,8,22,6,9,8,30,52
1995-07-31 00:00:00.000,Kitzbuhel Austria ATP World Tour,CLAY,2,Jose Imaz-Ruiz,Christian Miniussi,Jose Imaz-Ruiz,6-3; 2-6; 6-3,R64,97,1,1,62,80,44,62,8,18,6,9,13,52,80,9,6,37,82,27,37,22,45,6,10,13,49,82
1995-07-31 00:00:00.000,Kitzbuhel Austria ATP World Tour,CLAY,2,Sergi Bruguera,N/A Bye,Sergi Bruguera,,R64,0,0,0,0,0,0,0,0,0,0,0,0,0,0,0,0,0,0,0,0,0,0,0,0,0,0,0
1995-07-31 00:00:00.000,Kitzbuhel Austria ATP World Tour,CLAY,2,Thomas Muster,Steve Campbell,Thomas Muster,6-3; 6-3,R32,71,5,1,23,56,20,23,17,33,3,4,9,37,56,0,3,28,60,18,28,14,32,3,7,9,32,60
1995-07-31 00:00:00.000,Kitzbuhel Austria ATP World Tour,CLAY,2,Frederik Fetterlein,Vaclav Roubicek,Frederik Fetterlein,2-6; 6-1; 6-3,R32,99,2,4,54,70,34,54,8,16,3,7,12,42,70,2,4,41,68,20,41,14,27,3,9,12,34,68
1995-07-31 00:00:00.000,Kitzbuhel Austria ATP World Tour,CLAY,2,Carlos Moya,Renzo Furlan,Carlos Moya,6-4; 7-6(5),R32,98,1,0,56,72,38,56,11,16,3,5,11,49,72,1,2,52,94,42,52,14,42,10,13,11,56,94
1995-07-31 00:00:00.000,Kitzbuhel Austria ATP World Tour,CLAY,2,Sandor Noszaly,Francisco Clavet,Sandor Noszaly,6-3; 2-6; 6-3,R32,136,4,5,60,85,40,60,12,25,5,8,13,52,85,0,2,54,88,37,54,12,34,4,8,13,49,88
1995-07-31 00:00:00.000,Kitzbuhel Austria ATP World Tour,CLAY,2,Alberto Berasategui,Gerard Solves,Alberto Berasategui,6-3; 5-7; 6-3,R32,87,2,1,67,81,45,67,10,14,3,6,15,55,81,1,2,61,82,42,61,9,21,0,5,15,51,82
1995-07-31 00:00:00.000,Kitzbuhel Austria ATP World Tour,CLAY,2,Marcelo Filippini,Thierry Guardiola,Marcelo Filippini,6-3; 6-4,R32,80,0,2,40,63,25,40,13,23,6,8,10,38,63,0,4,19,56,14,19,15,37,5,9,9,29,56
1995-07-31 00:00:00.000,Kitzbuhel Austria ATP World Tour,CLAY,2,Jordi Arrese,Emilio Benfele Alvarez,Jordi Arrese,6-4; 6-4,R32,77,1,1,49,62,36,49,8,13,2,2,10,44,62,6,3,31,50,24,31,10,19,0,2,10,34,50
1995-07-31 00:00:00.000,Kitzbuhel Austria ATP World Tour,CLAY,2,Gilbert Schaller,Daniele Musa,Gilbert Schaller,6-4; 3-6; 6-4,R32,127,1,3,62,91,44,62,12,29,3,6,14,56,91,7,2,41,92,28,41,26,51,6,10,15,54,92
1995-07-31 00:00:00.000,Kitzbuhel Austria ATP World Tour,CLAY,2,Albert Costa,David Nainkin,Albert Costa,6-3; 6-4,R32,78,8,1,33,52,25,33,13,19,0,1,10,38,52,4,4,44,74,25,44,15,30,11,14,9,40,74
1995-07-31 00:00:00.000,Kitzbuhel Austria ATP World Tour,CLAY,2,Adrian Voinea,Marcelo Charpentier,Adrian Voinea,6-3; 7-6(4),R32,87,7,7,39,74,25,39,22,35,2,4,11,47,74,0,3,35,58,24,35,11,23,2,5,10,35,58
1995-07-31 00:00:00.000,Kitzbuhel Austria ATP World Tour,CLAY,2,Andrew Ilie,Tomas Carbonell,Andrew Ilie,6-3; 6-2,R32,70,0,2,26,50,20,26,18,24,1,1,9,38,50,4,3,33,67,22,33,15,34,11,14,8,37,67
1995-07-31 00:00:00.000,Kitzbuhel Austria ATP World Tour,CLAY,2,Andrea Gaudenzi,Patrick Baur,Andrea Gaudenzi,6-2; 6-4,R32,52,1,3,25,48,21,25,16,23,0,0,9,37,48,4,3,31,48,22,31,7,17,1,4,9,29,48
1995-07-31 00:00:00.000,Kitzbuhel Austria ATP World Tour,CLAY,2,Bernd Karbacher,Alex Lopez Moron,Bernd Karbacher,7-6(2); 5-7; 7-5,R32,169,12,4,49,104,38,49,26,55,5,11,18,64,104,3,12,82,137,52,82,24,55,16,22,18,76,137
1995-07-31 00:00:00.000,Kitzbuhel Austria ATP World Tour,CLAY,2,Fernando Meligeni,Andrei Pavel,Fernando Meligeni,7-5; 2-0 RET,R32,58,1,1,20,40,14,20,13,20,0,1,8,27,40,1,2,28,44,15,28,9,16,4,7,7,24,44
1995-07-31 00:00:00.000,Kitzbuhel Austria ATP World Tour,CLAY,2,Stefano Pescosolido,Emilio Sanchez,Stefano Pescosolido,6-4; 6-4,R32,80,1,2,34,59,22,34,16,25,3,5,10,38,59,0,1,34,57,23,34,11,23,2,6,10,34,57
1995-07-31 00:00:00.000,Kitzbuhel Austria ATP World Tour,CLAY,2,Sergi Bruguera,Jose Imaz-Ruiz,Sergi Bruguera,6-1; 6-4,R32,56,3,1,36,54,28,36,11,18,2,2,9,39,54,0,2,40,51,24,40,5,11,4,7,8,29,51
1995-07-31 00:00:00.000,Kitzbuhel Austria ATP World Tour,CLAY,2,Thomas Muster,Frederik Fetterlein,Thomas Muster,6-3; 6-3,R16,72,5,4,27,59,21,27,14,32,3,6,10,35,59,3,5,37,56,19,37,8,19,2,7,9,27,56
1995-07-31 00:00:00.000,Kitzbuhel Austria ATP World Tour,CLAY,2,Sandor Noszaly,Carlos Moya,Sandor Noszaly,6-4; 6-4,R16,64,4,5,40,51,34,40,3,11,0,1,10,37,51,2,0,35,50,22,35,8,15,0,3,10,30,50
1995-07-31 00:00:00.000,Kitzbuhel Austria ATP World Tour,CLAY,2,Alberto Berasategui,Marcelo Filippini,Alberto Berasategui,6-3; 7-6(1),R16,68,2,3,57,66,42,57,3,9,3,5,11,45,66,2,2,41,58,31,41,6,17,0,3,10,37,58
1995-07-31 00:00:00.000,Kitzbuhel Austria ATP World Tour,CLAY,2,Gilbert Schaller,Jordi Arrese,Gilbert Schaller,6-4; 3-6; 6-4,R16,162,7,4,63,117,43,63,22,54,14,18,15,65,117,0,5,67,101,40,67,19,34,7,11,14,59,101
1995-07-31 00:00:00.000,Kitzbuhel Austria ATP World Tour,CLAY,2,Albert Costa,Adrian Voinea,Albert Costa,6-3; 6-4,R16,60,4,2,39,55,33,39,9,16,1,1,10,42,55,4,5,30,54,23,30,11,24,3,5,9,34,54
1995-07-31 00:00:00.000,Kitzbuhel Austria ATP World Tour,CLAY,2,Andrea Gaudenzi,Andrew Ilie,Andrea Gaudenzi,6-0; 6-1,R16,46,4,3,20,39,18,20,9,19,1,1,6,27,39,4,7,24,44,12,24,5,20,2,8,7,17,44
1995-07-31 00:00:00.000,Kitzbuhel Austria ATP World Tour,CLAY,2,Bernd Karbacher,Fernando Meligeni,Bernd Karbacher,6-4; 5-7; 6-3,R16,139,4,4,44,114,33,44,35,70,8,12,16,68,114,2,3,47,106,31,47,29,59,8,13,15,60,106
1995-07-31 00:00:00.000,Kitzbuhel Austria ATP World Tour,CLAY,2,Stefano Pescosolido,Sergi Bruguera,Stefano Pescosolido,6-4; 7-5,R16,78,6,1,35,60,30,35,14,25,1,2,11,44,60,3,4,47,74,34,47,10,27,2,5,11,44,74
1995-07-31 00:00:00.000,Kitzbuhel Austria ATP World Tour,CLAY,2,Thomas Muster,Sandor Noszaly,Thomas Muster,7-6(1); 6-3,Q,85,3,4,46,68,36,46,12,22,1,3,11,48,68,10,10,40,66,29,40,8,26,0,3,10,37,66
1995-07-31 00:00:00.000,Kitzbuhel Austria ATP World Tour,CLAY,2,Gilbert Schaller,Alberto Berasategui,Gilbert Schaller,7-5; 6-4,Q,89,1,0,41,62,31,41,11,21,3,5,11,42,62,2,0,53,72,27,53,12,19,4,8,11,39,72
1995-07-31 00:00:00.000,Kitzbuhel Austria ATP World Tour,CLAY,2,Albert Costa,Andrea Gaudenzi,Albert Costa,6-2; 7-6(4),Q,80,1,7,52,75,39,52,9,23,0,1,10,48,75,1,5,34,61,23,34,13,27,2,5,10,36,61
1995-07-31 00:00:00.000,Kitzbuhel Austria ATP World Tour,CLAY,2,Bernd Karbacher,Stefano Pescosolido,Bernd Karbacher,7-5; 7-5,Q,97,7,2,40,77,29,40,22,37,2,3,12,51,77,7,6,40,72,28,40,16,32,1,4,12,44,72
1995-07-31 00:00:00.000,Kitzbuhel Austria ATP World Tour,CLAY,2,Thomas Muster,Gilbert Schaller,Thomas Muster,6-3; 6-7(1); 6-3,S,145,2,8,80,117,52,80,13,37,6,10,14,65,117,7,1,79,103,44,79,7,24,11,19,15,51,103
1995-07-31 00:00:00.000,Kitzbuhel Austria ATP World Tour,CLAY,2,Albert Costa,Bernd Karbacher,Albert Costa,6-2; 6-4,S,68,1,1,47,64,28,47,13,17,4,5,9,41,64,3,3,31,52,21,31,5,21,0,4,9,26,52
1995-07-31 00:00:00.000,Kitzbuhel Austria ATP World Tour,CLAY,2,Albert Costa,Thomas Muster,Albert Costa,4-6; 6-4; 7-6(3); 2-6; 6-4,F,193,3,8,108,157,80,108,19,49,5,10,25,99,157,8,6,99,162,70,99,34,63,8,12,25,104,162
1995-07-31 00:00:00.000,Los Angeles CA; U.S.A. ATP World Tour,HARD,2,Goran Ivanisevic,Kenneth Carlsen,Goran Ivanisevic,6-2; 6-4,R32,68,6,3,23,61,20,23,20,38,4,5,9,40,61,5,3,28,56,18,28,11,28,3,7,9,29,56
1995-07-31 00:00:00.000,Los Angeles CA; U.S.A. ATP World Tour,HARD,2,Jim Grabb,Mark Petchey,Jim Grabb,6-2; 6-4,R32,86,1,1,36,56,25,36,15,20,3,3,9,40,56,3,3,40,63,25,40,8,23,2,5,9,33,63
1995-07-31 00:00:00.000,Los Angeles CA; U.S.A. ATP World Tour,HARD,2,Mark Philippoussis,Jim Pugh,Mark Philippoussis,7-6(5); 6-7(4); 7-6(7),R32,157,13,9,74,134,63,74,30,60,6,7,18,93,134,6,2,82,130,59,82,32,48,7,8,18,91,130
1995-07-31 00:00:00.000,Los Angeles CA; U.S.A. ATP World Tour,HARD,2,Marcos Ondruska,Brett Steven,Marcos Ondruska,1-6; 6-3; 6-3,R32,101,1,2,53,73,35,53,10,20,2,5,12,45,73,3,2,51,79,34,51,14,28,3,7,13,48,79
1995-07-31 00:00:00.000,Los Angeles CA; U.S.A. ATP World Tour,HARD,2,Jim Courier,Alejandro Hernandez,Jim Courier,6-3; 6-2,R32,64,3,1,33,47,27,33,11,14,0,0,9,38,47,3,0,33,48,20,33,8,15,0,3,8,28,48
1995-07-31 00:00:00.000,Los Angeles CA; U.S.A. ATP World Tour,HARD,2,Michael Joyce,Paul Wekesa,Michael Joyce,6-1; 6-4,R32,65,5,2,34,63,27,34,16,29,2,2,9,43,63,3,2,31,53,23,31,9,22,3,6,8,32,53
1995-07-31 00:00:00.000,Los Angeles CA; U.S.A. ATP World Tour,HARD,2,Cristiano Caratti,Jimmy Connors,Cristiano Caratti,6-4; 6-4,R32,68,3,1,33,53,24,33,12,20,0,2,10,36,53,1,0,45,56,23,45,9,11,0,4,10,32,56
1995-07-31 00:00:00.000,Los Angeles CA; U.S.A. ATP World Tour,HARD,2,Thomas Enqvist,Mauricio Hadad,Thomas Enqvist,6-1; 6-2,R32,43,2,1,18,36,17,18,15,18,0,0,8,32,36,0,0,17,39,8,17,10,22,4,8,7,18,39
1995-07-31 00:00:00.000,Los Angeles CA; U.S.A. ATP World Tour,HARD,2,Shuzo Matsuoka,Mark Woodforde,Shuzo Matsuoka,6-3; 2-6; 6-2,R32,103,8,5,63,84,47,63,8,21,5,7,13,55,84,4,4,50,78,35,50,11,28,6,9,12,46,78
1995-07-31 00:00:00.000,Los Angeles CA; U.S.A. ATP World Tour,HARD,2,Jakob Hlasek,Jordi Burillo,Jakob Hlasek,4-6; 6-1; 7-5,R32,105,13,4,55,97,47,55,20,42,7,9,15,67,97,6,8,31,83,21,31,27,52,3,7,14,48,83
1995-07-31 00:00:00.000,Los Angeles CA; U.S.A. ATP World Tour,HARD,2,Patrick Rafter,Paul Kilderry,Patrick Rafter,6-3; 5-7; 6-4,R32,121,8,4,57,92,40,57,18,35,2,6,16,58,92,4,6,53,88,36,53,17,35,3,8,15,53,88
1995-07-31 00:00:00.000,Los Angeles CA; U.S.A. ATP World Tour,HARD,2,Luis Herrera,Ignacio Martinez,Luis Herrera,4-6; 6-4; 6-3,R32,116,4,1,58,82,41,58,12,24,2,6,15,53,82,1,1,65,98,42,65,13,33,12,17,14,55,98
1995-07-31 00:00:00.000,Los Angeles CA; U.S.A. ATP World Tour,HARD,2,Alexander Volkov,Greg Rusedski,Alexander Volkov,7-5; 6-4,R32,83,6,9,41,74,33,41,14,33,1,2,11,47,74,9,8,41,75,28,41,14,34,4,7,11,42,75
1995-07-31 00:00:00.000,Los Angeles CA; U.S.A. ATP World Tour,HARD,2,Derrick Rostagno,Kent Kinnear,Derrick Rostagno,6-3; 6-3,R32,70,2,2,37,56,26,37,12,19,1,2,9,38,56,3,5,31,61,22,31,10,30,8,12,9,32,61
1995-07-31 00:00:00.000,Los Angeles CA; U.S.A. ATP World Tour,HARD,2,Jeff Tarango,Vincent Spadea,Jeff Tarango,6-2; 6-3,R32,58,2,3,45,70,33,45,11,25,6,6,9,44,70,2,3,27,42,18,27,6,15,3,6,8,24,42
1995-07-31 00:00:00.000,Los Angeles CA; U.S.A. ATP World Tour,HARD,2,Michael Stich,Gianluca Pozzi,Michael Stich,6-4; 6-2,R32,69,2,3,32,56,24,32,13,24,1,2,9,37,56,2,4,24,57,16,24,13,33,0,4,9,29,57
1995-07-31 00:00:00.000,Los Angeles CA; U.S.A. ATP World Tour,HARD,2,Goran Ivanisevic,Jim Grabb,Goran Ivanisevic,6-4; 6-2,R16,81,5,1,26,53,20,26,13,27,4,6,9,33,53,5,5,46,77,31,46,7,31,8,13,9,38,77
1995-07-31 00:00:00.000,Los Angeles CA; U.S.A. ATP World Tour,HARD,2,Marcos Ondruska,Mark Philippoussis,Marcos Ondruska,6-3; 1-6; 6-3,R16,105,4,2,60,91,39,60,20,31,7,9,13,59,91,7,6,46,81,33,46,17,35,8,10,12,50,81
1995-07-31 00:00:00.000,Los Angeles CA; U.S.A. ATP World Tour,HARD,2,Michael Joyce,Jim Courier,Michael Joyce,7-6(4); 7-5,R16,103,5,3,44,75,36,44,21,31,2,2,12,57,75,11,4,52,76,43,52,9,24,1,2,12,52,76
1995-07-31 00:00:00.000,Los Angeles CA; U.S.A. ATP World Tour,HARD,2,Thomas Enqvist,Cristiano Caratti,Thomas Enqvist,6-2; 7-6(2),R16,87,9,6,38,71,26,38,16,33,7,11,10,42,71,1,5,41,80,20,41,18,39,8,14,10,38,80
1995-07-31 00:00:00.000,Los Angeles CA; U.S.A. ATP World Tour,HARD,2,Jakob Hlasek,Shuzo Matsuoka,Jakob Hlasek,6-3; 4-6; 7-6(5),R16,131,5,8,56,103,46,56,21,47,4,6,15,67,103,12,3,58,99,48,58,15,41,0,3,16,63,99
1995-07-31 00:00:00.000,Los Angeles CA; U.S.A. ATP World Tour,HARD,2,Patrick Rafter,Luis Herrera,Patrick Rafter,7-5; 6-1,R16,76,0,0,43,66,29,43,14,23,4,5,10,43,66,0,4,32,56,21,32,10,24,5,9,9,31,56
1995-07-31 00:00:00.000,Los Angeles CA; U.S.A. ATP World Tour,HARD,2,Alexander Volkov,Derrick Rostagno,Alexander Volkov,6-4; 1-6; 6-4,R16,111,5,8,42,90,30,42,22,48,4,7,13,52,90,7,3,57,87,39,57,15,30,6,9,14,54,87
1995-07-31 00:00:00.000,Los Angeles CA; U.S.A. ATP World Tour,HARD,2,Michael Stich,Jeff Tarango,Michael Stich,6-3; 6-3,R16,63,10,3,33,49,25,33,9,16,3,4,9,34,49,1,2,38,57,24,38,6,19,2,6,9,30,57
1995-07-31 00:00:00.000,Los Angeles CA; U.S.A. ATP World Tour,HARD,2,Goran Ivanisevic,Marcos Ondruska,Goran Ivanisevic,2-6; 6-1; 6-3,Q,86,16,6,36,76,31,36,17,40,2,4,12,48,76,2,5,35,72,24,35,16,37,2,6,12,40,72
1995-07-31 00:00:00.000,Los Angeles CA; U.S.A. ATP World Tour,HARD,2,Thomas Enqvist,Michael Joyce,Thomas Enqvist,1-6; 6-1; 6-1,Q,85,12,2,33,67,25,33,18,34,7,9,10,43,67,3,4,44,85,30,44,14,41,13,18,11,44,85
1995-07-31 00:00:00.000,Los Angeles CA; U.S.A. ATP World Tour,HARD,2,Jakob Hlasek,Patrick Rafter,Jakob Hlasek,6-7(1); 6-4; 7-6(5),Q,140,3,4,66,118,48,66,31,52,7,9,17,79,118,9,4,72,109,50,72,20,37,0,3,17,70,109
1995-07-31 00:00:00.000,Los Angeles CA; U.S.A. ATP World Tour,HARD,2,Michael Stich,Alexander Volkov,Michael Stich,6-3; 6-2,Q,69,11,2,31,60,25,31,17,29,6,6,9,42,60,1,6,21,53,13,21,17,32,6,9,8,30,53
1995-07-31 00:00:00.000,Los Angeles CA; U.S.A. ATP World Tour,HARD,2,Thomas Enqvist,Goran Ivanisevic,Thomas Enqvist,6-7(3); 6-4; 6-4,S,106,16,2,51,94,44,51,28,43,5,5,16,72,94,22,1,51,99,45,51,25,48,8,10,16,70,99
1995-07-31 00:00:00.000,Los Angeles CA; U.S.A. ATP World Tour,HARD,2,Michael Stich,Jakob Hlasek,Michael Stich,6-2; 6-4,S,63,7,0,26,46,22,26,15,20,1,1,9,37,46,2,3,30,59,21,30,11,29,4,7,9,32,59
1995-07-31 00:00:00.000,Los Angeles CA; U.S.A. ATP World Tour,HARD,2,Michael Stich,Thomas Enqvist,Michael Stich,6-7(7); 7-6(4); 6-2,F,149,17,3,82,140,60,82,33,58,6,6,16,93,140,3,6,49,102,40,49,32,53,3,5,16,72,102
1995-07-31 00:00:00.000,Prague Czech Republic ATP World Tour,CLAY,2,Marc Rosset,Jaroslav Bulant,Marc Rosset,6-1; 1-6; 6-4,R32,114,6,6,40,84,28,40,19,44,6,11,13,47,84,1,0,57,99,32,57,22,42,9,14,14,54,99
1995-07-31 00:00:00.000,Prague Czech Republic ATP World Tour,CLAY,2,David Skoch,Jan Kroslak,David Skoch,0-6; 6-1; 6-2,R32,74,1,3,29,71,13,29,22,42,6,11,10,35,71,2,10,22,57,14,22,10,35,0,7,11,24,57
1995-07-31 00:00:00.000,Prague Czech Republic ATP World Tour,CLAY,2,David Rikl,Jiri Novak,David Rikl,6-3; 6-1,R32,58,2,1,28,53,16,28,16,25,4,5,8,32,53,1,2,31,49,16,31,7,18,3,8,8,23,49
1995-07-31 00:00:00.000,Prague Czech Republic ATP World Tour,CLAY,2,Javier Sanchez,Ronald Agenor,Javier Sanchez,4-6; 6-2; 6-3,R32,113,4,2,52,78,38,52,16,26,2,4,14,54,78,2,4,48,92,28,48,22,44,10,14,13,50,92
1995-07-31 00:00:00.000,Prague Czech Republic ATP World Tour,CLAY,2,Karol Kucera,Andrei Cherkasov,Karol Kucera,6-3; 1-6; 6-1,R32,109,7,3,29,64,20,29,15,35,1,6,12,35,64,1,4,40,90,20,40,23,50,3,9,11,43,90
1995-07-31 00:00:00.000,Prague Czech Republic ATP World Tour,CLAY,2,Albert Portas,Marcos Aurelio Gorriz,Albert Portas,6-2; 6-4,R32,76,1,2,41,68,31,41,13,27,2,2,9,44,68,1,0,29,53,22,29,11,24,3,6,9,33,53
1995-07-31 00:00:00.000,Prague Czech Republic ATP World Tour,CLAY,2,Karim Alami,David Miketa,Karim Alami,7-6(2); 6-0,R32,67,2,1,25,50,21,25,16,25,0,1,9,37,50,1,11,24,59,16,24,12,35,1,5,9,28,59
1995-07-31 00:00:00.000,Prague Czech Republic ATP World Tour,CLAY,2,Hernan Gumy,Christian Ruud,Hernan Gumy,4-6; 6-1; 6-3,R32,137,1,1,60,91,39,60,16,31,5,8,13,55,91,3,5,41,78,23,41,15,37,6,12,13,38,78
1995-07-31 00:00:00.000,Prague Czech Republic ATP World Tour,CLAY,2,Slava Dosedel,Henri Leconte,Slava Dosedel,6-1; 6-3,R32,51,1,1,37,45,27,37,4,8,1,2,8,31,45,5,3,22,43,13,22,7,21,2,7,8,20,43
1995-07-31 00:00:00.000,Prague Czech Republic ATP World Tour,CLAY,2,Bohdan Ulihrach,Marco Meneschincheri,Bohdan Ulihrach,6-4; 6-1,R32,61,4,5,26,65,20,26,21,39,5,6,9,41,65,0,2,24,47,16,24,7,23,1,5,8,23,47
1995-07-31 00:00:00.000,Prague Czech Republic ATP World Tour,CLAY,2,Gaston Etlis,Oscar Martinez,Gaston Etlis,6-4; 6-4,R32,8,2,0,26,63,23,26,18,37,5,6,10,41,63,1,8,21,55,16,21,18,34,2,5,10,34,55
1995-07-31 00:00:00.000,Prague Czech Republic ATP World Tour,CLAY,2,Oleg Ogorodov,Franco Davin,Oleg Ogorodov,6-3; 3-6; 6-3,R32,98,3,1,58,79,46,58,12,21,4,5,14,58,79,0,6,47,82,31,47,22,35,2,4,13,53,82
1995-07-31 00:00:00.000,Prague Czech Republic ATP World Tour,CLAY,2,Sergio Cortes,Jaime Yzaga,Sergio Cortes,4-6; 7-6(6); 6-3,R32,133,1,2,52,105,33,52,24,53,9,15,15,57,105,5,9,47,99,28,47,23,52,5,12,16,51,99
1995-07-31 00:00:00.000,Prague Czech Republic ATP World Tour,CLAY,2,Mariano Zabaleta,Wojtek Kowalski,Mariano Zabaleta,6-4; 1-6; 7-6(3),R32,130,1,1,60,90,38,60,16,30,5,10,14,54,90,4,3,61,102,42,61,17,41,8,12,15,59,102
1995-07-31 00:00:00.000,Prague Czech Republic ATP World Tour,CLAY,2,Jiri Vanek,Radomir Vasek,Jiri Vanek,6-4; 4-6; 6-4,R32,140,4,3,43,109,27,43,29,66,8,15,15,56,109,2,17,51,95,36,51,10,44,3,11,15,46,95
1995-07-31 00:00:00.000,Prague Czech Republic ATP World Tour,CLAY,2,Nicklas Kulti,Andrei Medvedev,Nicklas Kulti,7-5 RET,R32,45,2,2,19,36,14,19,8,17,2,4,6,22,36,1,1,16,36,9,16,9,20,1,4,7,18,36
1995-07-31 00:00:00.000,Prague Czech Republic ATP World Tour,CLAY,2,Marc Rosset,David Skoch,Marc Rosset,7-6(3); 7-5,R16,109,3,7,44,92,33,44,24,48,11,14,12,57,92,0,3,65,93,41,65,10,28,11,15,12,51,93
1995-07-31 00:00:00.000,Prague Czech Republic ATP World Tour,CLAY,2,Javier Sanchez,David Rikl,Javier Sanchez,7-6(6); 6-1,R16,86,0,3,48,77,27,48,17,29,3,6,10,44,77,0,5,25,62,11,25,19,37,2,7,9,30,62
1995-07-31 00:00:00.000,Prague Czech Republic ATP World Tour,CLAY,2,Albert Portas,Karol Kucera,Albert Portas,6-2; 2-6; 6-0,R16,80,1,1,51,69,29,51,13,18,4,7,11,42,69,1,9,20,64,11,20,20,44,6,12,11,31,64
1995-07-31 00:00:00.000,Prague Czech Republic ATP World Tour,CLAY,2,Karim Alami,Hernan Gumy,Karim Alami,6-2; 6-4,R16,71,1,1,24,51,20,24,16,27,3,4,9,36,51,1,5,36,56,20,36,10,20,2,6,9,30,56
1995-07-31 00:00:00.000,Prague Czech Republic ATP World Tour,CLAY,2,Bohdan Ulihrach,Slava Dosedel,Bohdan Ulihrach,0-6; 6-2; 7-5,R16,108,5,6,38,88,25,38,26,50,7,11,13,51,88,0,2,64,84,37,64,11,20,4,8,13,48,84
1995-07-31 00:00:00.000,Prague Czech Republic ATP World Tour,CLAY,2,Gaston Etlis,Oleg Ogorodov,Gaston Etlis,6-4; 6-2,R16,68,1,2,18,49,14,18,22,31,0,0,9,36,49,1,2,29,55,21,29,10,26,3,6,9,31,55
1995-07-31 00:00:00.000,Prague Czech Republic ATP World Tour,CLAY,2,Mariano Zabaleta,Sergio Cortes,Mariano Zabaleta,6-4; 6-4,R16,93,2,1,37,59,18,37,9,22,2,7,10,27,59,0,3,30,59,14,30,11,29,3,10,10,25,59
1995-07-31 00:00:00.000,Prague Czech Republic ATP World Tour,CLAY,2,Nicklas Kulti,Jiri Vanek,Nicklas Kulti,6-0; 6-4,R16,81,2,2,26,60,20,26,15,34,2,4,8,35,60,1,1,25,53,9,25,11,28,2,8,8,20,53
1995-07-31 00:00:00.000,Prague Czech Republic ATP World Tour,CLAY,2,Javier Sanchez,Marc Rosset,Javier Sanchez,6-4; 6-4,Q,80,1,1,50,73,34,50,8,23,8,11,10,42,73,4,1,29,54,18,29,9,25,0,5,10,27,54
1995-07-31 00:00:00.000,Prague Czech Republic ATP World Tour,CLAY,2,Albert Portas,Karim Alami,Albert Portas,4-6; 7-6(4); 6-1,Q,140,0,4,63,102,41,63,22,39,6,9,14,63,102,7,3,50,114,32,50,30,64,9,14,15,62,114
1995-07-31 00:00:00.000,Prague Czech Republic ATP World Tour,CLAY,2,Bohdan Ulihrach,Gaston Etlis,Bohdan Ulihrach,6-3; 7-5,Q,92,1,3,35,79,24,35,23,44,7,9,10,47,79,3,3,34,65,19,34,14,31,1,6,11,33,65
1995-07-31 00:00:00.000,Prague Czech Republic ATP World Tour,CLAY,2,Nicklas Kulti,Mariano Zabaleta,Nicklas Kulti,6-2; 6-1,Q,68,5,2,23,49,19,23,17,26,1,1,8,36,49,1,1,30,50,16,30,8,20,4,8,7,24,50
1995-07-31 00:00:00.000,Prague Czech Republic ATP World Tour,CLAY,2,Javier Sanchez,Albert Portas,Javier Sanchez,3-6; 6-1; 6-4,S,96,2,2,61,86,44,61,11,25,7,9,13,55,86,1,2,57,80,37,57,11,23,4,8,13,48,80
1995-07-31 00:00:00.000,Prague Czech Republic ATP World Tour,CLAY,2,Bohdan Ulihrach,Nicklas Kulti,Bohdan Ulihrach,6-4; 6-4,S,77,1,3,25,51,21,25,16,26,0,1,10,37,51,3,3,31,68,20,31,19,37,6,9,10,39,68
1995-07-31 00:00:00.000,Prague Czech Republic ATP World Tour,CLAY,2,Bohdan Ulihrach,Javier Sanchez,Bohdan Ulihrach,6-2; 6-2,F,58,1,3,21,42,16,21,13,21,1,2,8,29,42,0,2,38,55,21,38,5,17,6,11,8,26,55
1995-08-07 00:00:00.000,ATP Masters Series Cincinnati OH; U.S.A. ATP World Tour,HARD,2,Andre Agassi,N/A Bye,Andre Agassi,,R64,0,0,0,0,0,0,0,0,0,0,0,0,0,0,0,0,0,0,0,0,0,0,0,0,0,0,0
1995-08-07 00:00:00.000,ATP Masters Series Cincinnati OH; U.S.A. ATP World Tour,HARD,2,Daniel Vacek,Jerome Golmard,Daniel Vacek,6-7(4); 6-4; 6-4,R64,116,14,6,55,95,46,55,19,40,0,1,16,65,95,7,1,59,103,40,59,25,44,4,7,16,65,103
1995-08-07 00:00:00.000,ATP Masters Series Cincinnati OH; U.S.A. ATP World Tour,HARD,2,Jonas Bjorkman,Martin Damm,Jonas Bjorkman,2-6; 7-5; 6-4,R64,127,11,8,57,108,41,57,21,51,9,13,15,62,108,7,2,45,92,32,45,22,47,1,5,15,54,92
1995-08-07 00:00:00.000,ATP Masters Series Cincinnati OH; U.S.A. ATP World Tour,HARD,2,Alberto Berasategui,Guy Forget,Alberto Berasategui,7-5; 4-6; 6-4,R64,111,3,2,64,90,44,64,16,26,2,5,16,60,90,19,8,61,105,43,61,21,44,6,10,16,64,105
1995-08-07 00:00:00.000,ATP Masters Series Cincinnati OH; U.S.A. ATP World Tour,HARD,2,Sergi Bruguera,Byron Black,Sergi Bruguera,7-6(6); 4-6; 6-2,R64,122,10,4,61,114,47,61,23,53,7,9,15,70,114,7,3,79,120,49,79,25,41,11,14,15,74,120
1995-08-07 00:00:00.000,ATP Masters Series Cincinnati OH; U.S.A. ATP World Tour,HARD,2,Renzo Furlan,Mats Wilander,Renzo Furlan,6-4; 7-6(4),R64,89,4,0,40,64,32,40,17,24,1,2,11,49,64,3,1,44,68,30,44,14,24,0,2,11,44,68
1995-08-07 00:00:00.000,ATP Masters Series Cincinnati OH; U.S.A. ATP World Tour,HARD,2,Olivier Delaitre,Marc-Kevin Goellner,Olivier Delaitre,7-6(5); 6-3,R64,88,5,3,35,73,24,35,17,38,2,5,11,41,73,13,4,39,72,26,39,11,33,6,10,10,37,72
1995-08-07 00:00:00.000,ATP Masters Series Cincinnati OH; U.S.A. ATP World Tour,HARD,2,Wayne Ferreira,N/A Bye,Wayne Ferreira,,R64,0,0,0,0,0,0,0,0,0,0,0,0,0,0,0,0,0,0,0,0,0,0,0,0,0,0,0
1995-08-07 00:00:00.000,ATP Masters Series Cincinnati OH; U.S.A. ATP World Tour,HARD,2,Boris Becker,N/A Bye,Boris Becker,,R64,0,0,0,0,0,0,0,0,0,0,0,0,0,0,0,0,0,0,0,0,0,0,0,0,0,0,0
1995-08-07 00:00:00.000,ATP Masters Series Cincinnati OH; U.S.A. ATP World Tour,HARD,2,Jan Siemerink,Kenneth Carlsen,Jan Siemerink,6-3; 7-6(3),R64,90,4,2,37,71,27,37,23,34,3,4,11,50,71,3,1,47,70,33,47,11,23,9,11,10,44,70
1995-08-07 00:00:00.000,ATP Masters Series Cincinnati OH; U.S.A. ATP World Tour,HARD,2,David Wheaton,Alex Corretja,David Wheaton,6-1; 7-6(4),R64,79,4,2,36,65,27,36,15,29,1,3,10,42,65,1,2,38,52,20,38,8,14,2,6,9,28,52
1995-08-07 00:00:00.000,ATP Masters Series Cincinnati OH; U.S.A. ATP World Tour,HARD,2,Thomas Enqvist,Anders Jarryd,Thomas Enqvist,6-1; 6-1,R64,48,2,3,16,33,15,16,13,17,0,0,7,28,33,0,0,23,47,13,23,6,24,5,10,7,19,47
1995-08-07 00:00:00.000,ATP Masters Series Cincinnati OH; U.S.A. ATP World Tour,HARD,2,Sandon Stolle,Stefan Edberg,Sandon Stolle,6-3; 6-1,R64,64,5,5,30,43,22,30,7,13,0,1,8,29,43,1,3,32,57,17,32,10,25,6,11,8,27,57
1995-08-07 00:00:00.000,ATP Masters Series Cincinnati OH; U.S.A. ATP World Tour,HARD,2,Brett Steven,Marcelo Rios,Brett Steven,6-3; 6-3,R64,73,5,3,35,54,25,35,10,19,1,2,9,35,54,4,4,34,55,21,34,10,21,5,9,9,31,55
1995-08-07 00:00:00.000,ATP Masters Series Cincinnati OH; U.S.A. ATP World Tour,HARD,2,Richey Reneberg,Arnaud Boetsch,Richey Reneberg,6-2; 6-3,R64,69,4,0,28,62,19,28,21,34,5,6,9,40,62,1,0,27,50,13,27,13,23,4,8,8,26,50
1995-08-07 00:00:00.000,ATP Masters Series Cincinnati OH; U.S.A. ATP World Tour,HARD,2,Goran Ivanisevic,N/A Bye,Goran Ivanisevic,,R64,0,0,0,0,0,0,0,0,0,0,0,0,0,0,0,0,0,0,0,0,0,0,0,0,0,0,0
1995-08-07 00:00:00.000,ATP Masters Series Cincinnati OH; U.S.A. ATP World Tour,HARD,2,Yevgeny Kafelnikov,N/A Bye,Yevgeny Kafelnikov,,R64,0,0,0,0,0,0,0,0,0,0,0,0,0,0,0,0,0,0,0,0,0,0,0,0,0,0,0
1995-08-07 00:00:00.000,ATP Masters Series Cincinnati OH; U.S.A. ATP World Tour,HARD,2,Bernd Karbacher,Jonathan Stark,Bernd Karbacher,7-5; 6-1,R64,76,1,1,34,72,22,34,22,38,4,6,10,44,72,3,3,28,49,18,28,6,21,3,8,9,24,49
1995-08-07 00:00:00.000,ATP Masters Series Cincinnati OH; U.S.A. ATP World Tour,HARD,2,Vincent Spadea,Cedric Pioline,Vincent Spadea,6-2; 3-6; 6-4,R64,112,4,1,38,77,24,38,28,39,1,2,13,52,77,6,2,51,84,36,51,15,33,2,5,14,51,84
1995-08-07 00:00:00.000,ATP Masters Series Cincinnati OH; U.S.A. ATP World Tour,HARD,2,Jim Courier,Jared Palmer,Jim Courier,6-3; 6-2,R64,86,2,0,31,53,23,31,15,22,0,0,9,38,53,4,4,29,59,18,29,16,30,2,5,8,34,59
1995-08-07 00:00:00.000,ATP Masters Series Cincinnati OH; U.S.A. ATP World Tour,HARD,2,Andrei Medvedev,Tommy Ho,Andrei Medvedev,6-1; 6-2,R64,51,9,5,28,49,23,28,12,21,1,1,8,35,49,3,4,17,39,13,17,6,22,1,5,7,19,39
1995-08-07 00:00:00.000,ATP Masters Series Cincinnati OH; U.S.A. ATP World Tour,HARD,2,Patrick Rafter,Andrei Chesnokov,Patrick Rafter,6-3; 7-6(5),R64,88,8,3,36,65,31,36,19,29,1,1,11,50,65,4,4,48,73,39,48,9,25,3,4,10,48,73
1995-08-07 00:00:00.000,ATP Masters Series Cincinnati OH; U.S.A. ATP World Tour,HARD,2,Alex O'Brien,Lionel Roux,Alex O'Brien,6-2; 6-2,R64,69,1,0,33,49,23,33,13,16,3,3,8,36,49,1,5,17,46,10,17,13,29,0,4,8,23,46
1995-08-07 00:00:00.000,ATP Masters Series Cincinnati OH; U.S.A. ATP World Tour,HARD,2,Michael Chang,N/A Bye,Michael Chang,,R64,0,0,0,0,0,0,0,0,0,0,0,0,0,0,0,0,0,0,0,0,0,0,0,0,0,0,0
1995-08-07 00:00:00.000,ATP Masters Series Cincinnati OH; U.S.A. ATP World Tour,HARD,2,Michael Stich,N/A Bye,Michael Stich,,R64,0,0,0,0,0,0,0,0,0,0,0,0,0,0,0,0,0,0,0,0,0,0,0,0,0,0,0
1995-08-07 00:00:00.000,ATP Masters Series Cincinnati OH; U.S.A. ATP World Tour,HARD,2,Todd Woodbridge,MaliVai Washington,Todd Woodbridge,7-6(8); 6-4,R64,87,3,2,48,74,36,48,14,26,0,1,11,50,74,8,1,49,67,38,49,7,18,0,2,11,45,67
1995-08-07 00:00:00.000,ATP Masters Series Cincinnati OH; U.S.A. ATP World Tour,HARD,2,Patrick McEnroe,Jim Grabb,Patrick McEnroe,6-2; 6-3,R64,72,1,3,42,58,30,42,7,16,2,3,9,37,58,6,0,37,48,20,37,4,11,4,8,8,24,48
1995-08-07 00:00:00.000,ATP Masters Series Cincinnati OH; U.S.A. ATP World Tour,HARD,2,Greg Rusedski,Richard Krajicek,Greg Rusedski,7-6(4); 6-3,R64,76,5,6,32,63,28,32,14,31,1,3,11,42,63,2,4,38,72,28,38,14,34,6,9,10,42,72
1995-08-07 00:00:00.000,ATP Masters Series Cincinnati OH; U.S.A. ATP World Tour,HARD,2,Todd Martin,Jaime Yzaga,Todd Martin,6-3; 6-4,R64,70,7,4,33,54,28,33,13,21,0,0,10,41,54,1,2,29,58,19,29,17,29,4,6,9,36,58
1995-08-07 00:00:00.000,ATP Masters Series Cincinnati OH; U.S.A. ATP World Tour,HARD,2,Mark Woodforde,Jason Stoltenberg,Mark Woodforde,7-6(5); 6-3,R64,98,3,5,38,71,27,38,16,33,4,7,10,43,71,2,4,48,83,28,48,17,35,6,11,11,45,83
1995-08-07 00:00:00.000,ATP Masters Series Cincinnati OH; U.S.A. ATP World Tour,HARD,2,Petr Korda,Aaron Krickstein,Petr Korda,6-2; 6-1,R64,57,1,3,31,54,24,31,13,23,3,3,8,37,54,2,0,25,44,13,25,8,19,2,6,7,21,44
1995-08-07 00:00:00.000,ATP Masters Series Cincinnati OH; U.S.A. ATP World Tour,HARD,2,Pete Sampras,N/A Bye,Pete Sampras,,R64,0,0,0,0,0,0,0,0,0,0,0,0,0,0,0,0,0,0,0,0,0,0,0,0,0,0,0
1995-08-07 00:00:00.000,ATP Masters Series Cincinnati OH; U.S.A. ATP World Tour,HARD,2,Andre Agassi,Daniel Vacek,Andre Agassi,7-6(5); 6-1,R32,88,6,3,59,89,42,59,13,30,6,7,10,55,89,8,7,44,67,30,44,8,23,5,8,9,38,67
1995-08-07 00:00:00.000,ATP Masters Series Cincinnati OH; U.S.A. ATP World Tour,HARD,2,Alberto Berasategui,Jonas Bjorkman,Alberto Berasategui,6-0; 1-6; 7-5,R32,98,2,3,63,92,37,63,15,29,10,14,12,52,92,3,7,46,85,33,46,12,39,6,12,13,45,85
1995-08-07 00:00:00.000,ATP Masters Series Cincinnati OH; U.S.A. ATP World Tour,HARD,2,Renzo Furlan,Sergi Bruguera,Renzo Furlan,6-2; 6-4,R32,58,5,1,31,50,26,31,10,19,2,3,9,36,50,5,3,34,60,19,34,13,26,4,8,9,32,60
1995-08-07 00:00:00.000,ATP Masters Series Cincinnati OH; U.S.A. ATP World Tour,HARD,2,Wayne Ferreira,Olivier Delaitre,Wayne Ferreira,6-3; 6-2,R32,65,3,2,28,60,23,28,19,32,5,5,9,42,60,2,3,22,47,13,22,13,25,5,8,8,26,47
1995-08-07 00:00:00.000,ATP Masters Series Cincinnati OH; U.S.A. ATP World Tour,HARD,2,Jan Siemerink,Boris Becker,Jan Siemerink,7-5; 7-6(7),R32,105,6,4,57,92,45,57,17,35,5,5,12,62,92,9,7,35,74,31,35,22,39,2,3,12,53,74
1995-08-07 00:00:00.000,ATP Masters Series Cincinnati OH; U.S.A. ATP World Tour,HARD,2,Thomas Enqvist,David Wheaton,Thomas Enqvist,6-2; 7-6(4),R32,94,6,3,41,72,26,41,19,31,4,6,10,45,72,10,3,40,72,28,40,10,32,1,5,10,38,72
1995-08-07 00:00:00.000,ATP Masters Series Cincinnati OH; U.S.A. ATP World Tour,HARD,2,Brett Steven,Sandon Stolle,Brett Steven,7-6(5); 6-2,R32,76,8,0,39,58,35,39,12,19,2,2,10,47,58,7,6,37,65,26,37,15,28,2,4,10,41,65
1995-08-07 00:00:00.000,ATP Masters Series Cincinnati OH; U.S.A. ATP World Tour,HARD,2,Goran Ivanisevic,Richey Reneberg,Goran Ivanisevic,7-5; 6-4,R32,72,23,6,45,82,39,45,16,37,5,5,11,55,82,9,3,32,63,25,32,18,31,3,5,11,43,63
1995-08-07 00:00:00.000,ATP Masters Series Cincinnati OH; U.S.A. ATP World Tour,HARD,2,Bernd Karbacher,Yevgeny Kafelnikov,Bernd Karbacher,6-4; 7-5,R32,89,4,1,36,66,28,36,22,30,3,3,11,50,66,6,3,42,77,35,42,12,35,5,7,11,47,77
1995-08-07 00:00:00.000,ATP Masters Series Cincinnati OH; U.S.A. ATP World Tour,HARD,2,Jim Courier,Vincent Spadea,Jim Courier,7-5; 7-6(7),R32,118,4,7,48,92,31,48,22,44,8,12,12,53,92,5,4,45,72,29,45,9,27,0,5,12,38,72
1995-08-07 00:00:00.000,ATP Masters Series Cincinnati OH; U.S.A. ATP World Tour,HARD,2,Patrick Rafter,Andrei Medvedev,Patrick Rafter,4-6; 6-1; 7-6(5),R32,140,5,12,69,128,50,69,27,59,9,11,15,77,128,3,2,57,100,38,57,21,43,4,7,14,59,100
1995-08-07 00:00:00.000,ATP Masters Series Cincinnati OH; U.S.A. ATP World Tour,HARD,2,Michael Chang,Alex O'Brien,Michael Chang,4-6; 6-4; 6-1,R32,111,7,3,39,85,31,39,23,46,7,10,14,54,85,2,1,50,78,33,50,11,28,7,12,13,44,78
1995-08-07 00:00:00.000,ATP Masters Series Cincinnati OH; U.S.A. ATP World Tour,HARD,2,Michael Stich,Todd Woodbridge,Michael Stich,2-6; 7-5; 6-3,R32,109,4,3,50,94,33,50,22,44,4,8,15,55,94,1,5,47,87,28,47,26,40,6,10,14,54,87
1995-08-07 00:00:00.000,ATP Masters Series Cincinnati OH; U.S.A. ATP World Tour,HARD,2,Patrick McEnroe,Greg Rusedski,Patrick McEnroe,6-3; 3-6; 7-6(6),R32,129,7,1,50,97,38,50,23,47,3,6,15,61,97,12,7,53,98,42,53,19,45,3,6,15,61,98
1995-08-07 00:00:00.000,ATP Masters Series Cincinnati OH; U.S.A. ATP World Tour,HARD,2,Todd Martin,Mark Woodforde,Todd Martin,6-3; 6-0,R32,56,7,3,31,46,25,31,7,15,4,5,8,32,46,0,8,19,40,9,19,7,21,3,8,7,16,40
1995-08-07 00:00:00.000,ATP Masters Series Cincinnati OH; U.S.A. ATP World Tour,HARD,2,Pete Sampras,Petr Korda,Pete Sampras,6-3; 7-6(3),R32,87,8,5,34,71,26,34,19,37,2,4,11,45,71,7,7,40,61,31,40,6,21,4,7,10,37,61
1995-08-07 00:00:00.000,ATP Masters Series Cincinnati OH; U.S.A. ATP World Tour,HARD,2,Andre Agassi,Alberto Berasategui,Andre Agassi,6-0; 0-6; 6-2,R16,69,3,2,39,59,28,39,6,20,4,7,10,34,59,3,0,43,60,24,43,7,17,3,8,10,31,60
1995-08-07 00:00:00.000,ATP Masters Series Cincinnati OH; U.S.A. ATP World Tour,HARD,2,Renzo Furlan,Wayne Ferreira,Renzo Furlan,7-6(2); 4-6; 7-6(5),R16,144,3,4,67,127,49,67,35,60,5,7,17,84,127,10,3,72,111,57,72,20,39,4,5,17,77,111
1995-08-07 00:00:00.000,ATP Masters Series Cincinnati OH; U.S.A. ATP World Tour,HARD,2,Thomas Enqvist,Jan Siemerink,Thomas Enqvist,6-2; 6-3,R16,57,3,4,24,45,22,24,14,21,0,0,9,36,45,4,4,26,51,21,26,8,25,3,6,8,29,51
1995-08-07 00:00:00.000,ATP Masters Series Cincinnati OH; U.S.A. ATP World Tour,HARD,2,Goran Ivanisevic,Brett Steven,Goran Ivanisevic,6-4; 6-4,R16,73,14,1,28,53,24,28,15,25,2,3,10,39,53,5,3,32,59,20,32,15,27,2,5,10,35,59
1995-08-07 00:00:00.000,ATP Masters Series Cincinnati OH; U.S.A. ATP World Tour,HARD,2,Jim Courier,Bernd Karbacher,Jim Courier,7-5; 6-2,R16,82,6,0,35,56,26,35,16,21,1,1,10,42,56,4,2,34,64,26,34,12,30,5,8,10,38,64
1995-08-07 00:00:00.000,ATP Masters Series Cincinnati OH; U.S.A. ATP World Tour,HARD,2,Michael Chang,Patrick Rafter,Michael Chang,7-5; 6-1,R16,65,4,0,29,53,25,29,16,24,3,3,10,41,53,5,2,38,51,26,38,4,13,2,5,9,30,51
1995-08-07 00:00:00.000,ATP Masters Series Cincinnati OH; U.S.A. ATP World Tour,HARD,2,Michael Stich,Patrick McEnroe,Michael Stich,7-6(5); 6-3,R16,90,15,1,36,66,32,36,15,30,2,3,10,47,66,2,6,46,75,29,46,17,29,3,6,11,46,75
1995-08-07 00:00:00.000,ATP Masters Series Cincinnati OH; U.S.A. ATP World Tour,HARD,2,Pete Sampras,Todd Martin,Pete Sampras,6-7(2); 6-4; 7-6(4),R16,157,22,8,66,123,54,66,29,57,10,10,17,83,123,19,7,65,113,55,65,25,48,8,9,17,80,113
1995-08-07 00:00:00.000,ATP Masters Series Cincinnati OH; U.S.A. ATP World Tour,HARD,2,Andre Agassi,Renzo Furlan,Andre Agassi,6-3; 6-4,Q,67,2,0,34,47,24,34,9,13,0,1,9,33,47,1,0,28,58,16,28,15,30,1,5,10,31,58
1995-08-07 00:00:00.000,ATP Masters Series Cincinnati OH; U.S.A. ATP World Tour,HARD,2,Thomas Enqvist,Goran Ivanisevic,Thomas Enqvist,4-6; 6-0; 6-3,Q,82,13,5,46,66,36,46,9,20,2,5,13,45,66,12,3,30,77,21,30,18,47,3,9,12,39,77
1995-08-07 00:00:00.000,ATP Masters Series Cincinnati OH; U.S.A. ATP World Tour,HARD,2,Michael Chang,Jim Courier,Michael Chang,3-6; 7-6(6); 7-5,Q,184,20,6,48,103,40,48,24,55,8,13,16,64,103,13,8,96,148,65,96,19,52,14,19,17,84,148
1995-08-07 00:00:00.000,ATP Masters Series Cincinnati OH; U.S.A. ATP World Tour,HARD,2,Michael Stich,Pete Sampras,Michael Stich,6-7(5); 7-6(3); 6-1,Q,122,27,1,51,100,40,51,33,49,4,5,16,73,100,6,9,51,94,40,51,21,43,1,4,15,61,94
1995-08-07 00:00:00.000,ATP Masters Series Cincinnati OH; U.S.A. ATP World Tour,HARD,2,Andre Agassi,Thomas Enqvist,Andre Agassi,6-4; 6-2,S,70,2,2,31,49,25,31,12,18,0,0,9,37,49,4,4,26,59,17,26,16,33,5,8,9,33,59
1995-08-07 00:00:00.000,ATP Masters Series Cincinnati OH; U.S.A. ATP World Tour,HARD,2,Michael Chang,Michael Stich,Michael Chang,4-6; 6-2; 7-6(5),S,130,3,2,48,100,35,48,28,52,5,8,15,63,100,6,3,43,84,31,43,20,41,2,6,15,51,84
1995-08-07 00:00:00.000,ATP Masters Series Cincinnati OH; U.S.A. ATP World Tour,HARD,2,Andre Agassi,Michael Chang,Andre Agassi,7-5; 6-2,F,96,10,4,45,68,31,45,13,23,2,3,10,44,68,5,0,41,80,25,41,19,39,13,17,10,44,80
1995-08-07 00:00:00.000,San Marino San Marino ATP World Tour,CLAY,2,Thomas Muster,Marcelo Filippini,Thomas Muster,6-4; 6-2,R32,79,2,2,20,52,17,20,20,32,1,2,9,37,52,5,4,35,67,20,35,16,32,3,7,9,36,67
1995-08-07 00:00:00.000,San Marino San Marino ATP World Tour,CLAY,2,Felix Mantilla,Pablo Albano,Felix Mantilla,6-2; 6-4,R32,93,0,0,47,63,29,47,11,16,9,10,9,40,63,1,4,26,67,19,26,16,41,5,9,9,35,67
1995-08-07 00:00:00.000,San Marino San Marino ATP World Tour,CLAY,2,Adrian Voinea,Frederik Fetterlein,Adrian Voinea,6-7(3); 7-6(6); 6-3,R32,156,6,3,64,114,47,64,25,50,8,11,17,72,114,7,13,49,120,37,49,35,71,2,6,16,72,120
1995-08-07 00:00:00.000,San Marino San Marino ATP World Tour,CLAY,2,Horst Skoff,Bohdan Ulihrach,Horst Skoff,4-0 RET,R32,16,0,0,6,15,4,6,6,9,1,1,3,10,15,2,1,9,14,4,9,1,5,1,3,2,5,14
1995-08-07 00:00:00.000,San Marino San Marino ATP World Tour,CLAY,2,Albert Costa,Jan Kroslak,Albert Costa,6-4; 6-3,R32,62,7,2,46,55,36,46,3,9,3,3,9,39,55,2,4,39,66,24,39,14,27,8,11,10,38,66
1995-08-07 00:00:00.000,San Marino San Marino ATP World Tour,CLAY,2,Hernan Gumy,Lars Jonsson,Hernan Gumy,7-6(4); 7-5,R32,139,1,3,42,72,36,42,14,30,5,7,12,50,72,3,0,55,89,36,55,16,34,7,10,12,52,89
1995-08-07 00:00:00.000,San Marino San Marino ATP World Tour,CLAY,2,Stefano Pescosolido,Igor Gaudi,Stefano Pescosolido,6-3; 7-6(4),R32,91,2,4,39,66,32,39,14,27,2,4,11,46,66,4,3,37,62,27,37,11,25,1,4,10,38,62
1995-08-07 00:00:00.000,San Marino San Marino ATP World Tour,CLAY,2,Gaston Etlis,Carlos Costa,Gaston Etlis,7-6(4); 6-4,R32,93,1,2,39,73,26,39,23,34,2,4,11,49,73,8,2,44,68,32,44,10,24,4,7,11,42,68
1995-08-07 00:00:00.000,San Marino San Marino ATP World Tour,CLAY,2,Sandor Noszaly,Jordi Arrese,Sandor Noszaly,7-6(0); 6-2,R32,121,5,6,33,59,25,33,14,26,0,2,10,39,59,4,1,35,69,24,35,11,34,6,10,10,35,69
1995-08-07 00:00:00.000,San Marino San Marino ATP World Tour,CLAY,2,Filip Dewulf,Daniele Musa,Filip Dewulf,7-6(4); 7-5(5),R32,114,2,1,64,94,41,64,20,30,9,11,12,61,94,4,1,40,80,28,40,23,40,3,5,12,51,80
1995-08-07 00:00:00.000,San Marino San Marino ATP World Tour,CLAY,2,Diego Nargiso,Alex Lopez Moron,Diego Nargiso,6-4; 6-2,R32,73,5,0,25,49,16,25,16,24,2,4,9,32,49,0,3,40,62,20,40,9,22,4,9,9,29,62
1995-08-07 00:00:00.000,San Marino San Marino ATP World Tour,CLAY,2,Gilbert Schaller,Carl-Uwe Steeb,Gilbert Schaller,6-3; 6-3,R32,54,3,2,28,57,23,28,15,29,3,4,9,38,57,5,2,33,55,18,33,12,22,4,8,9,30,55
1995-08-07 00:00:00.000,San Marino San Marino ATP World Tour,CLAY,2,Slava Dosedel,Roberto Carretero,Slava Dosedel,6-3; 6-2,R32,52,6,1,32,47,28,32,8,15,0,0,9,36,47,1,5,29,45,21,29,4,16,0,3,8,25,45
1995-08-07 00:00:00.000,San Marino San Marino ATP World Tour,CLAY,2,Franco Davin,Jiri Novak,Franco Davin,6-2; 6-4,R32,75,4,1,44,58,27,44,8,14,0,2,9,35,58,1,1,34,69,17,34,14,35,9,14,9,31,69
1995-08-07 00:00:00.000,San Marino San Marino ATP World Tour,CLAY,2,Paolo Pambianco,Alejo Mancisidor,Paolo Pambianco,6-1; 7-6(3),R32,99,3,3,44,72,35,44,19,28,7,7,10,54,72,3,3,53,91,37,53,15,38,6,8,9,52,91
1995-08-07 00:00:00.000,San Marino San Marino ATP World Tour,CLAY,2,Andrea Gaudenzi,Vaclav Roubicek,Andrea Gaudenzi,6-1; 4-6; 7-5,R32,139,2,7,46,92,32,46,26,46,8,11,14,58,92,5,4,46,84,31,46,17,38,4,10,15,48,84
1995-08-07 00:00:00.000,San Marino San Marino ATP World Tour,CLAY,2,Thomas Muster,Felix Mantilla,Thomas Muster,6-3; 6-2,R16,76,1,1,32,55,21,32,12,23,5,7,9,33,55,1,1,39,60,21,39,6,21,6,11,8,27,60
1995-08-07 00:00:00.000,San Marino San Marino ATP World Tour,CLAY,2,Adrian Voinea,Horst Skoff,Adrian Voinea,6-3; 6-1,R16,64,5,6,32,53,22,32,9,21,1,3,8,31,53,0,0,34,60,14,34,12,26,8,14,8,26,60
1995-08-07 00:00:00.000,San Marino San Marino ATP World Tour,CLAY,2,Albert Costa,Hernan Gumy,Albert Costa,6-3; 6-3,R16,80,0,0,43,58,28,43,10,15,3,4,9,38,58,1,6,27,57,17,27,14,30,5,9,9,31,57
1995-08-07 00:00:00.000,San Marino San Marino ATP World Tour,CLAY,2,Stefano Pescosolido,Gaston Etlis,Stefano Pescosolido,4-6; 6-3; 7-5,R16,126,6,4,55,103,44,55,25,48,6,7,16,69,103,5,4,50,90,35,50,24,40,2,4,15,59,90
1995-08-07 00:00:00.000,San Marino San Marino ATP World Tour,CLAY,2,Filip Dewulf,Sandor Noszaly,Filip Dewulf,7-6(4); 6-3,R16,96,5,3,45,65,34,45,13,20,1,2,11,47,65,6,2,67,91,43,67,8,24,13,15,10,51,91
1995-08-07 00:00:00.000,San Marino San Marino ATP World Tour,CLAY,2,Diego Nargiso,Gilbert Schaller,Diego Nargiso,7-6(4); 6-3,R16,95,6,3,30,57,25,30,17,27,1,2,10,42,57,0,3,65,89,39,65,13,24,4,7,11,52,89
1995-08-07 00:00:00.000,San Marino San Marino ATP World Tour,CLAY,2,Slava Dosedel,Franco Davin,Slava Dosedel,2-6; 6-3; 6-1,R16,102,3,3,49,72,30,49,11,23,2,6,12,41,72,1,3,69,108,40,69,15,39,13,19,12,55,108
1995-08-07 00:00:00.000,San Marino San Marino ATP World Tour,CLAY,2,Andrea Gaudenzi,Paolo Pambianco,Andrea Gaudenzi,6-3; 6-3,R16,61,2,2,22,45,17,22,15,23,1,3,9,32,45,2,3,35,61,19,35,9,26,6,11,9,28,61
1995-08-07 00:00:00.000,San Marino San Marino ATP World Tour,CLAY,2,Thomas Muster,Adrian Voinea,Thomas Muster,7-6(7); 2-6; 6-4,Q,104,1,1,55,88,41,55,19,33,1,4,15,60,88,7,3,54,90,44,54,19,36,3,5,15,63,90
1995-08-07 00:00:00.000,San Marino San Marino ATP World Tour,CLAY,2,Stefano Pescosolido,Albert Costa,Stefano Pescosolido,5-5 RET,Q,41,2,3,12,33,10,12,6,21,1,4,6,16,33,1,1,22,29,9,22,5,7,1,4,5,14,29
1995-08-07 00:00:00.000,San Marino San Marino ATP World Tour,CLAY,2,Filip Dewulf,Diego Nargiso,Filip Dewulf,6-4; 4-6; 7-6(5),Q,125,5,2,71,103,53,71,15,32,5,8,16,68,103,6,10,60,105,46,60,19,45,4,7,16,65,105
1995-08-07 00:00:00.000,San Marino San Marino ATP World Tour,CLAY,2,Andrea Gaudenzi,Slava Dosedel,Andrea Gaudenzi,6-2; 6-0,Q,54,1,1,30,50,21,30,13,20,3,3,7,34,50,0,1,25,37,11,25,4,12,0,5,7,15,37
1995-08-07 00:00:00.000,San Marino San Marino ATP World Tour,CLAY,2,Thomas Muster,Stefano Pescosolido,Thomas Muster,6-4; 6-2,S,69,5,0,32,50,24,32,13,18,2,2,9,37,50,2,5,32,65,20,32,17,33,7,10,9,37,65
1995-08-07 00:00:00.000,San Marino San Marino ATP World Tour,CLAY,2,Andrea Gaudenzi,Filip Dewulf,Andrea Gaudenzi,6-4; 6-0,S,79,1,2,30,60,23,30,16,30,6,6,8,39,60,3,4,35,69,21,35,12,34,8,12,8,33,69
1995-08-07 00:00:00.000,San Marino San Marino ATP World Tour,CLAY,2,Thomas Muster,Andrea Gaudenzi,Thomas Muster,6-2; 6-0,F,55,6,2,27,43,22,27,8,16,0,0,7,30,43,1,5,23,46,12,23,7,23,3,8,7,19,46
1995-08-14 00:00:00.000,Indianapolis IN; U.S.A. ATP World Tour,HARD,2,Pete Sampras,N/A Bye,Pete Sampras,,R64,0,0,0,0,0,0,0,0,0,0,0,0,0,0,0,0,0,0,0,0,0,0,0,0,0,0,0
1995-08-14 00:00:00.000,Indianapolis IN; U.S.A. ATP World Tour,HARD,2,Vincent Spadea,Aaron Krickstein,Vincent Spadea,4-6; 6-2; 6-2,R64,95,11,1,34,67,27,34,19,33,1,4,13,46,67,1,6,42,88,24,42,23,46,6,12,13,47,88
1995-08-14 00:00:00.000,Indianapolis IN; U.S.A. ATP World Tour,HARD,2,Jan Apell,Kent Kinnear,Jan Apell,6-1; 6-2,R64,58,4,1,25,38,20,25,11,13,2,2,7,31,38,11,4,37,61,23,37,6,24,9,14,8,29,61
1995-08-14 00:00:00.000,Indianapolis IN; U.S.A. ATP World Tour,HARD,2,Tim Henman,Cedric Pioline,Tim Henman,6-7(5); 6-3; 7-6(2),R64,154,3,6,51,120,34,51,39,69,5,9,16,73,120,4,11,56,110,38,56,25,54,0,6,17,63,110
1995-08-14 00:00:00.000,Indianapolis IN; U.S.A. ATP World Tour,HARD,2,Todd Woodbridge,Alex Corretja,Todd Woodbridge,6-4; 6-1,R64,69,2,4,31,54,25,31,13,23,3,3,9,38,54,0,3,39,58,23,39,8,19,6,9,8,31,58
1995-08-14 00:00:00.000,Indianapolis IN; U.S.A. ATP World Tour,HARD,2,Michael Tebbutt,Jan-Michael Gambill,Michael Tebbutt,6-3; 6-3,R64,72,11,4,27,55,25,27,15,28,3,3,9,40,55,3,5,33,69,24,33,17,36,11,14,9,41,69
1995-08-14 00:00:00.000,Indianapolis IN; U.S.A. ATP World Tour,HARD,2,Chris Woodruff,David Adams,Chris Woodruff,6-4; 6-2,R64,68,4,1,32,55,29,32,8,23,2,3,9,37,55,0,3,30,54,16,30,12,24,2,6,9,28,54
1995-08-14 00:00:00.000,Indianapolis IN; U.S.A. ATP World Tour,HARD,2,Andrei Medvedev,N/A Bye,Andrei Medvedev,,R64,0,0,0,0,0,0,0,0,0,0,0,0,0,0,0,0,0,0,0,0,0,0,0,0,0,0,0
1995-08-14 00:00:00.000,Indianapolis IN; U.S.A. ATP World Tour,HARD,2,Wayne Ferreira,N/A Bye,Wayne Ferreira,,R64,0,0,0,0,0,0,0,0,0,0,0,0,0,0,0,0,0,0,0,0,0,0,0,0,0,0,0
1995-08-14 00:00:00.000,Indianapolis IN; U.S.A. ATP World Tour,HARD,2,Richey Reneberg,Martin Damm,Richey Reneberg,6-2; 6-2,R64,52,6,1,23,38,20,23,12,15,0,0,8,32,38,2,4,25,44,14,25,6,19,1,5,8,20,44
1995-08-14 00:00:00.000,Indianapolis IN; U.S.A. ATP World Tour,HARD,2,Sandon Stolle,Nicola Bruno,Sandon Stolle,6-4; 6-2,R64,61,8,2,33,55,23,33,15,22,2,3,9,38,55,5,6,19,51,17,19,11,32,2,6,9,28,51
1995-08-14 00:00:00.000,Indianapolis IN; U.S.A. ATP World Tour,HARD,2,Guy Forget,Sargis Sargsian,Guy Forget,6-3; 6-4,R64,74,6,0,30,51,27,30,14,21,0,0,10,41,51,4,3,36,59,31,36,6,23,3,5,9,37,59
1995-08-14 00:00:00.000,Indianapolis IN; U.S.A. ATP World Tour,HARD,2,Bernd Karbacher,Scott Draper,Bernd Karbacher,6-3; 6-7(6); 6-3,R64,129,5,2,41,96,34,41,35,55,3,4,16,69,96,6,2,52,102,37,52,27,50,4,7,14,64,102
1995-08-14 00:00:00.000,Indianapolis IN; U.S.A. ATP World Tour,HARD,2,Jordi Burillo,Karol Kucera,Jordi Burillo,4-6; 5-4 RET,R64,82,4,1,42,60,29,42,5,18,4,7,10,34,60,8,10,29,79,23,29,22,50,5,8,10,45,79
1995-08-14 00:00:00.000,Indianapolis IN; U.S.A. ATP World Tour,HARD,2,Jonathan Stark,Olivier Delaitre,Jonathan Stark,6-3; 6-3,R64,70,11,2,29,48,25,29,14,19,2,2,9,39,48,1,5,31,58,22,31,12,27,5,8,9,34,58
1995-08-14 00:00:00.000,Indianapolis IN; U.S.A. ATP World Tour,HARD,2,Todd Martin,N/A Bye,Todd Martin,,R64,0,0,0,0,0,0,0,0,0,0,0,0,0,0,0,0,0,0,0,0,0,0,0,0,0,0,0
1995-08-14 00:00:00.000,Indianapolis IN; U.S.A. ATP World Tour,HARD,2,Jim Courier,N/A Bye,Jim Courier,,R64,0,0,0,0,0,0,0,0,0,0,0,0,0,0,0,0,0,0,0,0,0,0,0,0,0,0,0
1995-08-14 00:00:00.000,Indianapolis IN; U.S.A. ATP World Tour,HARD,2,Jerome Golmard,Jeremy Bates,Jerome Golmard,6-3; 7-5,R64,104,6,9,26,70,19,26,22,44,3,6,11,41,70,6,14,42,94,28,42,18,52,7,12,10,46,94
1995-08-14 00:00:00.000,Indianapolis IN; U.S.A. ATP World Tour,HARD,2,Nicklas Kulti,Kenny Thorne,Nicklas Kulti,7-6(1); 4-6; 6-1,R64,105,8,3,38,80,32,38,32,42,5,6,15,64,80,10,7,44,84,34,44,23,40,4,6,14,57,84
1995-08-14 00:00:00.000,Indianapolis IN; U.S.A. ATP World Tour,HARD,2,Renzo Furlan,David Wheaton,Renzo Furlan,7-6(6); 6-4,R64,91,5,3,38,69,35,38,17,31,2,2,11,52,69,7,3,35,63,30,35,18,28,2,3,11,48,63
1995-08-14 00:00:00.000,Indianapolis IN; U.S.A. ATP World Tour,HARD,2,Mark Woodforde,Jaime Yzaga,Mark Woodforde,7-6(8); 4-6; 6-4,R64,152,6,11,59,96,46,59,15,37,4,8,16,61,96,1,6,80,131,51,80,22,51,13,17,16,73,131
1995-08-14 00:00:00.000,Indianapolis IN; U.S.A. ATP World Tour,HARD,2,Cristiano Caratti,Jason Stoltenberg,Cristiano Caratti,3-6; 6-3; 6-3,R64,110,1,5,47,89,34,47,26,42,8,9,13,60,89,5,7,36,88,27,36,27,52,5,8,14,54,88
1995-08-14 00:00:00.000,Indianapolis IN; U.S.A. ATP World Tour,HARD,2,Jeff Tarango,Donald Johnson,Jeff Tarango,6-2; 6-4,R64,76,4,4,31,60,24,31,15,29,5,6,9,39,60,5,9,36,64,23,36,11,28,9,13,9,34,64
1995-08-14 00:00:00.000,Indianapolis IN; U.S.A. ATP World Tour,HARD,2,Thomas Enqvist,N/A Bye,Thomas Enqvist,,R64,0,0,0,0,0,0,0,0,0,0,0,0,0,0,0,0,0,0,0,0,0,0,0,0,0,0,0
1995-08-14 00:00:00.000,Indianapolis IN; U.S.A. ATP World Tour,HARD,2,Alberto Berasategui,N/A Bye,Alberto Berasategui,,R64,0,0,0,0,0,0,0,0,0,0,0,0,0,0,0,0,0,0,0,0,0,0,0,0,0,0,0
1995-08-14 00:00:00.000,Indianapolis IN; U.S.A. ATP World Tour,HARD,2,Lionel Roux,Nuno Marques,Lionel Roux,6-3; 6-4,R64,79,3,1,26,53,20,26,21,27,1,1,10,41,53,6,3,45,65,26,45,12,20,2,4,9,38,65
1995-08-14 00:00:00.000,Indianapolis IN; U.S.A. ATP World Tour,HARD,2,Petr Korda,Sebastien Lareau,Petr Korda,1-6; 6-3; 6-3,R64,90,4,12,47,73,34,47,7,26,2,7,13,41,73,7,5,48,79,30,48,12,31,5,10,12,42,79
1995-08-14 00:00:00.000,Indianapolis IN; U.S.A. ATP World Tour,HARD,2,Jonas Bjorkman,Bryan Shelton,Jonas Bjorkman,6-4; 6-3,R64,75,5,2,38,59,30,38,11,21,3,4,9,41,59,0,5,41,70,24,41,13,29,5,9,10,37,70
1995-08-14 00:00:00.000,Indianapolis IN; U.S.A. ATP World Tour,HARD,2,Brett Steven,Alex O'Brien,Brett Steven,6-1; 6-2,R64,72,3,2,26,46,21,26,14,20,2,2,8,35,46,4,2,36,56,19,36,8,20,7,11,7,27,56
1995-08-14 00:00:00.000,Indianapolis IN; U.S.A. ATP World Tour,HARD,2,Greg Rusedski,Anders Jarryd,Greg Rusedski,6-2; 7-5,R64,75,6,5,30,54,26,30,12,24,0,1,10,38,54,1,5,26,61,17,26,16,35,5,9,10,33,61
1995-08-14 00:00:00.000,Indianapolis IN; U.S.A. ATP World Tour,HARD,2,Marcos Ondruska,Grant Stafford,Marcos Ondruska,6-3; 4-6; 6-2,R64,110,6,2,50,91,32,50,22,41,5,8,13,54,91,5,7,45,86,32,45,17,41,5,11,14,49,86
1995-08-14 00:00:00.000,Indianapolis IN; U.S.A. ATP World Tour,HARD,2,Goran Ivanisevic,N/A Bye,Goran Ivanisevic,,R64,0,0,0,0,0,0,0,0,0,0,0,0,0,0,0,0,0,0,0,0,0,0,0,0,0,0,0
1995-08-14 00:00:00.000,Indianapolis IN; U.S.A. ATP World Tour,HARD,2,Pete Sampras,Vincent Spadea,Pete Sampras,7-5; 6-4,R32,76,11,1,29,57,27,29,18,28,0,0,11,45,57,9,1,39,56,27,39,12,17,1,3,11,39,56
1995-08-14 00:00:00.000,Indianapolis IN; U.S.A. ATP World Tour,HARD,2,Jan Apell,Tim Henman,Jan Apell,6-3; 6-1,R32,53,2,0,25,36,22,25,10,11,0,0,8,32,36,2,2,23,48,13,23,10,25,0,4,8,23,48
1995-08-14 00:00:00.000,Indianapolis IN; U.S.A. ATP World Tour,HARD,2,Todd Woodbridge,Michael Tebbutt,Todd Woodbridge,1-6; 6-3; 7-6(4),R32,127,3,3,70,109,45,70,23,39,9,12,14,68,109,14,7,43,88,37,43,23,45,5,7,14,60,88
1995-08-14 00:00:00.000,Indianapolis IN; U.S.A. ATP World Tour,HARD,2,Andrei Medvedev,Chris Woodruff,Andrei Medvedev,7-5; 6-3,R32,95,7,5,30,70,24,30,15,40,6,10,10,39,70,1,7,39,76,21,39,16,37,3,10,11,37,76
1995-08-14 00:00:00.000,Indianapolis IN; U.S.A. ATP World Tour,HARD,2,Richey Reneberg,Wayne Ferreira,Richey Reneberg,6-4; 7-6(4),R32,90,1,5,35,75,28,35,22,40,3,5,11,50,75,12,3,43,75,32,43,15,32,4,7,11,47,75
1995-08-14 00:00:00.000,Indianapolis IN; U.S.A. ATP World Tour,HARD,2,Guy Forget,Sandon Stolle,Guy Forget,7-6(0); 6-3,R32,89,4,0,34,60,28,34,17,26,3,3,10,45,60,7,5,48,82,34,48,15,34,1,3,11,49,82
1995-08-14 00:00:00.000,Indianapolis IN; U.S.A. ATP World Tour,HARD,2,Bernd Karbacher,Jordi Burillo,Bernd Karbacher,6-7(5); 6-1; 6-1,R32,97,9,2,44,76,32,44,20,32,0,2,13,52,76,2,5,53,99,30,53,20,46,10,17,13,50,99
1995-08-14 00:00:00.000,Indianapolis IN; U.S.A. ATP World Tour,HARD,2,Todd Martin,Jonathan Stark,Todd Martin,7-5; 6-3,R32,90,5,5,42,66,30,42,14,24,5,6,11,44,66,4,2,26,63,20,26,16,37,1,4,10,36,63
1995-08-14 00:00:00.000,Indianapolis IN; U.S.A. ATP World Tour,HARD,2,Jerome Golmard,Jim Courier,Jerome Golmard,6-7(5); 6-4; 7-6(1),R32,159,11,6,86,132,60,86,24,46,8,10,17,84,132,18,10,67,110,51,67,19,43,2,5,17,70,110
1995-08-14 00:00:00.000,Indianapolis IN; U.S.A. ATP World Tour,HARD,2,Nicklas Kulti,Renzo Furlan,Nicklas Kulti,6-1; 6-2,R32,58,3,3,19,43,18,19,15,24,0,0,8,33,43,5,2,23,44,18,23,3,21,2,6,7,21,44
1995-08-14 00:00:00.000,Indianapolis IN; U.S.A. ATP World Tour,HARD,2,Cristiano Caratti,Mark Woodforde,Cristiano Caratti,6-4 RET,R32,47,1,3,23,40,15,23,8,17,4,5,5,23,40,1,5,24,41,14,24,8,17,6,8,6,22,41
1995-08-14 00:00:00.000,Indianapolis IN; U.S.A. ATP World Tour,HARD,2,Thomas Enqvist,Jeff Tarango,Thomas Enqvist,7-5; 6-1,R32,60,5,3,30,56,24,30,17,26,0,0,10,41,56,4,1,23,44,16,23,11,21,0,3,9,27,44
1995-08-14 00:00:00.000,Indianapolis IN; U.S.A. ATP World Tour,HARD,2,Alberto Berasategui,Lionel Roux,Alberto Berasategui,7-6(3); 2-6; 6-3,R32,121,3,3,65,96,48,65,12,31,4,9,15,60,96,6,4,75,110,43,75,19,35,6,10,14,62,110
1995-08-14 00:00:00.000,Indianapolis IN; U.S.A. ATP World Tour,HARD,2,Petr Korda,Jonas Bjorkman,Petr Korda,7-5; 6-2,R32,83,1,8,50,81,31,50,17,31,11,13,10,48,81,4,5,29,58,18,29,12,29,4,9,10,30,58
1995-08-14 00:00:00.000,Indianapolis IN; U.S.A. ATP World Tour,HARD,2,Brett Steven,Greg Rusedski,Brett Steven,7-6(5); 4-1 RET,R32,79,1,2,31,53,21,31,14,22,1,3,9,35,53,6,7,33,66,25,33,11,33,2,6,9,36,66
1995-08-14 00:00:00.000,Indianapolis IN; U.S.A. ATP World Tour,HARD,2,Goran Ivanisevic,Marcos Ondruska,Goran Ivanisevic,6-4; 6-2,R32,54,12,2,24,53,23,24,16,29,1,1,9,39,53,3,2,27,41,21,27,5,14,0,3,9,26,41
1995-08-14 00:00:00.000,Indianapolis IN; U.S.A. ATP World Tour,HARD,2,Pete Sampras,Jan Apell,Pete Sampras,6-3; 6-4,R16,66,11,1,27,54,23,27,20,27,2,2,10,43,54,3,2,34,55,24,34,12,21,3,5,9,36,55
1995-08-14 00:00:00.000,Indianapolis IN; U.S.A. ATP World Tour,HARD,2,Andrei Medvedev,Todd Woodbridge,Andrei Medvedev,6-4; 7-6(2),R16,81,8,6,39,74,28,39,19,35,6,8,11,47,74,1,5,37,74,21,37,19,37,6,9,11,40,74
1995-08-14 00:00:00.000,Indianapolis IN; U.S.A. ATP World Tour,HARD,2,Richey Reneberg,Guy Forget,Richey Reneberg,7-6(5); 6-4,R16,81,3,2,36,72,28,36,23,36,2,2,11,51,72,9,1,36,59,27,36,17,23,1,2,11,44,59
1995-08-14 00:00:00.000,Indianapolis IN; U.S.A. ATP World Tour,HARD,2,Bernd Karbacher,Todd Martin,Bernd Karbacher,6-3; 6-2,R16,69,6,2,35,56,25,35,12,21,2,3,9,37,56,3,3,29,50,16,29,10,21,4,8,8,26,50
1995-08-14 00:00:00.000,Indianapolis IN; U.S.A. ATP World Tour,HARD,2,Jerome Golmard,Nicklas Kulti,Jerome Golmard,6-4; 6-1,R16,70,4,5,26,53,22,26,16,27,1,1,9,38,53,4,2,26,44,14,26,13,18,2,5,8,27,44
1995-08-14 00:00:00.000,Indianapolis IN; U.S.A. ATP World Tour,HARD,2,Thomas Enqvist,Cristiano Caratti,Thomas Enqvist,6-0; 3-6; 6-0,R16,74,8,4,29,62,21,29,19,33,2,5,11,40,62,2,6,42,68,21,42,9,26,7,14,10,30,68
1995-08-14 00:00:00.000,Indianapolis IN; U.S.A. ATP World Tour,HARD,2,Alberto Berasategui,Petr Korda,Alberto Berasategui,7-6(7); 6-3,R16,82,2,0,58,77,42,58,12,19,7,8,11,54,77,9,5,40,66,33,40,11,26,4,6,10,44,66
1995-08-14 00:00:00.000,Indianapolis IN; U.S.A. ATP World Tour,HARD,2,Goran Ivanisevic,Brett Steven,Goran Ivanisevic,6-4; 3-6; 6-3,R16,114,19,3,47,91,41,47,20,44,5,6,14,61,91,7,3,49,87,39,49,19,38,2,4,14,58,87
1995-08-14 00:00:00.000,Indianapolis IN; U.S.A. ATP World Tour,HARD,2,Pete Sampras,Andrei Medvedev,Pete Sampras,6-2; 6-2,Q,68,6,2,21,44,19,21,14,23,0,0,8,33,44,3,5,37,74,23,37,15,37,13,17,8,38,74
1995-08-14 00:00:00.000,Indianapolis IN; U.S.A. ATP World Tour,HARD,2,Bernd Karbacher,Richey Reneberg,Bernd Karbacher,7-6(3); 7-5,Q,121,10,6,46,83,36,46,19,37,4,6,12,55,83,3,5,36,86,25,36,26,50,11,14,12,51,86
1995-08-14 00:00:00.000,Indianapolis IN; U.S.A. ATP World Tour,HARD,2,Thomas Enqvist,Jerome Golmard,Thomas Enqvist,6-3; 6-1,Q,56,10,2,22,42,19,22,14,20,2,2,8,33,42,2,4,24,50,14,24,8,26,2,6,8,22,50
1995-08-14 00:00:00.000,Indianapolis IN; U.S.A. ATP World Tour,HARD,2,Goran Ivanisevic,Alberto Berasategui,Goran Ivanisevic,6-4; 6-4,Q,55,14,3,38,53,33,38,8,15,0,0,10,41,53,2,3,42,59,29,42,7,17,2,4,10,36,59
1995-08-14 00:00:00.000,Indianapolis IN; U.S.A. ATP World Tour,HARD,2,Bernd Karbacher,Pete Sampras,Bernd Karbacher,4-6; 6-4; 6-1,S,106,10,5,35,83,31,35,26,48,2,3,14,57,83,13,5,35,73,27,35,21,38,2,5,13,48,73
1995-08-14 00:00:00.000,Indianapolis IN; U.S.A. ATP World Tour,HARD,2,Thomas Enqvist,Goran Ivanisevic,Thomas Enqvist,6-1; 1-6; 6-3,S,75,14,2,38,69,30,38,17,31,3,5,12,47,69,12,7,27,69,22,27,21,42,4,7,11,43,69
1995-08-14 00:00:00.000,Indianapolis IN; U.S.A. ATP World Tour,HARD,2,Thomas Enqvist,Bernd Karbacher,Thomas Enqvist,6-4; 6-3,F,76,3,6,28,49,24,28,11,21,0,1,9,35,49,3,4,40,71,24,40,13,31,2,6,10,37,71
1995-08-14 00:00:00.000,New Haven CT; U.S.A. ATP World Tour,HARD,2,Andre Agassi,N/A Bye,Andre Agassi,,R64,0,0,0,0,0,0,0,0,0,0,0,0,0,0,0,0,0,0,0,0,0,0,0,0,0,0,0
1995-08-14 00:00:00.000,New Haven CT; U.S.A. ATP World Tour,HARD,2,Fernando Meligeni,Luke Jensen,Fernando Meligeni,1-6; 6-3; 7-6(7),R64,113,4,7,74,115,45,74,21,41,9,13,14,66,115,6,6,57,92,38,57,19,35,6,9,14,57,92
1995-08-14 00:00:00.000,New Haven CT; U.S.A. ATP World Tour,HARD,2,Steve Campbell,Mark Petchey,Steve Campbell,6-4; 6-1,R64,62,0,3,34,58,26,34,15,24,6,7,9,41,58,0,0,30,48,17,30,8,18,2,6,8,25,48
1995-08-14 00:00:00.000,New Haven CT; U.S.A. ATP World Tour,HARD,2,Patrick Rafter,Mark Philippoussis,Patrick Rafter,6-4; 7-5,R64,86,10,3,43,63,32,43,13,20,1,1,11,45,63,18,12,39,82,36,39,14,43,6,8,11,50,82
1995-08-14 00:00:00.000,New Haven CT; U.S.A. ATP World Tour,HARD,2,Wayne Black,Jacco Eltingh,Wayne Black,6-3; 6-3,R64,75,3,5,31,69,24,31,22,38,4,4,9,46,69,7,6,24,55,16,24,15,31,1,4,9,31,55
1995-08-14 00:00:00.000,New Haven CT; U.S.A. ATP World Tour,HARD,2,Chris Wilkinson,Jared Palmer,Chris Wilkinson,7-5; 3-6; 6-3,R64,120,5,2,50,94,41,50,21,44,7,9,15,62,94,5,5,46,92,33,46,26,46,6,9,15,59,92
1995-08-14 00:00:00.000,New Haven CT; U.S.A. ATP World Tour,HARD,2,Daniel Vacek,Piet Norval,Daniel Vacek,6-3; 6-4,R64,73,5,3,45,66,31,45,13,21,1,2,10,44,66,3,7,30,64,24,30,12,34,6,9,9,36,64
1995-08-14 00:00:00.000,New Haven CT; U.S.A. ATP World Tour,HARD,2,Sergi Bruguera,N/A Bye,Sergi Bruguera,,R64,0,0,0,0,0,0,0,0,0,0,0,0,0,0,0,0,0,0,0,0,0,0,0,0,0,0,0
1995-08-14 00:00:00.000,New Haven CT; U.S.A. ATP World Tour,HARD,2,Michael Chang,N/A Bye,Michael Chang,,R64,0,0,0,0,0,0,0,0,0,0,0,0,0,0,0,0,0,0,0,0,0,0,0,0,0,0,0
1995-08-14 00:00:00.000,New Haven CT; U.S.A. ATP World Tour,HARD,2,Kenneth Carlsen,Gianluca Pozzi,Kenneth Carlsen,6-4; 3-6; 7-6(2),R64,133,6,2,62,102,44,62,22,40,5,8,15,66,102,2,0,63,108,46,63,20,45,10,13,16,66,108
1995-08-14 00:00:00.000,New Haven CT; U.S.A. ATP World Tour,HARD,2,Mats Wilander,Jim Pugh,Mats Wilander,6-0; 6-2,R64,46,1,3,25,35,22,25,3,10,0,1,7,25,35,0,4,11,31,4,11,3,20,1,7,7,7,31
1995-08-14 00:00:00.000,New Haven CT; U.S.A. ATP World Tour,HARD,2,Jan Siemerink,Shuzo Matsuoka,Jan Siemerink,6-4; 6-4,R64,95,1,4,36,72,26,36,21,36,5,5,10,47,72,8,4,44,64,33,44,8,20,3,5,10,41,64
1995-08-14 00:00:00.000,New Haven CT; U.S.A. ATP World Tour,HARD,2,MaliVai Washington,Andrei Chesnokov,MaliVai Washington,6-3; 6-1,R64,77,6,3,38,56,27,38,7,18,4,6,8,34,56,2,2,44,80,21,44,14,36,9,15,8,35,80
1995-08-14 00:00:00.000,New Haven CT; U.S.A. ATP World Tour,HARD,2,Nicolas Pereira,Adrian Voinea,Nicolas Pereira,6-4; 6-1,R64,50,4,1,19,38,15,19,14,19,0,1,8,29,38,1,1,39,60,20,39,9,21,9,14,9,29,60
1995-08-14 00:00:00.000,New Haven CT; U.S.A. ATP World Tour,HARD,2,Ellis Ferreira,Rob Givone,Ellis Ferreira,4-6; 6-1; 6-3,R64,89,5,6,50,90,38,50,19,40,5,7,13,57,90,2,9,34,72,21,34,20,38,5,10,13,41,72
1995-08-14 00:00:00.000,New Haven CT; U.S.A. ATP World Tour,HARD,2,Marc Rosset,N/A Bye,Marc Rosset,,R64,0,0,0,0,0,0,0,0,0,0,0,0,0,0,0,0,0,0,0,0,0,0,0,0,0,0,0
1995-08-14 00:00:00.000,New Haven CT; U.S.A. ATP World Tour,HARD,2,Michael Stich,N/A Bye,Michael Stich,,R64,0,0,0,0,0,0,0,0,0,0,0,0,0,0,0,0,0,0,0,0,0,0,0,0,0,0,0
1995-08-14 00:00:00.000,New Haven CT; U.S.A. ATP World Tour,HARD,2,Albert Chang,Scott Humphries,Albert Chang,7-6(4); 3-6; 7-5,R64,139,2,4,75,118,52,75,19,43,14,19,17,71,118,8,5,51,91,41,51,19,40,2,6,16,60,91
1995-08-14 00:00:00.000,New Haven CT; U.S.A. ATP World Tour,HARD,2,Jakob Hlasek,Marcelo Charpentier,Jakob Hlasek,6-1; 6-4,R64,64,3,6,31,60,22,31,14,29,6,8,9,36,60,2,1,28,49,14,28,9,21,3,8,8,23,49
1995-08-14 00:00:00.000,New Haven CT; U.S.A. ATP World Tour,HARD,2,Arnaud Boetsch,Stefano Pescosolido,Arnaud Boetsch,6-3; 6-2,R64,52,4,1,27,40,23,27,9,13,0,0,8,32,40,2,7,24,54,16,24,12,30,3,7,9,28,54
1995-08-14 00:00:00.000,New Haven CT; U.S.A. ATP World Tour,HARD,2,Marcelo Rios,Leander Paes,Marcelo Rios,1-6; 6-1; 6-4,R64,80,2,4,41,74,30,41,17,33,5,8,12,47,74,6,7,41,68,31,41,11,27,2,6,12,42,68
1995-08-14 00:00:00.000,New Haven CT; U.S.A. ATP World Tour,HARD,2,Daniele Musa,Louis Gloria,Daniele Musa,6-4; 4-6; 6-4,R64,122,2,2,68,114,44,68,23,46,9,13,15,67,114,4,5,57,92,33,57,20,35,6,11,15,53,92
1995-08-14 00:00:00.000,New Haven CT; U.S.A. ATP World Tour,HARD,2,Marc-Kevin Goellner,Thierry Guardiola,Marc-Kevin Goellner,6-4; 6-3,R64,67,5,5,31,47,28,31,9,16,0,0,9,37,47,5,4,28,68,17,28,22,40,10,13,10,39,68
1995-08-14 00:00:00.000,New Haven CT; U.S.A. ATP World Tour,HARD,2,Yevgeny Kafelnikov,N/A Bye,Yevgeny Kafelnikov,,R64,0,0,0,0,0,0,0,0,0,0,0,0,0,0,0,0,0,0,0,0,0,0,0,0,0,0,0
1995-08-14 00:00:00.000,New Haven CT; U.S.A. ATP World Tour,HARD,2,Richard Krajicek,N/A Bye,Richard Krajicek,,R64,0,0,0,0,0,0,0,0,0,0,0,0,0,0,0,0,0,0,0,0,0,0,0,0,0,0,0
1995-08-14 00:00:00.000,New Haven CT; U.S.A. ATP World Tour,HARD,2,Derrick Rostagno,Michael Joyce,Derrick Rostagno,5-7; 6-4; 6-4,R64,122,5,13,58,110,41,58,22,52,6,10,16,63,110,2,8,56,110,37,56,25,54,11,16,16,62,110
1995-08-14 00:00:00.000,New Haven CT; U.S.A. ATP World Tour,HARD,2,Byron Black,Jim Grabb,Byron Black,6-1; 6-2,R64,68,0,3,22,44,15,22,15,22,3,4,8,30,44,6,3,29,55,16,29,7,26,4,9,7,23,55
1995-08-14 00:00:00.000,New Haven CT; U.S.A. ATP World Tour,HARD,2,Paul Haarhuis,Andrei Olhovskiy,Paul Haarhuis,7-6(3); 6-3,R64,85,6,1,41,79,30,41,23,38,5,6,11,53,79,7,6,24,66,18,24,21,42,3,5,10,39,66
1995-08-14 00:00:00.000,New Haven CT; U.S.A. ATP World Tour,HARD,2,Patrick McEnroe,Mauricio Hadad,Patrick McEnroe,6-1; 6-2,R64,63,4,4,30,62,20,30,19,32,8,9,8,39,62,2,3,24,39,13,24,2,15,0,5,7,15,39
1995-08-14 00:00:00.000,New Haven CT; U.S.A. ATP World Tour,HARD,2,Paul Wekesa,Jan Kroslak,Paul Wekesa,6-1; 6-7(5); 6-2,R64,111,7,10,47,88,36,47,24,41,1,2,14,60,88,7,4,58,88,35,58,14,30,6,11,13,49,88
1995-08-14 00:00:00.000,New Haven CT; U.S.A. ATP World Tour,HARD,2,Rodolphe Gilbert,Jeff Salzenstein,Rodolphe Gilbert,6-4; 6-3,R64,78,5,2,37,70,26,37,18,33,7,8,9,44,70,7,2,34,62,24,34,10,28,6,10,10,34,62
1995-08-14 00:00:00.000,New Haven CT; U.S.A. ATP World Tour,HARD,2,Boris Becker,N/A Bye,Boris Becker,,R64,0,0,0,0,0,0,0,0,0,0,0,0,0,0,0,0,0,0,0,0,0,0,0,0,0,0,0
1995-08-14 00:00:00.000,New Haven CT; U.S.A. ATP World Tour,HARD,2,Andre Agassi,Fernando Meligeni,Andre Agassi,6-4; 7-5,R32,79,4,4,42,68,32,42,13,26,4,6,11,45,68,6,2,31,62,20,31,16,31,4,8,11,36,62
1995-08-14 00:00:00.000,New Haven CT; U.S.A. ATP World Tour,HARD,2,Patrick Rafter,Steve Campbell,Patrick Rafter,6-4; 6-2,R32,68,10,1,31,49,27,31,12,18,1,1,9,39,49,0,2,41,69,27,41,14,28,9,12,9,41,69
1995-08-14 00:00:00.000,New Haven CT; U.S.A. ATP World Tour,HARD,2,Wayne Black,Chris Wilkinson,Wayne Black,6-4; 4-6; 6-3,R32,125,5,1,54,85,37,54,23,31,3,5,15,60,85,7,3,58,99,40,58,17,41,8,11,14,57,99
1995-08-14 00:00:00.000,New Haven CT; U.S.A. ATP World Tour,HARD,2,Sergi Bruguera,Daniel Vacek,Sergi Bruguera,6-3; 4-6; 7-6(2),R32,105,1,3,59,92,41,59,16,33,2,6,15,57,92,12,3,54,93,43,54,15,39,3,8,16,58,93
1995-08-14 00:00:00.000,New Haven CT; U.S.A. ATP World Tour,HARD,2,Kenneth Carlsen,Michael Chang,Kenneth Carlsen,7-5; 6-4,R32,102,7,3,40,82,34,40,22,42,11,11,11,56,82,5,3,28,71,22,28,24,43,2,4,11,46,71
1995-08-14 00:00:00.000,New Haven CT; U.S.A. ATP World Tour,HARD,2,Mats Wilander,Jan Siemerink,Mats Wilander,6-4; 6-4,R32,81,2,2,56,69,42,56,6,13,5,5,10,48,69,2,6,23,59,20,23,17,36,1,3,10,37,59
1995-08-14 00:00:00.000,New Haven CT; U.S.A. ATP World Tour,HARD,2,Nicolas Pereira,MaliVai Washington,Nicolas Pereira,6-3; 6-2,R32,64,7,3,48,66,36,48,8,18,5,5,9,44,66,4,1,22,42,17,22,6,20,1,4,8,23,42
1995-08-14 00:00:00.000,New Haven CT; U.S.A. ATP World Tour,HARD,2,Marc Rosset,Ellis Ferreira,Marc Rosset,7-6(0); 6-3,R32,77,15,4,36,68,32,36,18,32,0,1,11,50,68,7,8,31,61,28,31,9,30,1,3,10,37,61
1995-08-14 00:00:00.000,New Haven CT; U.S.A. ATP World Tour,HARD,2,Albert Chang,Michael Stich,Albert Chang,4-6; 6-3 RET,R32,70,3,3,36,61,30,36,13,25,2,3,10,43,61,7,3,33,57,26,33,12,24,1,2,10,38,57
1995-08-14 00:00:00.000,New Haven CT; U.S.A. ATP World Tour,HARD,2,Arnaud Boetsch,Jakob Hlasek,Arnaud Boetsch,6-2; 6-4,R32,62,1,5,35,52,29,35,7,17,2,3,9,36,52,3,2,26,54,17,26,14,28,1,5,9,31,54
1995-08-14 00:00:00.000,New Haven CT; U.S.A. ATP World Tour,HARD,2,Marcelo Rios,Daniele Musa,Marcelo Rios,6-2; 6-4,R32,58,5,2,33,52,24,33,13,19,1,2,9,37,52,0,3,31,60,15,31,15,29,2,6,9,30,60
1995-08-14 00:00:00.000,New Haven CT; U.S.A. ATP World Tour,HARD,2,Yevgeny Kafelnikov,Marc-Kevin Goellner,Yevgeny Kafelnikov,6-1; 6-3,R32,49,9,0,26,43,22,26,9,17,0,1,8,31,43,9,2,21,51,14,21,11,30,4,9,8,25,51
1995-08-14 00:00:00.000,New Haven CT; U.S.A. ATP World Tour,HARD,2,Richard Krajicek,Derrick Rostagno,Richard Krajicek,6-2; 6-2,R32,49,7,0,20,44,18,20,16,24,0,0,8,34,44,0,2,24,45,13,24,9,21,1,5,8,22,45
1995-08-14 00:00:00.000,New Haven CT; U.S.A. ATP World Tour,HARD,2,Paul Haarhuis,Byron Black,Paul Haarhuis,6-4; 3-6; 6-3,R32,108,8,4,50,95,38,50,23,45,5,7,14,61,95,3,4,54,89,40,54,16,35,4,7,14,56,89
1995-08-14 00:00:00.000,New Haven CT; U.S.A. ATP World Tour,HARD,2,Patrick McEnroe,Paul Wekesa,Patrick McEnroe,6-1; 6-3,R32,70,3,2,28,55,22,28,16,27,1,1,8,38,55,4,3,24,45,14,24,11,21,1,5,8,25,45
1995-08-14 00:00:00.000,New Haven CT; U.S.A. ATP World Tour,HARD,2,Boris Becker,Rodolphe Gilbert,Boris Becker,6-4; 6-4,R32,72,3,1,35,51,31,35,10,16,0,0,10,41,51,1,2,36,70,29,36,15,34,6,8,10,44,70
1995-08-14 00:00:00.000,New Haven CT; U.S.A. ATP World Tour,HARD,2,Andre Agassi,Patrick Rafter,Andre Agassi,6-2; 6-4,R16,73,2,1,39,60,26,39,14,21,4,4,9,40,60,9,2,35,62,23,35,13,27,1,4,9,36,62
1995-08-14 00:00:00.000,New Haven CT; U.S.A. ATP World Tour,HARD,2,Sergi Bruguera,Wayne Black,Sergi Bruguera,2-6; 6-3; 7-5,R16,114,3,3,57,90,37,57,20,33,5,7,14,57,90,5,1,60,93,41,60,19,33,4,7,15,60,93
1995-08-14 00:00:00.000,New Haven CT; U.S.A. ATP World Tour,HARD,2,Mats Wilander,Kenneth Carlsen,Mats Wilander,6-7(6); 6-3; 7-6(2),R16,171,5,4,75,110,53,75,22,35,7,9,17,75,110,13,6,70,130,53,70,26,60,9,12,16,79,130
1995-08-14 00:00:00.000,New Haven CT; U.S.A. ATP World Tour,HARD,2,Marc Rosset,Nicolas Pereira,Marc Rosset,6-4; 6-3,R16,59,3,0,28,50,23,28,15,22,0,0,9,38,50,8,6,30,50,24,30,9,20,1,4,10,33,50
1995-08-14 00:00:00.000,New Haven CT; U.S.A. ATP World Tour,HARD,2,Albert Chang,Arnaud Boetsch,Albert Chang,7-5; 6-2,R16,76,4,4,43,67,32,43,15,24,5,5,10,47,67,3,3,31,61,21,31,15,30,4,7,10,36,61
1995-08-14 00:00:00.000,New Haven CT; U.S.A. ATP World Tour,HARD,2,Yevgeny Kafelnikov,Marcelo Rios,Yevgeny Kafelnikov,6-3; 7-6(2),R16,75,5,3,47,72,34,47,15,25,2,4,11,49,72,5,3,32,71,20,32,20,39,3,6,10,40,71
1995-08-14 00:00:00.000,New Haven CT; U.S.A. ATP World Tour,HARD,2,Richard Krajicek,Paul Haarhuis,Richard Krajicek,4-6; 6-4; 7-5,R16,109,10,7,60,100,46,60,19,40,6,8,16,65,100,2,3,63,95,46,63,16,32,2,5,16,62,95
1995-08-14 00:00:00.000,New Haven CT; U.S.A. ATP World Tour,HARD,2,Boris Becker,Patrick McEnroe,Boris Becker,3-6; 7-6(2); 6-4,R16,138,18,3,56,84,51,56,9,28,2,4,15,60,84,5,4,72,117,47,72,24,45,6,8,16,71,117
1995-08-14 00:00:00.000,New Haven CT; U.S.A. ATP World Tour,HARD,2,Andre Agassi,Sergi Bruguera,Andre Agassi,6-4; 6-1,Q,63,1,0,32,46,23,32,10,14,0,0,8,33,46,5,2,40,65,25,40,10,25,7,11,9,35,65
1995-08-14 00:00:00.000,New Haven CT; U.S.A. ATP World Tour,HARD,2,Mats Wilander,Marc Rosset,Mats Wilander,6-7(8); 7-5; 7-5,Q,170,3,0,107,139,72,107,16,32,9,11,18,88,139,11,2,59,105,45,59,25,46,1,5,18,70,105
1995-08-14 00:00:00.000,New Haven CT; U.S.A. ATP World Tour,HARD,2,Yevgeny Kafelnikov,Albert Chang,Yevgeny Kafelnikov,6-3; 6-2,Q,55,2,2,30,48,24,30,10,18,1,2,9,34,48,3,2,38,53,23,38,4,15,5,9,8,27,53
1995-08-14 00:00:00.000,New Haven CT; U.S.A. ATP World Tour,HARD,2,Richard Krajicek,Boris Becker,Richard Krajicek,7-6(5); 3-6; 7-6(5),Q,127,9,1,68,104,51,68,18,36,3,7,16,69,104,12,5,76,107,59,76,13,31,5,8,17,72,107
1995-08-14 00:00:00.000,New Haven CT; U.S.A. ATP World Tour,HARD,2,Andre Agassi,Mats Wilander,Andre Agassi,6-3; 6-3,S,77,2,1,26,48,19,26,12,22,1,3,9,31,48,7,1,47,77,29,47,7,30,8,13,9,36,77
1995-08-14 00:00:00.000,New Haven CT; U.S.A. ATP World Tour,HARD,2,Richard Krajicek,Yevgeny Kafelnikov,Richard Krajicek,6-4; 6-4,S,69,16,2,44,67,31,44,12,23,3,4,10,43,67,6,2,38,61,24,38,12,23,2,5,10,36,61
1995-08-14 00:00:00.000,New Haven CT; U.S.A. ATP World Tour,HARD,2,Andre Agassi,Richard Krajicek,Andre Agassi,3-6; 7-6(2); 6-3,F,114,8,3,50,91,35,50,19,41,4,9,14,54,91,19,7,46,103,33,46,24,57,5,11,16,57,103
1995-08-21 00:00:00.000,Long Island NY; U.S.A. ATP World Tour,HARD,2,Yevgeny Kafelnikov,Olivier Delaitre,Yevgeny Kafelnikov,6-1; 6-3,R32,54,3,1,17,45,15,17,18,28,1,1,8,33,45,1,5,23,52,11,23,14,29,3,7,8,25,52
1995-08-21 00:00:00.000,Long Island NY; U.S.A. ATP World Tour,HARD,2,Alexander Volkov,Karel Novacek,Alexander Volkov,3-6; 6-3; 6-3,R32,103,4,4,40,77,29,40,22,37,6,8,13,51,77,7,2,46,85,33,46,18,39,1,5,14,51,85
1995-08-21 00:00:00.000,Long Island NY; U.S.A. ATP World Tour,HARD,2,Shuzo Matsuoka,Bernd Karbacher,Shuzo Matsuoka,6-4; 7-6(7),R32,82,11,1,45,61,38,45,12,16,0,0,11,50,61,3,2,57,86,43,57,13,29,7,8,11,56,86
1995-08-21 00:00:00.000,Long Island NY; U.S.A. ATP World Tour,HARD,2,Andrei Chesnokov,Alex Corretja,Andrei Chesnokov,6-2; 6-1,R32,53,1,0,22,36,19,22,9,14,0,0,7,28,36,2,1,34,55,18,34,8,21,2,7,8,26,55
1995-08-21 00:00:00.000,Long Island NY; U.S.A. ATP World Tour,HARD,2,Marc Rosset,Martin Damm,Marc Rosset,6-4; 6-1,R32,58,3,0,25,46,17,25,16,21,3,4,8,33,46,3,4,26,54,14,26,12,28,6,11,9,26,54
1995-08-21 00:00:00.000,Long Island NY; U.S.A. ATP World Tour,HARD,2,Arnaud Boetsch,Petr Korda,Arnaud Boetsch,6-3; 5-7; 6-2,R32,126,7,2,68,117,48,68,24,49,12,14,15,72,117,2,9,50,90,37,50,18,40,6,10,14,55,90
1995-08-21 00:00:00.000,Long Island NY; U.S.A. ATP World Tour,HARD,2,Cedric Pioline,Jason Stoltenberg,Cedric Pioline,4-6; 7-6(7); 7-6(6),R32,156,3,5,65,108,52,65,20,43,1,4,17,72,108,12,6,69,109,51,69,22,40,4,6,17,73,109
1995-08-21 00:00:00.000,Long Island NY; U.S.A. ATP World Tour,HARD,2,Michael Joyce,Jacco Eltingh,Michael Joyce,6-4; 6-3,R32,72,3,4,41,69,28,41,14,28,3,4,9,42,69,11,9,32,68,24,32,12,36,2,6,10,36,68
1995-08-21 00:00:00.000,Long Island NY; U.S.A. ATP World Tour,HARD,2,MaliVai Washington,Stefan Edberg,MaliVai Washington,6-1; 6-4,R32,60,6,2,37,60,28,37,13,23,2,2,9,41,60,0,2,25,39,19,25,5,14,0,3,8,24,39
1995-08-21 00:00:00.000,Long Island NY; U.S.A. ATP World Tour,HARD,2,Marcelo Rios,Daniel Vacek,Marcelo Rios,7-5; 6-4,R32,65,4,1,37,56,30,37,14,19,0,0,11,44,56,7,5,44,74,32,44,14,30,4,6,11,46,74
1995-08-21 00:00:00.000,Long Island NY; U.S.A. ATP World Tour,HARD,2,Renzo Furlan,Adrian Voinea,Renzo Furlan,6-7(5); 7-5; 6-0,R32,123,7,10,50,108,38,50,30,58,9,11,15,68,108,9,3,58,92,40,58,13,34,2,8,15,53,92
1995-08-21 00:00:00.000,Long Island NY; U.S.A. ATP World Tour,HARD,2,Andrei Medvedev,Richey Reneberg,Andrei Medvedev,6-2; 6-4,R32,74,7,4,44,75,33,44,15,31,7,7,9,48,75,1,4,28,57,17,28,14,29,2,5,9,31,57
1995-08-21 00:00:00.000,Long Island NY; U.S.A. ATP World Tour,HARD,2,Karol Kucera,Jonas Bjorkman,Karol Kucera,4-6; 7-6(4); 7-6(4),R32,148,3,9,53,112,35,53,26,59,3,10,17,61,112,2,3,75,128,44,75,23,53,9,15,17,67,128
1995-08-21 00:00:00.000,Long Island NY; U.S.A. ATP World Tour,HARD,2,Todd Woodbridge,Mark Woodforde,Todd Woodbridge,6-3; 4-6; 5-3 RET,R32,124,4,4,55,91,40,55,16,36,8,11,14,56,91,1,11,51,100,37,51,18,49,5,10,14,55,100
1995-08-21 00:00:00.000,Long Island NY; U.S.A. ATP World Tour,HARD,2,Paul Haarhuis,Marcelo Charpentier,Paul Haarhuis,2-6; 7-5; 6-3,R32,122,10,4,59,102,41,59,20,43,4,8,15,61,102,0,1,67,99,40,67,16,32,6,10,14,56,99
1995-08-21 00:00:00.000,Long Island NY; U.S.A. ATP World Tour,HARD,2,Jan Siemerink,Wayne Ferreira,Jan Siemerink,6-3; 2-6; 6-4,R32,96,2,6,45,90,29,45,23,45,5,9,14,52,90,5,3,39,74,24,39,21,35,2,6,13,45,74
1995-08-21 00:00:00.000,Long Island NY; U.S.A. ATP World Tour,HARD,2,Yevgeny Kafelnikov,Alexander Volkov,Yevgeny Kafelnikov,6-1; 6-2,R16,46,3,1,21,45,20,21,13,24,1,1,8,33,45,2,5,16,44,9,16,11,28,1,5,7,20,44
1995-08-21 00:00:00.000,Long Island NY; U.S.A. ATP World Tour,HARD,2,Shuzo Matsuoka,Andrei Chesnokov,Shuzo Matsuoka,6-2; 6-3,R16,65,3,3,31,55,28,31,13,24,3,3,9,41,55,0,2,32,47,21,32,5,15,2,5,8,26,47
1995-08-21 00:00:00.000,Long Island NY; U.S.A. ATP World Tour,HARD,2,Marc Rosset,Arnaud Boetsch,Marc Rosset,6-2; 7-5,R16,85,4,6,39,74,30,39,17,35,5,6,10,47,74,2,6,30,68,20,30,17,38,7,11,10,37,68
1995-08-21 00:00:00.000,Long Island NY; U.S.A. ATP World Tour,HARD,2,Cedric Pioline,Michael Joyce,Cedric Pioline,6-3; 6-3,R16,75,3,2,38,63,26,38,13,25,1,3,9,39,63,1,5,20,46,14,20,9,26,2,7,9,23,46
1995-08-21 00:00:00.000,Long Island NY; U.S.A. ATP World Tour,HARD,2,MaliVai Washington,Marcelo Rios,MaliVai Washington,6-1; 7-5,R16,69,7,1,33,53,26,33,12,20,1,2,10,38,53,1,1,35,54,19,35,9,19,2,6,9,28,54
1995-08-21 00:00:00.000,Long Island NY; U.S.A. ATP World Tour,HARD,2,Renzo Furlan,Andrei Medvedev,Renzo Furlan,6-4; 6-0,R16,59,1,3,24,47,19,24,13,23,3,4,8,32,47,2,2,20,50,11,20,12,30,3,8,8,23,50
1995-08-21 00:00:00.000,Long Island NY; U.S.A. ATP World Tour,HARD,2,Todd Woodbridge,Karol Kucera,Todd Woodbridge,6-2; 6-1,R16,51,0,1,30,42,23,30,5,12,1,2,7,28,42,2,4,25,44,10,25,8,19,4,10,8,18,44
1995-08-21 00:00:00.000,Long Island NY; U.S.A. ATP World Tour,HARD,2,Jan Siemerink,Paul Haarhuis,Jan Siemerink,7-6(5); 6-4,R16,102,8,1,44,81,34,44,23,37,8,8,11,57,81,3,2,44,76,30,44,19,32,2,3,11,49,76
1995-08-21 00:00:00.000,Long Island NY; U.S.A. ATP World Tour,HARD,2,Yevgeny Kafelnikov,Shuzo Matsuoka,Yevgeny Kafelnikov,5-7; 6-2; 6-2,Q,99,8,4,40,75,37,40,17,35,3,5,14,54,75,6,5,48,84,30,48,18,36,3,8,14,48,84
1995-08-21 00:00:00.000,Long Island NY; U.S.A. ATP World Tour,HARD,2,Marc Rosset,Cedric Pioline,Marc Rosset,7-5; 6-7(3); 6-1,Q,148,4,8,62,113,48,62,23,51,9,11,16,71,113,2,3,53,101,38,53,20,48,10,15,15,58,101
1995-08-21 00:00:00.000,Long Island NY; U.S.A. ATP World Tour,HARD,2,Renzo Furlan,MaliVai Washington,Renzo Furlan,6-4; 1-6; 6-2,Q,123,0,3,53,96,36,53,19,43,5,8,12,55,96,4,1,40,79,26,40,20,39,4,8,13,46,79
1995-08-21 00:00:00.000,Long Island NY; U.S.A. ATP World Tour,HARD,2,Jan Siemerink,Todd Woodbridge,Jan Siemerink,6-4; 6-2,Q,82,3,3,45,69,28,45,14,24,10,11,9,42,69,1,7,40,70,23,40,12,30,4,8,9,35,70
1995-08-21 00:00:00.000,Long Island NY; U.S.A. ATP World Tour,HARD,2,Yevgeny Kafelnikov,Marc Rosset,Yevgeny Kafelnikov,7-6(6); 6-4,S,109,9,5,45,78,27,45,19,33,5,8,11,46,78,5,9,36,96,24,36,28,60,8,12,11,52,96
1995-08-21 00:00:00.000,Long Island NY; U.S.A. ATP World Tour,HARD,2,Jan Siemerink,Renzo Furlan,Jan Siemerink,6-4; 6-3,S,70,5,3,30,49,23,30,13,19,0,2,10,36,49,1,8,35,60,22,35,7,25,4,8,9,29,60
1995-08-21 00:00:00.000,Long Island NY; U.S.A. ATP World Tour,HARD,2,Yevgeny Kafelnikov,Jan Siemerink,Yevgeny Kafelnikov,7-6(0); 6-2,F,76,2,1,33,55,27,33,17,22,0,0,10,44,55,6,1,44,69,25,44,15,25,5,7,10,40,69
1995-08-21 00:00:00.000,Umag Croatia ATP World Tour,CLAY,2,Thomas Muster,Roberto Carretero,Thomas Muster,6-2; 3-0 RET,R32,44,1,1,17,27,15,17,6,10,3,3,6,21,27,2,5,23,47,14,23,8,24,6,10,6,22,47
1995-08-21 00:00:00.000,Umag Croatia ATP World Tour,CLAY,2,Alejo Mancisidor,Johan Van Herck,Alejo Mancisidor,6-4; 1-6; 6-2,R32,127,1,2,49,75,28,49,10,26,6,12,12,38,75,1,9,70,117,40,70,17,47,16,23,13,57,117
1995-08-21 00:00:00.000,Umag Croatia ATP World Tour,CLAY,2,Hernan Gumy,Kris Goossens,Hernan Gumy,6-2; 6-0,R32,71,1,0,30,38,23,30,4,8,0,1,7,27,38,1,2,42,72,22,42,10,30,12,18,7,32,72
1995-08-21 00:00:00.000,Umag Croatia ATP World Tour,CLAY,2,Jordi Arrese,Gaston Etlis,Jordi Arrese,3-6; 7-5; 6-1,R32,128,0,1,62,84,42,62,14,22,6,8,14,56,84,4,2,59,101,39,59,20,42,10,14,14,59,101
1995-08-21 00:00:00.000,Umag Croatia ATP World Tour,CLAY,2,Gilbert Schaller,Sandor Noszaly,Gilbert Schaller,7-6(1); 6-4,R32,99,4,0,48,65,34,48,10,17,3,5,11,44,65,3,3,49,72,30,49,10,23,0,3,11,40,72
1995-08-21 00:00:00.000,Umag Croatia ATP World Tour,CLAY,2,Magnus Gustafsson,Goran Oresic,Magnus Gustafsson,6-2; 6-4,R32,69,2,2,34,57,27,34,12,23,4,5,9,39,57,0,6,27,50,14,27,10,23,0,4,9,24,50
1995-08-21 00:00:00.000,Umag Croatia ATP World Tour,CLAY,2,Alex Lopez Moron,Tomislav Prpic,Alex Lopez Moron,4-6; 7-6(1); 6-1,R32,136,3,5,66,106,46,66,17,40,9,13,15,63,106,6,3,54,102,36,54,19,48,7,12,14,55,102
1995-08-21 00:00:00.000,Umag Croatia ATP World Tour,CLAY,2,Francisco Clavet,Patrick Baur,Francisco Clavet,6-1; 6-2,R32,68,0,0,27,39,20,27,9,12,3,3,7,29,39,4,3,35,71,20,35,15,36,8,13,8,35,71
1995-08-21 00:00:00.000,Umag Croatia ATP World Tour,CLAY,2,Javier Sanchez,Mike Bauer,Javier Sanchez,6-3; 1-6; 6-2,R32,92,1,2,54,76,27,54,13,22,2,7,12,40,76,1,8,41,78,25,41,13,37,8,14,12,38,78
1995-08-21 00:00:00.000,Umag Croatia ATP World Tour,CLAY,2,Wojtek Kowalski,Frederik Fetterlein,Wojtek Kowalski,6-4; 6-2,R32,65,7,0,31,48,25,31,12,17,0,0,9,37,48,1,2,47,60,30,47,3,13,6,9,9,33,60
1995-08-21 00:00:00.000,Umag Croatia ATP World Tour,CLAY,2,Lars Jonsson,Oscar Martinez,Lars Jonsson,3-6; 7-6(4); 6-3,R32,124,1,1,61,112,34,61,30,51,6,10,14,64,112,7,2,58,116,33,58,31,58,9,14,16,64,116
1995-08-21 00:00:00.000,Umag Croatia ATP World Tour,CLAY,2,Andrea Gaudenzi,Jiri Novak,Andrea Gaudenzi,6-3; 6-4,R32,88,4,1,41,81,29,41,20,40,12,13,9,49,81,3,2,33,55,21,33,10,22,4,8,10,31,55
1995-08-21 00:00:00.000,Umag Croatia ATP World Tour,CLAY,2,Carlos Costa,Marcos Aurelio Gorriz,Carlos Costa,7-5; 7-6(3),R32,19,1,1,51,84,30,51,15,33,4,9,12,45,84,0,0,67,96,33,67,16,29,13,19,12,49,96
1995-08-21 00:00:00.000,Umag Croatia ATP World Tour,CLAY,2,Franco Davin,Radomir Vasek,Franco Davin,6-3; 6-7(8); 6-3,R32,136,1,1,64,89,42,64,14,25,2,5,14,56,89,3,17,74,127,51,74,15,53,14,21,16,66,127
1995-08-21 00:00:00.000,Umag Croatia ATP World Tour,CLAY,2,Tomas Carbonell,Emanuel Rasberger,Tomas Carbonell,6-4; 6-0,R32,70,0,5,40,54,25,40,8,14,3,5,8,33,54,0,2,23,47,9,23,8,24,6,12,8,17,47
1995-08-21 00:00:00.000,Umag Croatia ATP World Tour,CLAY,2,Alberto Berasategui,Carlos Moya,Alberto Berasategui,6-3; 2-6; 7-6(3),R32,119,0,3,92,112,52,92,9,20,5,12,15,61,112,0,0,68,98,42,68,11,30,9,15,14,53,98
1995-08-21 00:00:00.000,Umag Croatia ATP World Tour,CLAY,2,Thomas Muster,Alejo Mancisidor,Thomas Muster,6-3; 6-1,R16,54,1,1,22,41,16,22,12,19,0,1,8,28,41,1,2,24,40,10,24,4,16,1,6,8,14,40
1995-08-21 00:00:00.000,Umag Croatia ATP World Tour,CLAY,2,Jordi Arrese,Hernan Gumy,Jordi Arrese,6-4; 1-6; 6-3,R16,119,0,4,54,73,36,54,10,19,0,3,13,46,73,3,7,56,94,38,56,18,38,6,9,13,56,94
1995-08-21 00:00:00.000,Umag Croatia ATP World Tour,CLAY,2,Magnus Gustafsson,Gilbert Schaller,Magnus Gustafsson,6-4; 6-0,R16,67,0,2,38,55,24,38,9,17,1,3,8,33,55,0,0,43,52,18,43,3,9,3,9,8,21,52
1995-08-21 00:00:00.000,Umag Croatia ATP World Tour,CLAY,2,Francisco Clavet,Alex Lopez Moron,Francisco Clavet,3-6; 7-5; 6-3,R16,142,2,4,61,96,37,61,18,35,9,14,15,55,96,2,4,56,96,39,56,13,40,2,8,15,52,96
1995-08-21 00:00:00.000,Umag Croatia ATP World Tour,CLAY,2,Javier Sanchez,Wojtek Kowalski,Javier Sanchez,6-3; 6-4,R16,72,3,0,44,70,30,44,13,26,7,9,10,43,70,1,3,21,53,15,21,13,32,1,5,9,28,53
1995-08-21 00:00:00.000,Umag Croatia ATP World Tour,CLAY,2,Andrea Gaudenzi,Lars Jonsson,Andrea Gaudenzi,6-1; 6-4,R16,68,0,4,31,54,26,31,11,23,2,3,9,37,54,1,2,30,51,16,30,10,21,0,4,8,26,51
1995-08-21 00:00:00.000,Umag Croatia ATP World Tour,CLAY,2,Carlos Costa,Franco Davin,Carlos Costa,6-7(6); 6-4; 6-3,R16,144,6,8,73,133,42,73,26,60,7,14,16,68,133,1,2,76,104,41,76,12,28,15,24,15,53,104
1995-08-21 00:00:00.000,Umag Croatia ATP World Tour,CLAY,2,Alberto Berasategui,Tomas Carbonell,Alberto Berasategui,6-2; 4-6; 6-1,R16,87,1,1,55,71,37,55,11,16,1,3,13,48,71,1,4,45,84,29,45,15,39,10,15,12,44,84
1995-08-21 00:00:00.000,Umag Croatia ATP World Tour,CLAY,2,Thomas Muster,Jordi Arrese,Thomas Muster,6-1; 6-3,Q,65,4,3,25,44,16,25,10,19,2,5,8,26,44,0,4,29,47,12,29,3,18,4,11,8,15,47
1995-08-21 00:00:00.000,Umag Croatia ATP World Tour,CLAY,2,Francisco Clavet,Magnus Gustafsson,Francisco Clavet,6-2; 6-3,Q,60,3,0,30,41,24,30,9,11,0,1,9,33,41,2,6,30,49,18,30,6,19,1,5,8,24,49
1995-08-21 00:00:00.000,Umag Croatia ATP World Tour,CLAY,2,Andrea Gaudenzi,Javier Sanchez,Andrea Gaudenzi,6-2; 6-4,Q,80,0,3,27,54,18,27,21,27,2,2,9,39,54,2,2,43,68,23,43,14,25,3,6,9,37,68
1995-08-21 00:00:00.000,Umag Croatia ATP World Tour,CLAY,2,Carlos Costa,Alberto Berasategui,Carlos Costa,6-4; 6-4,Q,67,2,1,41,63,30,41,8,22,4,7,10,38,63,0,0,48,53,24,48,1,5,2,7,10,25,53
1995-08-21 00:00:00.000,Umag Croatia ATP World Tour,CLAY,2,Thomas Muster,Francisco Clavet,Thomas Muster,7-5; 5-7; 7-6(3),S,163,4,3,73,116,47,73,22,43,10,16,18,69,116,2,3,47,98,29,47,26,51,1,7,18,55,98
1995-08-21 00:00:00.000,Umag Croatia ATP World Tour,CLAY,2,Carlos Costa,Andrea Gaudenzi,Carlos Costa,6-3; 6-4,S,72,3,0,36,54,30,36,12,18,0,0,10,42,54,0,0,28,54,21,28,14,26,1,3,9,35,54
1995-08-21 00:00:00.000,Umag Croatia ATP World Tour,CLAY,2,Thomas Muster,Carlos Costa,Thomas Muster,3-6; 7-6(5); 6-4,F,147,0,1,80,116,43,80,17,36,8,16,15,60,116,7,2,65,110,40,65,17,45,7,15,16,57,110
1995-08-28 00:00:00.000,US Open NY; U.S.A. Grand Slams,HARD,3,Andre Agassi,Bryan Shelton,Andre Agassi,6-2; 6-2; 6-2,R128,4,3,6,48,87,38,48,20,39,6,6,12,58,87,14,9,65,102,44,65,11,37,4,10,12,55,102
1995-08-28 00:00:00.000,US Open NY; U.S.A. Grand Slams,HARD,3,Alex Corretja,Alex O'Brien,Alex Corretja,6-4; 6-4; 6-3,R128,1,2,1,71,95,45,71,15,24,4,6,14,60,95,5,4,67,115,41,67,19,48,4,10,15,60,115
1995-08-28 00:00:00.000,US Open NY; U.S.A. Grand Slams,HARD,3,Daniel Nestor,Andrei Olhovskiy,Daniel Nestor,6-3; 6-4; 3-6; 6-1,R128,2,17,8,81,133,69,81,21,52,7,9,18,90,133,16,8,69,132,56,69,24,63,3,8,17,80,132
1995-08-28 00:00:00.000,US Open NY; U.S.A. Grand Slams,HARD,3,Stefan Edberg,Martin Damm,Stefan Edberg,6-0; 6-3; 7-6(4),R128,3,9,4,45,84,41,45,23,39,0,0,13,64,84,8,3,62,118,42,62,25,56,9,14,14,67,118
1995-08-28 00:00:00.000,US Open NY; U.S.A. Grand Slams,HARD,3,Tim Henman,Juan Albert Viloca-Puig,Tim Henman,6-3; 4-6; 6-4; 6-3,R128,2,5,4,62,115,50,62,27,53,1,3,18,77,115,3,0,71,117,45,71,20,46,7,13,18,65,117
1995-08-28 00:00:00.000,US Open NY; U.S.A. Grand Slams,HARD,3,Jared Palmer,Leonardo Lavalle,Jared Palmer,6-4; 7-5; 6-3,R128,2,6,8,63,121,49,63,25,58,11,13,16,74,121,3,5,58,108,38,58,22,50,6,11,15,60,108
1995-08-28 00:00:00.000,US Open NY; U.S.A. Grand Slams,HARD,3,Sargis Sargsian,Michael Joyce,Sargis Sargsian,7-6(1); 2-6; 4-6; 6-3; 6-1,R128,3,11,9,107,181,74,107,37,74,6,11,23,111,181,2,7,86,156,62,86,27,70,10,16,23,89,156
1995-08-28 00:00:00.000,US Open NY; U.S.A. Grand Slams,HARD,3,Andrei Medvedev,Hicham Arazi,Andrei Medvedev,6-7(5); 6-3; 6-4; 6-4,R128,3,15,2,90,136,76,90,27,46,2,3,21,103,136,11,6,78,158,60,78,41,80,10,14,20,101,158
1995-08-28 00:00:00.000,US Open NY; U.S.A. Grand Slams,HARD,3,Jerome Golmard,Wayne Ferreira,Jerome Golmard,7-5; 7-6(5); 6-1,R128,2,1,6,45,99,37,45,26,54,4,6,15,63,99,10,0,58,104,47,58,18,46,4,10,16,65,104
1995-08-28 00:00:00.000,US Open NY; U.S.A. Grand Slams,HARD,3,Marcos Ondruska,Mark Petchey,Marcos Ondruska,7-6(0); 6-1; 6-0,R128,2,1,4,43,80,33,43,21,37,1,3,13,54,80,1,13,44,105,23,44,19,61,6,13,12,42,105
1995-08-28 00:00:00.000,US Open NY; U.S.A. Grand Slams,HARD,3,Petr Korda,Shuzo Matsuoka,Petr Korda,7-6(4); 6-7(4); 6-7(8); 6-5 RET,R128,5,3,5,118,175,83,118,34,57,1,4,24,117,175,12,4,106,171,86,106,34,65,7,10,24,120,171
1995-08-28 00:00:00.000,US Open NY; U.S.A. Grand Slams,HARD,3,Jacco Eltingh,Wayne Black,Jacco Eltingh,6-2; 6-2; 6-4,R128,1,14,4,57,87,52,57,14,30,1,2,13,66,87,0,4,42,78,21,42,14,36,2,8,13,35,78
1995-08-28 00:00:00.000,US Open NY; U.S.A. Grand Slams,HARD,3,Emilio Sanchez,Jeremy Bates,Emilio Sanchez,6-2; 6-2; 6-3,R128,1,2,0,48,66,41,48,13,18,0,0,13,54,66,6,3,54,100,37,54,18,46,9,14,12,55,100
1995-08-28 00:00:00.000,US Open NY; U.S.A. Grand Slams,HARD,3,Vincent Spadea,Hendrik Dreekmann,Vincent Spadea,6-4; 7-5; 6-4,R128,5,3,3,62,129,46,62,32,67,9,12,16,78,129,4,9,55,116,45,55,21,61,8,14,16,66,116
1995-08-28 00:00:00.000,US Open NY; U.S.A. Grand Slams,HARD,3,Nuno Marques,Mahesh Bhupathi,Nuno Marques,6-7(3); 7-5; 6-1; 6-3,R128,3,3,6,77,125,50,77,26,48,1,6,20,76,125,7,7,75,153,55,75,26,78,8,18,20,81,153
1995-08-28 00:00:00.000,US Open NY; U.S.A. Grand Slams,HARD,3,Yevgeny Kafelnikov,Jeff Tarango,Yevgeny Kafelnikov,6-0; 6-4; 7-5,R128,3,9,5,46,91,39,46,26,45,2,3,14,65,91,3,6,54,88,37,54,8,34,3,9,14,45,88
1995-08-28 00:00:00.000,US Open NY; U.S.A. Grand Slams,HARD,3,Boris Becker,Alex Lopez Moron,Boris Becker,6-1; 6-0; 6-3,R128,0,8,3,49,82,38,49,20,33,6,6,11,58,82,1,3,45,81,18,45,16,36,9,16,11,34,81
1995-08-28 00:00:00.000,US Open NY; U.S.A. Grand Slams,HARD,3,Carsten Arriens,Karol Kucera,Carsten Arriens,6-4; 7-6(3); 6-2,R128,3,2,3,67,125,47,67,32,58,15,16,15,79,125,3,9,48,109,32,48,26,61,5,9,15,58,109
1995-08-28 00:00:00.000,US Open NY; U.S.A. Grand Slams,HARD,3,Aaron Krickstein,Lionel Roux,Aaron Krickstein,3-6; 6-3; 6-1; 3-6; 6-4,R128,0,9,2,74,143,53,74,40,69,4,9,22,93,143,5,6,90,158,55,90,34,68,8,15,22,89,158
1995-08-28 00:00:00.000,US Open NY; U.S.A. Grand Slams,HARD,3,Jason Stoltenberg,Radomir Vasek,Jason Stoltenberg,6-4; 6-4; 6-3,R128,2,9,6,69,111,53,69,21,42,9,10,14,74,111,0,8,56,106,34,56,21,50,3,8,15,55,106
1995-08-28 00:00:00.000,US Open NY; U.S.A. Grand Slams,HARD,3,Renzo Furlan,Olivier Delaitre,Renzo Furlan,6-3; 6-3; 6-1,R128,4,8,3,46,77,37,46,20,31,3,5,13,57,77,0,5,29,72,16,29,15,43,4,11,12,31,72
1995-08-28 00:00:00.000,US Open NY; U.S.A. Grand Slams,HARD,3,Derrick Rostagno,Jan Siemerink,Derrick Rostagno,6-4; 6-4; 6-4,R128,2,8,1,57,87,45,57,21,30,0,1,15,66,87,3,0,54,96,36,54,24,42,6,10,15,60,96
1995-08-28 00:00:00.000,US Open NY; U.S.A. Grand Slams,HARD,3,Patrick Rafter,Richey Reneberg,Patrick Rafter,7-6(3); 6-3; 6-4,R128,2,16,3,85,129,68,85,25,44,8,8,16,93,129,2,3,47,87,36,47,25,40,2,4,15,61,87
1995-08-28 00:00:00.000,US Open NY; U.S.A. Grand Slams,HARD,3,Marc Rosset,Andrea Gaudenzi,Marc Rosset,6-7(3); 6-3; 6-1; 6-0,R128,4,21,4,85,125,71,85,22,40,3,4,17,93,125,1,4,52,113,33,52,28,61,8,16,17,61,113
1995-08-28 00:00:00.000,US Open NY; U.S.A. Grand Slams,HARD,3,Sergi Bruguera,Johan Van Herck,Sergi Bruguera,6-3; 6-4; 6-4,R128,0,0,0,0,0,0,0,0,0,0,0,0,0,0,0,0,0,0,0,0,0,0,0,0,0,0,0
1995-08-28 00:00:00.000,US Open NY; U.S.A. Grand Slams,HARD,3,Daniel Vacek,Martin Sinner,Daniel Vacek,6-4; 6-7(6); 6-3; 2-6; 7-6(4),R128,18,28,3,150,206,119,150,32,56,12,15,26,151,206,9,10,111,184,82,111,39,73,2,5,25,121,184
1995-08-28 00:00:00.000,US Open NY; U.S.A. Grand Slams,HARD,3,Nicolas Pereira,Fabrice Santoro,Nicolas Pereira,2-6; 6-4; 5-7; 7-6(8); 7-6(3),R128,5,13,3,142,183,109,142,22,41,8,11,27,131,183,8,1,126,172,94,126,32,46,4,5,27,126,172
1995-08-28 00:00:00.000,US Open NY; U.S.A. Grand Slams,HARD,3,Joost Winnink,Greg Rusedski,Joost Winnink,7-6(5); 6-4; 6-7(6); 6-1,R128,3,4,6,89,136,71,89,21,47,3,5,21,92,136,17,11,88,157,72,88,29,69,7,12,20,101,157
1995-08-28 00:00:00.000,US Open NY; U.S.A. Grand Slams,HARD,3,Bohdan Ulihrach,Guillaume Raoux,Bohdan Ulihrach,6-3; 6-2; 6-1,R128,2,3,4,32,72,28,32,25,40,0,0,12,53,72,1,0,53,89,29,53,18,36,6,12,12,47,89
1995-08-28 00:00:00.000,US Open NY; U.S.A. Grand Slams,HARD,3,Alexander Volkov,Brett Hansen-Dent,Alexander Volkov,6-2; 6-4; 6-1,R128,2,11,4,43,78,39,43,20,35,0,0,12,59,78,6,3,58,95,39,58,12,37,8,14,13,51,95
1995-08-28 00:00:00.000,US Open NY; U.S.A. Grand Slams,HARD,3,Patrick McEnroe,Nicklas Kulti,Patrick McEnroe,6-3; 3-6; 6-3; 3-6; 6-4,R128,2,7,9,93,164,75,93,28,71,3,6,23,103,164,18,3,89,166,74,89,36,77,5,9,23,110,166
1995-08-28 00:00:00.000,US Open NY; U.S.A. Grand Slams,HARD,3,Brett Steven,Goran Ivanisevic,Brett Steven,4-6; 2-6; 6-3; 3-1 RET,R128,2,5,1,72,96,51,72,12,24,2,6,16,63,96,10,1,58,104,44,58,22,46,3,6,16,66,104
1995-08-28 00:00:00.000,US Open NY; U.S.A. Grand Slams,HARD,3,Michael Chang,Gianluca Pozzi,Michael Chang,6-0; 6-1; 6-0,R128,1,4,1,29,57,23,29,22,28,1,1,10,45,57,1,1,34,57,13,34,6,23,3,11,9,19,57
1995-08-28 00:00:00.000,US Open NY; U.S.A. Grand Slams,HARD,3,Stefano Pescosolido,Jiri Novak,Stefano Pescosolido,2-6; 6-3; 6-4; 6-1,R128,2,15,3,72,113,57,72,15,41,1,6,17,72,113,5,6,78,118,47,78,16,40,10,18,17,63,118
1995-08-28 00:00:00.000,US Open NY; U.S.A. Grand Slams,HARD,3,Todd Woodbridge,Chris Woodruff,Todd Woodbridge,6-4; 7-6(5); 6-4,R128,6,4,6,69,111,53,69,19,42,1,3,16,72,111,1,5,58,105,40,58,24,47,5,9,16,64,105
1995-08-28 00:00:00.000,US Open NY; U.S.A. Grand Slams,HARD,3,Jakob Hlasek,Alexander Mronz,Jakob Hlasek,6-3; 4-6; 6-4; 6-2,R128,6,13,4,69,118,58,69,23,49,1,5,19,81,118,11,11,54,124,46,54,21,70,4,11,18,67,124
1995-08-28 00:00:00.000,US Open NY; U.S.A. Grand Slams,HARD,3,David Wheaton,Neville Godwin,David Wheaton,7-6(10); 5-7; 7-5; 6-1,R128,5,6,4,89,131,66,89,22,42,3,8,21,88,131,7,8,85,156,58,85,34,71,9,17,22,92,156
1995-08-28 00:00:00.000,US Open NY; U.S.A. Grand Slams,HARD,3,Michael Tebbutt,Anders Jarryd,Michael Tebbutt,6-4; 6-3; 7-6(4),R128,4,19,9,83,159,73,83,31,76,13,14,16,104,159,3,7,46,106,33,46,31,60,5,8,15,64,106
1995-08-28 00:00:00.000,US Open NY; U.S.A. Grand Slams,HARD,3,Justin Gimelstob,David Prinosil,Justin Gimelstob,6-4; 6-4; 4-6; 4-6; 6-3,R128,3,12,3,130,180,91,130,27,50,14,18,25,118,180,12,11,107,185,84,107,27,78,8,13,24,111,185
1995-08-28 00:00:00.000,US Open NY; U.S.A. Grand Slams,HARD,3,Richard Krajicek,Karel Novacek,Richard Krajicek,6-3; 6-4; 6-4,R128,2,9,2,56,90,48,56,22,34,1,1,15,70,90,7,1,57,93,45,57,18,36,3,6,14,63,93
1995-08-28 00:00:00.000,US Open NY; U.S.A. Grand Slams,HARD,3,Jim Courier,Bernd Karbacher,Jim Courier,6-3; 6-4; 3-6; 6-3,R128,3,5,6,76,134,52,76,29,58,6,10,19,81,134,12,5,83,142,61,83,23,59,9,15,18,84,142
1995-08-28 00:00:00.000,US Open NY; U.S.A. Grand Slams,HARD,3,Sebastien Lareau,Adrian Voinea,Sebastien Lareau,6-4; 3-6; 4-6; 6-4; 7-5,R128,3,11,16,98,184,82,98,27,86,8,13,25,109,184,22,5,104,170,83,104,33,66,8,14,26,116,170
1995-08-28 00:00:00.000,US Open NY; U.S.A. Grand Slams,HARD,3,Kenneth Carlsen,Jim Grabb,Kenneth Carlsen,6-7(6); 7-6(1); 6-2; 3-6; 6-2,R128,4,9,8,77,162,58,77,52,85,4,7,24,110,162,5,8,93,183,65,93,44,90,10,16,25,109,183
1995-08-28 00:00:00.000,US Open NY; U.S.A. Grand Slams,HARD,3,Karsten Braasch,Scott Humphries,Karsten Braasch,6-3; 6-7(4); 7-6(5); 6-3,R128,6,23,3,112,171,84,112,28,59,7,10,21,112,171,8,13,73,162,49,73,37,89,2,8,21,86,162
1995-08-28 00:00:00.000,US Open NY; U.S.A. Grand Slams,HARD,3,Cedric Pioline,Sjeng Schalken,Cedric Pioline,6-4; 7-5; 6-1,R128,4,8,3,64,112,50,64,26,48,8,8,14,76,112,4,4,61,102,42,61,17,41,3,8,15,59,102
1995-08-28 00:00:00.000,US Open NY; U.S.A. Grand Slams,HARD,3,Francisco Clavet,Christian Ruud,Francisco Clavet,6-1; 6-4; 6-4,R128,3,3,2,78,95,52,78,6,17,4,7,14,58,95,3,4,83,111,49,83,6,28,3,10,13,55,111
1995-08-28 00:00:00.000,US Open NY; U.S.A. Grand Slams,HARD,3,Mark Woodforde,Kris Goossens,Mark Woodforde,6-3; 6-3; 6-4,R128,2,6,4,46,81,33,46,23,35,1,3,14,56,81,1,8,49,103,29,49,24,54,10,16,14,53,103
1995-08-28 00:00:00.000,US Open NY; U.S.A. Grand Slams,HARD,3,Thomas Muster,Luke Jensen,Thomas Muster,7-6(3); 6-3; 6-0,R128,2,4,4,48,80,44,48,20,32,0,1,14,64,80,3,6,54,101,37,54,16,47,3,8,13,53,101
1995-08-28 00:00:00.000,US Open NY; U.S.A. Grand Slams,HARD,3,Michael Stich,Javier Sanchez,Michael Stich,6-2; 6-3; 6-0,R128,1,8,3,46,78,40,46,19,32,0,0,12,59,78,0,6,44,74,23,44,11,30,5,11,11,34,74
1995-08-28 00:00:00.000,US Open NY; U.S.A. Grand Slams,HARD,3,Hernan Gumy,Jonathan Stark,Hernan Gumy,6-4; 6-4; 6-3,R128,2,8,4,66,96,54,66,15,30,7,7,14,69,96,7,5,86,123,61,86,11,37,8,12,15,72,123
1995-08-28 00:00:00.000,US Open NY; U.S.A. Grand Slams,HARD,3,Andrei Chesnokov,MaliVai Washington,Andrei Chesnokov,6-2; 6-4; 6-4,R128,0,2,2,57,94,37,57,23,37,0,2,14,60,94,3,6,55,110,38,55,19,55,13,19,14,57,110
1995-08-28 00:00:00.000,US Open NY; U.S.A. Grand Slams,HARD,3,Scott Draper,Cristiano Caratti,Scott Draper,6-2; 6-3; 3-6; 6-3,R128,5,9,6,83,123,61,83,19,40,10,13,18,80,123,2,7,61,116,43,61,22,55,3,9,17,65,116
1995-08-28 00:00:00.000,US Open NY; U.S.A. Grand Slams,HARD,3,Jonas Bjorkman,Mark Knowles,Jonas Bjorkman,6-1; 7-5; 6-1,R128,1,7,2,52,85,42,52,19,33,0,1,13,61,85,0,2,51,84,26,51,16,33,4,11,13,42,84
1995-08-28 00:00:00.000,US Open NY; U.S.A. Grand Slams,HARD,3,Paul Haarhuis,Gilbert Schaller,Paul Haarhuis,6-7(6); 6-1; 6-3; 6-7(3); 7-5,R128,4,9,8,101,196,75,101,46,95,9,12,26,121,196,7,5,104,193,68,104,42,89,12,20,26,110,193
1995-08-28 00:00:00.000,US Open NY; U.S.A. Grand Slams,HARD,3,Byron Black,Arnaud Boetsch,Byron Black,7-6(3); 6-3; 6-3,R128,2,4,2,67,96,49,67,18,29,0,2,15,67,96,4,4,59,93,44,59,10,34,4,9,15,54,93
1995-08-28 00:00:00.000,US Open NY; U.S.A. Grand Slams,HARD,3,Thomas Enqvist,Marcelo Rios,Thomas Enqvist,2-6; 6-2; 4-6; 6-3; 7-6(7),R128,3,20,13,115,202,81,115,33,87,12,21,24,114,202,8,3,101,170,67,101,28,69,9,18,23,95,170
1995-08-28 00:00:00.000,US Open NY; U.S.A. Grand Slams,HARD,3,Todd Martin,Guy Forget,Todd Martin,6-3; 7-5; 4-6; 6-4,R128,2,21,4,76,132,69,76,33,56,4,5,20,102,132,16,4,83,147,69,83,32,64,7,11,21,101,147
1995-08-28 00:00:00.000,US Open NY; U.S.A. Grand Slams,HARD,3,Mats Wilander,Steve Campbell,Mats Wilander,3-6; 6-1; 3-6; 6-4; 6-2,R128,3,7,5,78,141,55,78,28,63,4,10,21,83,141,7,1,87,135,57,87,26,48,7,16,22,83,135
1995-08-28 00:00:00.000,US Open NY; U.S.A. Grand Slams,HARD,3,Frederik Fetterlein,Jordi Burillo,Frederik Fetterlein,6-2; 2-6; 6-3; 4-6; 6-2,R128,3,11,9,66,129,49,66,32,63,3,9,21,81,129,8,8,89,150,61,89,21,61,7,16,22,82,150
1995-08-28 00:00:00.000,US Open NY; U.S.A. Grand Slams,HARD,3,Mauricio Hadad,Jean-Philippe Fleurian,Mauricio Hadad,7-5; 6-4; 5-2,R128,1,0,1,58,78,44,58,15,20,0,1,15,59,78,3,7,61,116,40,61,22,55,7,12,15,62,116
1995-08-28 00:00:00.000,US Open NY; U.S.A. Grand Slams,HARD,3,Marc-Kevin Goellner,Jan Apell,Marc-Kevin Goellner,6-2; 7-6(3); 6-1,R128,4,22,4,71,114,66,71,22,43,2,2,14,88,114,4,1,67,84,42,67,8,17,6,10,13,50,84
1995-08-28 00:00:00.000,US Open NY; U.S.A. Grand Slams,HARD,3,Mark Philippoussis,Paul Wekesa,Mark Philippoussis,7-6(4); 6-0; 1-0 RET,R128,4,12,1,37,65,33,37,20,28,1,1,10,53,65,2,2,41,65,24,41,10,24,1,5,10,34,65
1995-08-28 00:00:00.000,US Open NY; U.S.A. Grand Slams,HARD,3,Jaime Yzaga,Javier Frana,Jaime Yzaga,6-2; 5-7; 2-6; 6-3; 6-4,R128,3,1,7,85,152,61,85,33,67,7,12,24,94,152,21,2,115,186,83,115,33,71,16,22,23,116,186
1995-08-28 00:00:00.000,US Open NY; U.S.A. Grand Slams,HARD,3,Pete Sampras,Fernando Meligeni,Pete Sampras,6-0; 6-3; 6-4,R128,1,8,4,62,99,51,62,18,37,6,6,13,69,99,6,7,63,97,41,63,9,34,7,12,12,50,97
1995-08-28 00:00:00.000,US Open NY; U.S.A. Grand Slams,HARD,3,Andre Agassi,Alex Corretja,Andre Agassi,5-7; 6-3; 5-7; 6-0; 6-2,R64,3,9,6,101,147,77,101,16,46,3,8,23,93,147,7,2,143,183,86,143,12,40,17,27,24,98,183
1995-08-28 00:00:00.000,US Open NY; U.S.A. Grand Slams,HARD,3,Stefan Edberg,Daniel Nestor,Stefan Edberg,6-1; 7-6(4); 2-6; 6-1,R64,4,10,6,67,116,53,67,25,49,1,4,18,78,116,10,6,76,132,52,76,22,56,13,18,16,74,132
1995-08-28 00:00:00.000,US Open NY; U.S.A. Grand Slams,HARD,3,Jared Palmer,Tim Henman,Jared Palmer,6-4; 6-7(8); 6-3; 6-1,R64,4,3,6,86,153,63,86,32,67,10,12,19,95,153,7,6,100,168,62,100,32,68,12,19,19,94,168
1995-08-28 00:00:00.000,US Open NY; U.S.A. Grand Slams,HARD,3,Sargis Sargsian,Andrei Medvedev,Sargis Sargsian,1-6; 4-6; 6-3; 6-2; 6-4,R64,11,6,11,87,161,62,87,25,74,4,12,22,87,161,5,6,61,159,45,61,39,98,10,19,22,84,159
1995-08-28 00:00:00.000,US Open NY; U.S.A. Grand Slams,HARD,3,Marcos Ondruska,Jerome Golmard,Marcos Ondruska,6-4; 6-4; 6-3,R64,2,5,3,48,86,43,48,21,38,1,1,14,64,86,6,10,49,109,37,49,24,60,3,7,15,61,109
1995-08-28 00:00:00.000,US Open NY; U.S.A. Grand Slams,HARD,3,Petr Korda,Jacco Eltingh,Petr Korda,6-2; 6-4; 3-6; 6-1,R64,2,5,0,69,100,52,69,22,31,2,3,17,74,100,12,7,67,115,54,67,19,48,7,12,17,73,115
1995-08-28 00:00:00.000,US Open NY; U.S.A. Grand Slams,HARD,3,Vincent Spadea,Emilio Sanchez,Vincent Spadea,6-1; 7-6(7); 6-3,R64,3,5,1,77,94,54,77,5,17,5,9,13,59,94,4,2,84,102,42,84,6,18,3,12,15,48,102
1995-08-28 00:00:00.000,US Open NY; U.S.A. Grand Slams,HARD,3,Yevgeny Kafelnikov,Nuno Marques,Yevgeny Kafelnikov,6-3; 6-4; 6-4,R64,2,10,7,72,118,53,72,22,46,7,9,15,75,118,4,5,62,102,42,62,14,40,5,10,14,56,102
1995-08-28 00:00:00.000,US Open NY; U.S.A. Grand Slams,HARD,3,Boris Becker,Carsten Arriens,Boris Becker,6-1; 6-3; 7-5,R64,7,8,5,48,87,41,48,21,39,0,1,14,62,87,5,3,47,94,29,47,22,47,9,15,14,51,94
1995-08-28 00:00:00.000,US Open NY; U.S.A. Grand Slams,HARD,3,Jason Stoltenberg,Aaron Krickstein,Jason Stoltenberg,6-2; 6-4; 2-6; 4-6; 6-1,R64,3,17,9,91,156,72,91,23,65,9,15,21,95,156,5,5,89,160,56,89,31,71,13,22,22,87,160
1995-08-28 00:00:00.000,US Open NY; U.S.A. Grand Slams,HARD,3,Renzo Furlan,Derrick Rostagno,Renzo Furlan,6-4; 6-2; 6-4,R64,3,0,1,41,79,32,41,19,38,4,7,14,51,79,3,5,52,88,29,52,14,36,3,10,14,43,88
1995-08-28 00:00:00.000,US Open NY; U.S.A. Grand Slams,HARD,3,Marc Rosset,Patrick Rafter,Marc Rosset,6-4; 6-4; 3-6; 6-3,R64,2,11,6,86,132,67,86,22,46,5,7,19,89,132,8,4,72,127,54,72,28,55,1,5,19,82,127
1995-08-28 00:00:00.000,US Open NY; U.S.A. Grand Slams,HARD,3,Daniel Vacek,Sergi Bruguera,Daniel Vacek,6-2; 6-3; 6-4,R64,2,7,7,44,97,37,44,27,53,0,1,14,64,97,8,2,57,90,38,57,16,33,5,10,13,54,90
1995-08-28 00:00:00.000,US Open NY; U.S.A. Grand Slams,HARD,3,Nicolas Pereira,Joost Winnink,Nicolas Pereira,7-6(4); 6-4; 2-6; 6-3,R64,0,5,0,86,126,64,86,25,40,3,6,20,89,126,6,4,68,121,55,68,25,53,1,4,19,80,121
1995-08-28 00:00:00.000,US Open NY; U.S.A. Grand Slams,HARD,3,Alexander Volkov,Bohdan Ulihrach,Alexander Volkov,6-3; 4-6; 6-1; 6-3,R64,2,6,3,67,123,50,67,28,56,9,12,18,78,123,4,11,54,115,33,54,25,61,5,12,17,58,115
1995-08-28 00:00:00.000,US Open NY; U.S.A. Grand Slams,HARD,3,Patrick McEnroe,Brett Steven,Patrick McEnroe,6-2; 6-2; 6-2,R64,1,5,0,42,68,33,42,19,26,1,2,12,52,68,5,6,54,95,35,54,10,41,7,14,12,45,95
1995-08-28 00:00:00.000,US Open NY; U.S.A. Grand Slams,HARD,3,Michael Chang,Stefano Pescosolido,Michael Chang,4-6; 6-3; 6-4; 6-4,R64,3,18,5,81,157,67,81,36,76,11,15,20,103,157,8,8,58,147,39,58,42,89,8,14,19,81,147
1995-08-28 00:00:00.000,US Open NY; U.S.A. Grand Slams,HARD,3,Todd Woodbridge,Jakob Hlasek,Todd Woodbridge,6-3; 6-4; 3-6; 6-2,R64,3,7,4,77,131,57,77,31,54,8,10,18,88,131,6,7,83,151,52,83,33,68,13,18,18,85,151
1995-08-28 00:00:00.000,US Open NY; U.S.A. Grand Slams,HARD,3,Michael Tebbutt,David Wheaton,Michael Tebbutt,6-3; 6-3; 6-4,R64,2,20,6,63,111,58,63,22,48,1,1,14,80,111,8,5,75,105,52,75,13,30,5,9,14,65,105
1995-08-28 00:00:00.000,US Open NY; U.S.A. Grand Slams,HARD,3,Richard Krajicek,Justin Gimelstob,Richard Krajicek,6-4; 6-2; 6-4,R64,2,12,1,55,86,45,55,23,31,3,4,14,68,86,4,7,58,109,40,58,18,51,7,12,14,58,109
1995-08-28 00:00:00.000,US Open NY; U.S.A. Grand Slams,HARD,3,Jim Courier,Sebastien Lareau,Jim Courier,6-3; 6-4; 6-4,R64,2,13,2,59,95,56,59,17,36,3,4,15,73,95,12,12,65,118,55,65,13,53,5,9,14,68,118
1995-08-28 00:00:00.000,US Open NY; U.S.A. Grand Slams,HARD,3,Kenneth Carlsen,Karsten Braasch,Kenneth Carlsen,6-7(2); 6-7(3); 7-6(4); 6-5 RET,R64,6,9,10,79,181,57,79,58,102,7,9,24,115,181,17,7,109,189,87,109,38,80,8,11,24,125,189
1995-08-28 00:00:00.000,US Open NY; U.S.A. Grand Slams,HARD,3,Francisco Clavet,Cedric Pioline,Francisco Clavet,6-4; 5-7; 7-5; 6-0,R64,3,3,5,70,128,49,70,30,58,1,5,20,79,128,3,9,73,140,47,73,26,67,7,15,20,73,140
1995-08-28 00:00:00.000,US Open NY; U.S.A. Grand Slams,HARD,3,Thomas Muster,Mark Woodforde,Thomas Muster,4-6; 6-2; 6-2; 6-4,R64,3,6,5,63,112,53,63,26,49,2,3,18,79,112,16,8,69,130,54,69,27,61,7,12,18,81,130
1995-08-28 00:00:00.000,US Open NY; U.S.A. Grand Slams,HARD,3,Michael Stich,Hernan Gumy,Michael Stich,6-3; 1-6; 6-2; 2-6; 6-3,R64,0,17,2,86,131,70,86,22,45,3,8,21,92,131,2,4,71,137,47,71,33,66,5,10,20,80,137
1995-08-28 00:00:00.000,US Open NY; U.S.A. Grand Slams,HARD,3,Scott Draper,Andrei Chesnokov,Scott Draper,6-3; 4-6; 4-6; 7-6(3); 6-3,R64,5,13,7,108,188,82,108,34,80,9,15,26,116,188,4,2,97,161,61,97,36,64,8,14,24,97,161
1995-08-28 00:00:00.000,US Open NY; U.S.A. Grand Slams,HARD,3,Jonas Bjorkman,Paul Haarhuis,Jonas Bjorkman,6-4; 6-4; 6-3,R64,2,0,5,48,93,33,48,21,45,1,5,15,54,93,0,3,49,80,24,49,14,31,3,10,14,38,80
1995-08-28 00:00:00.000,US Open NY; U.S.A. Grand Slams,HARD,3,Byron Black,Thomas Enqvist,Byron Black,6-4; 6-4; 3-6; 6-3,R64,3,9,3,106,166,70,106,34,60,17,20,19,104,166,14,8,70,136,54,70,29,66,10,15,19,83,136
1995-08-28 00:00:00.000,US Open NY; U.S.A. Grand Slams,HARD,3,Todd Martin,Mats Wilander,Todd Martin,6-4; 6-2; 7-5,R64,2,10,4,55,93,47,55,23,38,3,4,15,70,93,0,2,63,102,36,63,17,39,6,11,15,53,102
1995-08-28 00:00:00.000,US Open NY; U.S.A. Grand Slams,HARD,3,Mauricio Hadad,Frederik Fetterlein,Mauricio Hadad,6-3; 2-6; 6-2; 7-5,R64,3,2,2,77,110,53,77,17,33,7,12,19,70,110,7,7,74,137,48,74,25,63,8,15,18,73,137
1995-08-28 00:00:00.000,US Open NY; U.S.A. Grand Slams,HARD,3,Mark Philippoussis,Marc-Kevin Goellner,Mark Philippoussis,7-6(5); 6-2; 7-5,R64,3,22,2,77,120,69,77,25,43,1,1,16,94,120,14,4,61,112,55,61,23,51,2,5,16,78,112
1995-08-28 00:00:00.000,US Open NY; U.S.A. Grand Slams,HARD,3,Pete Sampras,Jaime Yzaga,Pete Sampras,6-1; 6-4; 6-3,R64,2,16,3,45,86,43,45,25,41,0,0,13,68,86,1,3,42,86,27,42,17,44,2,7,13,44,86
1995-08-28 00:00:00.000,US Open NY; U.S.A. Grand Slams,HARD,3,Andre Agassi,Stefan Edberg,Andre Agassi,6-4; 6-3; 6-1,R32,2,5,2,55,95,39,55,21,40,6,8,13,60,95,6,5,47,88,33,47,13,41,3,10,13,46,88
1995-08-28 00:00:00.000,US Open NY; U.S.A. Grand Slams,HARD,3,Jared Palmer,Sargis Sargsian,Jared Palmer,6-3; 6-2; 6-2,R32,2,1,5,51,79,36,51,14,28,1,3,13,50,79,1,8,44,88,26,44,14,44,4,11,12,40,88
1995-08-28 00:00:00.000,US Open NY; U.S.A. Grand Slams,HARD,3,Petr Korda,Marcos Ondruska,Petr Korda,6-3; 6-2; 7-5,R32,3,2,6,62,106,43,62,24,44,9,11,15,67,106,5,4,57,107,39,57,17,50,11,17,14,56,107
1995-08-28 00:00:00.000,US Open NY; U.S.A. Grand Slams,HARD,3,Vincent Spadea,Yevgeny Kafelnikov,Vincent Spadea,6-2; 6-4; 6-4,R32,2,6,1,53,92,43,53,24,39,5,5,14,67,92,5,8,53,130,43,53,28,77,9,13,14,71,130
1995-08-28 00:00:00.000,US Open NY; U.S.A. Grand Slams,HARD,3,Boris Becker,Jason Stoltenberg,Boris Becker,6-2; 4-6; 6-0; 6-4,R32,3,12,5,69,121,57,69,18,52,1,5,17,75,121,12,9,78,146,52,78,20,68,12,21,17,72,146
1995-08-28 00:00:00.000,US Open NY; U.S.A. Grand Slams,HARD,3,Marc Rosset,Renzo Furlan,Marc Rosset,6-1; 7-6(2); 3-6; 7-5,R32,0,16,3,82,139,69,82,31,57,7,9,19,100,139,7,6,95,168,69,95,29,73,10,15,21,98,168
1995-08-28 00:00:00.000,US Open NY; U.S.A. Grand Slams,HARD,3,Daniel Vacek,Nicolas Pereira,Daniel Vacek,4-6; 7-6(5); 6-2; 7-6(3),R32,5,10,7,83,157,69,83,33,74,9,13,21,102,157,12,3,95,169,67,95,36,74,14,19,21,103,169
1995-08-28 00:00:00.000,US Open NY; U.S.A. Grand Slams,HARD,3,Patrick McEnroe,Alexander Volkov,Patrick McEnroe,4-6; 2-6; 6-1; 7-6(4); 6-2,R32,4,6,8,89,163,68,89,35,74,10,14,23,103,163,10,4,85,170,66,85,40,85,10,15,22,106,170
1995-08-28 00:00:00.000,US Open NY; U.S.A. Grand Slams,HARD,3,Michael Chang,Todd Woodbridge,Michael Chang,6-3; 6-2; 6-0,R32,2,4,2,35,82,30,35,28,47,3,3,12,58,82,1,5,37,66,21,37,8,29,1,7,11,29,66
1995-08-28 00:00:00.000,US Open NY; U.S.A. Grand Slams,HARD,3,Michael Tebbutt,Richard Krajicek,Michael Tebbutt,6-3; 3-6; 6-7(5); 7-6(4); 7-6(4),R32,5,23,9,129,224,110,129,48,95,7,8,27,158,224,36,8,149,228,129,149,33,79,9,10,27,162,228
1995-08-28 00:00:00.000,US Open NY; U.S.A. Grand Slams,HARD,3,Jim Courier,Kenneth Carlsen,Jim Courier,6-3; 6-4; 6-2,R32,2,4,2,61,90,49,61,15,29,4,4,14,64,90,7,3,48,92,36,48,18,44,2,6,13,54,92
1995-08-28 00:00:00.000,US Open NY; U.S.A. Grand Slams,HARD,3,Thomas Muster,Francisco Clavet,Thomas Muster,0-6; 6-4; 6-3; 7-5,R32,3,4,9,71,126,48,71,18,55,6,14,19,66,126,3,2,64,103,40,64,18,39,6,14,18,58,103
1995-08-28 00:00:00.000,US Open NY; U.S.A. Grand Slams,HARD,3,Michael Stich,Scott Draper,Michael Stich,6-3; 6-0; 6-3,R32,2,10,2,51,71,47,51,12,20,1,1,12,59,71,1,4,38,85,20,38,22,47,6,12,12,42,85
1995-08-28 00:00:00.000,US Open NY; U.S.A. Grand Slams,HARD,3,Byron Black,Jonas Bjorkman,Byron Black,6-3; 7-6(5); 6-1,R32,3,4,5,56,106,47,56,20,50,3,5,15,67,106,6,8,54,109,39,54,18,55,7,12,13,57,109
1995-08-28 00:00:00.000,US Open NY; U.S.A. Grand Slams,HARD,3,Todd Martin,Mauricio Hadad,Todd Martin,6-2; 6-1; 6-4,R32,1,10,2,59,86,53,59,13,27,3,3,13,66,86,0,4,54,80,31,54,10,26,4,9,12,41,80
1995-08-28 00:00:00.000,US Open NY; U.S.A. Grand Slams,HARD,3,Pete Sampras,Mark Philippoussis,Pete Sampras,6-7(5); 7-5; 7-5; 6-3,R32,6,28,14,99,185,91,99,33,86,4,7,23,124,185,14,9,89,170,70,89,34,81,5,11,22,104,170
1995-08-28 00:00:00.000,US Open NY; U.S.A. Grand Slams,HARD,3,Andre Agassi,Jared Palmer,Andre Agassi,7-5; 6-3; 6-2,R16,2,5,6,49,98,41,49,24,49,1,2,15,65,98,9,3,59,96,40,59,16,37,3,8,14,56,96
1995-08-28 00:00:00.000,US Open NY; U.S.A. Grand Slams,HARD,3,Petr Korda,Vincent Spadea,Petr Korda,6-2; 7-5; 6-4,R16,2,5,1,65,91,48,65,19,26,3,4,15,67,91,1,4,53,104,35,53,22,51,3,8,15,57,104
1995-08-28 00:00:00.000,US Open NY; U.S.A. Grand Slams,HARD,3,Boris Becker,Marc Rosset,Boris Becker,7-6(4); 6-3; 6-3,R16,4,13,5,71,115,62,71,24,44,3,3,15,86,115,7,5,50,104,44,50,23,54,4,7,15,67,104
1995-08-28 00:00:00.000,US Open NY; U.S.A. Grand Slams,HARD,3,Patrick McEnroe,Daniel Vacek,Patrick McEnroe,7-6(8); 6-3; 6-4,R16,3,5,2,61,106,47,61,29,45,2,3,16,76,106,11,4,72,122,58,72,20,50,4,7,15,78,122
1995-08-28 00:00:00.000,US Open NY; U.S.A. Grand Slams,HARD,3,Michael Chang,Michael Tebbutt,Michael Chang,6-2; 6-2; 4-6; 6-3,R16,4,13,5,62,130,50,62,33,68,8,11,17,83,130,12,16,64,134,48,64,18,70,2,10,18,66,134
1995-08-28 00:00:00.000,US Open NY; U.S.A. Grand Slams,HARD,3,Jim Courier,Thomas Muster,Jim Courier,6-3; 6-0; 7-6(4),R16,3,10,3,62,97,52,62,18,35,3,5,14,70,97,0,7,47,87,27,47,14,40,1,7,13,41,87
1995-08-28 00:00:00.000,US Open NY; U.S.A. Grand Slams,HARD,3,Byron Black,Michael Stich,Byron Black,6-4; 6-4; 3-6; 2-6; 6-3,R16,5,1,0,116,165,74,116,26,49,10,14,23,100,165,20,8,110,189,93,110,29,79,9,13,23,122,189
1995-08-28 00:00:00.000,US Open NY; U.S.A. Grand Slams,HARD,3,Pete Sampras,Todd Martin,Pete Sampras,7-6(4); 6-3; 6-4,R16,6,17,7,61,130,56,61,39,69,3,3,16,95,130,11,7,67,122,48,67,27,55,3,5,15,75,122
1995-08-28 00:00:00.000,US Open NY; U.S.A. Grand Slams,HARD,3,Andre Agassi,Petr Korda,Andre Agassi,6-4; 6-2; 1-6; 7-5,Q,3,4,2,78,122,51,78,24,44,7,12,18,75,122,8,6,88,147,54,88,29,59,8,15,19,83,147
1995-08-28 00:00:00.000,US Open NY; U.S.A. Grand Slams,HARD,3,Boris Becker,Patrick McEnroe,Boris Becker,6-4; 7-6(2); 6-7(3); 7-6(6),Q,6,30,14,127,221,106,127,34,94,12,16,23,140,221,5,3,117,188,77,117,34,71,12,17,23,111,188
1995-08-28 00:00:00.000,US Open NY; U.S.A. Grand Slams,HARD,3,Jim Courier,Michael Chang,Jim Courier,7-6(5); 7-6(3); 7-5,Q,5,9,5,92,143,59,92,28,51,10,15,18,87,143,7,6,60,137,47,60,33,77,4,10,18,80,137
1995-08-28 00:00:00.000,US Open NY; U.S.A. Grand Slams,HARD,3,Pete Sampras,Byron Black,Pete Sampras,7-6(3); 6-4; 6-0,Q,2,22,4,62,97,58,62,17,35,0,2,14,75,97,2,2,71,102,37,71,15,31,8,14,14,52,102
1995-08-28 00:00:00.000,US Open NY; U.S.A. Grand Slams,HARD,3,Andre Agassi,Boris Becker,Andre Agassi,7-6(4); 7-6(2); 4-6; 6-4,S,4,12,4,93,149,74,93,34,56,9,11,22,108,149,25,11,124,201,102,124,26,77,8,10,22,128,201
1995-08-28 00:00:00.000,US Open NY; U.S.A. Grand Slams,HARD,3,Pete Sampras,Jim Courier,Pete Sampras,7-5; 4-6; 6-4; 7-5,S,4,26,7,96,160,83,96,34,64,8,9,22,117,160,10,5,98,156,76,98,26,58,4,7,22,102,156
1995-08-28 00:00:00.000,US Open NY; U.S.A. Grand Slams,HARD,3,Pete Sampras,Andre Agassi,Pete Sampras,6-4; 6-3; 4-6; 7-5,F,4,24,6,89,151,80,89,30,62,4,6,21,110,151,8,4,72,125,52,72,32,53,3,7,20,84,125
1995-09-11 00:00:00.000,Bogota Colombia ATP World Tour,CLAY,2,Hernan Gumy,Richard Krajicek,Hernan Gumy,7-6(4); 4-6; 7-6(1),R32,127,5,7,73,118,55,73,31,45,10,11,17,86,118,16,2,54,93,49,54,26,39,2,2,17,75,93
1995-09-11 00:00:00.000,Bogota Colombia ATP World Tour,CLAY,2,Nicolas Pereira,Bryan Shelton,Nicolas Pereira,6-4; 6-4,R32,70,10,3,32,56,27,32,13,24,2,3,10,40,56,8,4,30,64,23,30,14,34,1,4,10,37,64
1995-09-11 00:00:00.000,Bogota Colombia ATP World Tour,CLAY,2,Emilio Sanchez,Jiri Novak,Emilio Sanchez,6-3; 7-6(3),R32,62,3,1,46,68,35,46,14,22,1,2,11,49,68,6,3,40,65,27,40,14,25,2,4,10,41,65
1995-09-11 00:00:00.000,Bogota Colombia ATP World Tour,CLAY,2,Fernando Meligeni,Alejo Mancisidor,Fernando Meligeni,6-2; 6-2,R32,65,3,3,24,49,21,24,11,25,3,4,8,32,49,2,6,31,58,18,31,8,27,1,6,8,26,58
1995-09-11 00:00:00.000,Bogota Colombia ATP World Tour,CLAY,2,Miguel Tobon,Javier Frana,Miguel Tobon,6-3; 6-4,R32,69,7,2,45,63,38,45,6,18,1,1,10,44,63,3,2,29,63,21,29,16,34,2,4,9,37,63
1995-09-11 00:00:00.000,Bogota Colombia ATP World Tour,CLAY,2,Sergio Cortes,Mario Rincon,Sergio Cortes,6-3; 6-0,R32,58,1,1,23,41,18,23,12,18,1,1,7,30,41,1,1,30,43,16,30,4,13,0,5,8,20,43
1995-09-11 00:00:00.000,Bogota Colombia ATP World Tour,CLAY,2,Vincent Spadea,Laurence Tieleman,Vincent Spadea,6-1; 6-3,R32,54,3,1,24,41,20,24,12,17,0,0,8,32,41,2,3,36,67,18,36,15,31,4,8,8,33,67
1995-09-11 00:00:00.000,Bogota Colombia ATP World Tour,CLAY,2,Karim Alami,Aaron Krickstein,Karim Alami,6-4; 6-2,R32,57,7,2,27,51,23,27,15,24,2,2,9,38,51,1,4,23,53,15,23,16,30,2,5,9,31,53
1995-09-11 00:00:00.000,Bogota Colombia ATP World Tour,CLAY,2,Marcelo Rios,Alex Lopez Moron,Marcelo Rios,6-4; 6-2,R32,64,6,1,34,49,27,34,11,15,2,2,9,38,49,5,6,44,77,27,44,15,33,11,14,9,42,77
1995-09-11 00:00:00.000,Bogota Colombia ATP World Tour,CLAY,2,Gaston Etlis,Daniele Musa,Gaston Etlis,6-4; 6-4,R32,81,7,1,39,59,29,39,12,20,1,2,10,41,59,2,2,39,73,29,39,14,34,6,9,10,43,73
1995-09-11 00:00:00.000,Bogota Colombia ATP World Tour,CLAY,2,Nicolas Lapentti,Juan Albert Viloca-Puig,Nicolas Lapentti,6-4; 6-4,R32,79,7,1,26,59,18,26,25,33,0,0,10,43,59,3,2,39,67,31,39,10,28,6,8,10,41,67
1995-09-11 00:00:00.000,Bogota Colombia ATP World Tour,CLAY,2,Steve Campbell,Alex Corretja,Steve Campbell,0-6; 6-3; 6-2,R32,91,3,3,37,70,28,37,12,33,0,5,13,40,70,4,0,52,72,35,52,8,20,4,8,12,43,72
1995-09-11 00:00:00.000,Bogota Colombia ATP World Tour,CLAY,2,MaliVai Washington,Felix Mantilla,MaliVai Washington,7-6(7); 6-4,R32,79,5,6,39,72,32,39,17,33,1,2,11,49,72,4,1,32,71,23,32,23,39,0,2,11,46,71
1995-09-11 00:00:00.000,Bogota Colombia ATP World Tour,CLAY,2,Luis Adrian Morejon,David Rikl,Luis Adrian Morejon,6-3; 6-7(5); 7-5,R32,123,12,3,65,108,51,65,21,43,8,10,17,72,108,5,12,49,107,37,49,28,58,4,8,16,65,107
1995-09-11 00:00:00.000,Bogota Colombia ATP World Tour,CLAY,2,Mauricio Hadad,Fernon Wibier,Mauricio Hadad,7-5; 7-6(6),R32,91,5,6,56,85,41,56,15,29,4,6,12,56,85,8,14,49,78,40,49,9,29,5,8,12,49,78
1995-09-11 00:00:00.000,Bogota Colombia ATP World Tour,CLAY,2,Alberto Berasategui,Marcelo Filippini,Alberto Berasategui,6-2; 6-7(2); 6-3,R32,104,1,12,69,112,51,69,19,43,6,8,15,70,112,3,5,49,81,34,49,18,32,3,8,14,52,81
1995-09-11 00:00:00.000,Bogota Colombia ATP World Tour,CLAY,2,Hernan Gumy,Nicolas Pereira,Hernan Gumy,7-6(1); 7-6(3),R16,94,3,4,39,69,32,39,19,30,0,2,12,51,69,5,1,55,84,35,55,17,29,4,6,12,52,84
1995-09-11 00:00:00.000,Bogota Colombia ATP World Tour,CLAY,2,Fernando Meligeni,Emilio Sanchez,Fernando Meligeni,7-5; 6-7(2); 6-4,R16,142,5,7,77,137,51,77,24,60,9,14,17,75,137,4,3,53,88,37,53,14,35,0,7,17,51,88
1995-09-11 00:00:00.000,Bogota Colombia ATP World Tour,CLAY,2,Miguel Tobon,Sergio Cortes,Miguel Tobon,7-5; 7-5,R16,90,4,3,39,71,24,39,18,32,5,9,12,42,71,1,5,41,72,24,41,13,31,4,10,12,37,72
1995-09-11 00:00:00.000,Bogota Colombia ATP World Tour,CLAY,2,Karim Alami,Vincent Spadea,Karim Alami,6-3; 6-2,R16,61,4,4,26,47,22,26,12,21,0,1,9,34,47,0,2,34,55,19,34,7,21,3,7,8,26,55
1995-09-11 00:00:00.000,Bogota Colombia ATP World Tour,CLAY,2,Marcelo Rios,Gaston Etlis,Marcelo Rios,6-4; 3-6; 6-3,R16,78,3,2,52,80,40,52,17,28,1,2,14,57,80,11,5,39,74,28,39,24,35,3,5,14,52,74
1995-09-11 00:00:00.000,Bogota Colombia ATP World Tour,CLAY,2,Nicolas Lapentti,Steve Campbell,Nicolas Lapentti,7-6(2); 6-2,R16,73,5,1,33,52,27,33,13,19,1,2,10,40,52,0,4,42,72,29,42,10,30,5,8,10,39,72
1995-09-11 00:00:00.000,Bogota Colombia ATP World Tour,CLAY,2,Luis Adrian Morejon,MaliVai Washington,Luis Adrian Morejon,6-3; 6-3,R16,67,3,0,37,55,27,37,11,18,4,5,9,38,55,8,6,43,73,30,43,8,30,8,12,9,38,73
1995-09-11 00:00:00.000,Bogota Colombia ATP World Tour,CLAY,2,Alberto Berasategui,Mauricio Hadad,Alberto Berasategui,6-1; 6-2,R16,56,1,3,43,56,27,43,5,13,6,9,8,32,56,1,2,34,48,13,34,4,14,5,12,8,17,48
1995-09-11 00:00:00.000,Bogota Colombia ATP World Tour,CLAY,2,Fernando Meligeni,Hernan Gumy,Fernando Meligeni,6-3; 6-4,Q,67,1,1,24,55,19,24,20,31,2,3,10,39,55,3,2,29,50,20,29,9,21,2,5,9,29,50
1995-09-11 00:00:00.000,Bogota Colombia ATP World Tour,CLAY,2,Miguel Tobon,Karim Alami,Miguel Tobon,6-2; 4-6; 7-5,Q,103,8,5,52,98,35,52,25,46,9,13,15,60,98,3,5,41,77,29,41,17,36,3,9,15,46,77
1995-09-11 00:00:00.000,Bogota Colombia ATP World Tour,CLAY,2,Nicolas Lapentti,Marcelo Rios,Nicolas Lapentti,6-3; 6-4,Q,59,5,0,36,51,29,36,11,15,0,0,10,40,51,1,1,44,66,28,44,13,22,6,8,9,41,66
1995-09-11 00:00:00.000,Bogota Colombia ATP World Tour,CLAY,2,Luis Adrian Morejon,Alberto Berasategui,Luis Adrian Morejon,6-0; 4-6; 6-3,Q,93,3,2,60,87,40,60,16,27,5,7,13,56,87,2,6,58,80,38,58,6,22,5,10,12,44,80
1995-09-11 00:00:00.000,Bogota Colombia ATP World Tour,CLAY,2,Miguel Tobon,Fernando Meligeni,Miguel Tobon,6-3; 6-7(5); 6-3,S,106,10,1,59,95,48,59,20,36,2,3,16,68,95,5,4,48,80,31,48,22,32,1,4,14,53,80
1995-09-11 00:00:00.000,Bogota Colombia ATP World Tour,CLAY,2,Nicolas Lapentti,Luis Adrian Morejon,Nicolas Lapentti,7-5; 6-7(0); 7-5,S,139,11,5,56,102,47,56,25,46,4,6,18,72,102,4,2,67,119,46,67,30,52,4,8,18,76,119
1995-09-11 00:00:00.000,Bogota Colombia ATP World Tour,CLAY,2,Nicolas Lapentti,Miguel Tobon,Nicolas Lapentti,2-6; 6-1; 6-4,F,94,3,3,49,80,33,49,16,31,5,8,13,49,80,4,4,49,80,29,49,18,31,2,6,12,47,80
1995-09-11 00:00:00.000,Bordeaux France ATP World Tour,HARD,2,Goran Ivanisevic,Paul Wekesa,Goran Ivanisevic,6-3; 6-1,R32,48,8,2,21,50,18,21,17,29,3,3,8,35,50,2,1,18,39,13,18,5,21,1,5,8,18,39
1995-09-11 00:00:00.000,Bordeaux France ATP World Tour,HARD,2,Radomir Vasek,Chris Wilkinson,Radomir Vasek,6-4; 5-7; 6-1,R32,112,4,8,49,92,37,49,24,43,5,7,15,61,92,11,4,50,89,38,50,15,39,2,6,14,53,89
1995-09-11 00:00:00.000,Bordeaux France ATP World Tour,HARD,2,Dick Norman,Kris Goossens,Dick Norman,7-6(3); 6-3,R32,103,6,7,45,77,31,45,18,32,6,9,11,49,77,3,5,45,90,26,45,22,45,12,16,10,48,90
1995-09-11 00:00:00.000,Bordeaux France ATP World Tour,HARD,2,Jakob Hlasek,Alexander Mronz,Jakob Hlasek,6-3; 6-3,R32,66,3,0,27,48,20,27,15,21,0,1,9,35,48,3,6,32,66,24,32,11,34,5,9,9,35,66
1995-09-11 00:00:00.000,Bordeaux France ATP World Tour,HARD,2,Stefano Pescosolido,Marc Rosset,Stefano Pescosolido,6-1; 1-0 RET,R32,36,2,1,10,23,9,10,8,13,0,0,5,17,23,2,5,16,30,10,16,4,14,5,8,4,14,30
1995-09-11 00:00:00.000,Bordeaux France ATP World Tour,HARD,2,Jason Stoltenberg,Olivier Mutis,Jason Stoltenberg,6-2; 6-2,R32,55,5,4,26,54,23,26,13,28,3,4,8,36,54,2,4,22,45,10,22,10,23,3,8,8,20,45
1995-09-11 00:00:00.000,Bordeaux France ATP World Tour,HARD,2,Danny Sapsford,Gianluca Pozzi,Danny Sapsford,6-1; 6-2,R32,54,0,0,37,46,28,37,6,9,1,1,8,34,46,0,1,17,45,8,17,14,28,5,9,7,22,45
1995-09-11 00:00:00.000,Bordeaux France ATP World Tour,HARD,2,Olivier Delaitre,Nuno Marques,Olivier Delaitre,6-4; 6-2,R32,71,0,1,20,50,18,20,21,30,1,1,9,39,50,1,1,52,69,28,52,10,17,3,6,9,38,69
1995-09-11 00:00:00.000,Bordeaux France ATP World Tour,HARD,2,David Prinosil,Gilles Bastie,David Prinosil,7-6(3); 6-2,R32,83,4,3,23,69,17,23,26,46,7,9,10,43,69,0,3,59,83,33,59,9,24,3,7,10,42,83
1995-09-11 00:00:00.000,Bordeaux France ATP World Tour,HARD,2,Yahiya Doumbia,Rodolphe Gilbert,Yahiya Doumbia,6-2; 6-4,R32,69,1,0,34,53,23,34,10,19,3,5,9,33,53,0,2,23,52,17,23,8,29,0,5,9,25,52
1995-09-11 00:00:00.000,Bordeaux France ATP World Tour,HARD,2,Guillaume Raoux,Jordi Burillo,Guillaume Raoux,7-6(3); 0-6; 7-6(2),R32,118,7,3,53,103,41,53,26,50,2,6,15,67,103,13,3,66,107,57,66,14,41,5,6,15,71,107
1995-09-11 00:00:00.000,Bordeaux France ATP World Tour,HARD,2,Greg Rusedski,Jim Grabb,Greg Rusedski,6-3; 3-6; 6-1,R32,92,4,3,45,73,38,45,15,28,4,5,13,53,73,2,4,48,75,30,48,15,27,1,4,12,45,75
1995-09-11 00:00:00.000,Bordeaux France ATP World Tour,HARD,2,Lionel Roux,Henri Leconte,Lionel Roux,6-2; 3-6; 6-3,R32,110,5,1,55,80,37,55,14,25,4,6,13,51,80,6,1,34,77,21,34,25,43,2,6,13,46,77
1995-09-11 00:00:00.000,Bordeaux France ATP World Tour,HARD,2,Johan Van Herck,Jeremy Bates,Johan Van Herck,6-3; 7-6(1),R32,85,4,0,44,64,33,44,11,20,6,7,10,44,64,2,3,41,70,28,41,12,29,2,5,11,40,70
1995-09-11 00:00:00.000,Bordeaux France ATP World Tour,HARD,2,Ronald Agenor,Cristiano Caratti,Ronald Agenor,6-2; 7-5,R32,72,8,2,38,60,31,38,11,22,1,1,10,42,60,1,5,34,59,22,34,13,25,2,5,10,35,59
1995-09-11 00:00:00.000,Bordeaux France ATP World Tour,HARD,2,Wayne Ferreira,Sjeng Schalken,Wayne Ferreira,6-3; 6-4,R32,74,6,3,37,72,24,37,20,35,6,8,10,44,72,2,7,34,62,20,34,12,28,6,10,9,32,62
1995-09-11 00:00:00.000,Bordeaux France ATP World Tour,HARD,2,Goran Ivanisevic,Radomir Vasek,Goran Ivanisevic,6-4; 6-3,R16,62,8,0,27,49,23,27,12,22,1,2,9,35,49,5,8,34,64,22,34,14,30,3,7,10,36,64
1995-09-11 00:00:00.000,Bordeaux France ATP World Tour,HARD,2,Jakob Hlasek,Dick Norman,Jakob Hlasek,6-1; 7-6(7),R16,79,2,2,39,69,26,39,20,30,3,5,10,46,69,6,5,45,68,27,45,9,23,7,11,9,36,68
1995-09-11 00:00:00.000,Bordeaux France ATP World Tour,HARD,2,Jason Stoltenberg,Stefano Pescosolido,Jason Stoltenberg,6-4; 6-4,R16,91,6,3,34,63,27,34,15,29,2,3,10,42,63,3,2,43,75,28,43,16,32,9,12,10,44,75
1995-09-11 00:00:00.000,Bordeaux France ATP World Tour,HARD,2,Olivier Delaitre,Danny Sapsford,Olivier Delaitre,7-5; 6-0,R16,78,3,3,34,70,25,34,18,36,6,7,9,43,70,1,1,35,55,14,35,11,20,2,7,9,25,55
1995-09-11 00:00:00.000,Bordeaux France ATP World Tour,HARD,2,Yahiya Doumbia,David Prinosil,Yahiya Doumbia,6-3; 6-2,R16,66,6,3,25,47,18,25,10,22,3,5,8,28,47,3,1,24,58,13,24,12,34,4,10,9,25,58
1995-09-11 00:00:00.000,Bordeaux France ATP World Tour,HARD,2,Guillaume Raoux,Greg Rusedski,Guillaume Raoux,4-6; 7-6(5); 6-4,R16,123,3,6,58,115,49,58,26,57,10,12,16,75,115,15,7,58,104,46,58,22,46,5,7,16,68,104
1995-09-11 00:00:00.000,Bordeaux France ATP World Tour,HARD,2,Lionel Roux,Johan Van Herck,Lionel Roux,6-3; 6-2,R16,73,4,1,32,51,25,32,11,19,1,2,9,36,51,1,2,31,57,16,31,13,26,1,5,8,29,57
1995-09-11 00:00:00.000,Bordeaux France ATP World Tour,HARD,2,Ronald Agenor,Wayne Ferreira,Ronald Agenor,6-3; 5-7; 6-1,R16,120,3,1,61,88,37,61,17,27,4,8,14,54,88,4,0,48,96,32,48,17,48,7,14,14,49,96
1995-09-11 00:00:00.000,Bordeaux France ATP World Tour,HARD,2,Jakob Hlasek,Goran Ivanisevic,Jakob Hlasek,6-3; 6-1,Q,42,9,1,32,36,31,32,1,4,0,0,8,32,36,5,2,27,58,16,27,14,31,9,13,8,30,58
1995-09-11 00:00:00.000,Bordeaux France ATP World Tour,HARD,2,Jason Stoltenberg,Olivier Delaitre,Jason Stoltenberg,4-6; 7-6(4); 6-1,Q,127,6,2,51,90,31,51,25,39,3,7,14,56,90,2,6,56,112,37,56,23,56,8,14,15,60,112
1995-09-11 00:00:00.000,Bordeaux France ATP World Tour,HARD,2,Yahiya Doumbia,Guillaume Raoux,Yahiya Doumbia,6-2; 6-2,Q,73,7,2,40,67,32,40,11,27,2,2,8,43,67,0,1,28,52,15,28,13,24,5,9,8,28,52
1995-09-11 00:00:00.000,Bordeaux France ATP World Tour,HARD,2,Lionel Roux,Ronald Agenor,Lionel Roux,6-1; 6-2,Q,64,1,1,29,43,23,29,10,14,0,0,8,33,43,3,1,36,50,19,36,5,14,5,9,7,24,50
1995-09-11 00:00:00.000,Bordeaux France ATP World Tour,HARD,2,Jakob Hlasek,Jason Stoltenberg,Jakob Hlasek,6-4; 7-5,S,77,2,3,45,72,34,45,12,27,5,7,11,46,72,0,2,27,58,23,27,13,31,2,6,11,36,58
1995-09-11 00:00:00.000,Bordeaux France ATP World Tour,HARD,2,Yahiya Doumbia,Lionel Roux,Yahiya Doumbia,6-4; 6-2,S,82,3,0,35,54,27,35,12,19,0,0,9,39,54,1,0,34,60,21,34,15,26,7,10,9,36,60
1995-09-11 00:00:00.000,Bordeaux France ATP World Tour,HARD,2,Yahiya Doumbia,Jakob Hlasek,Yahiya Doumbia,6-4; 6-4,F,82,2,0,42,69,27,42,18,27,4,5,10,45,69,4,3,30,57,22,30,13,27,2,5,10,35,57
1995-09-11 00:00:00.000,Bucharest Romania ATP World Tour,CLAY,2,Thomas Muster,Tomas Carbonell,Thomas Muster,6-4; 6-4,R32,86,3,1,42,70,25,42,14,28,2,5,10,39,70,3,5,43,67,26,43,8,24,9,14,10,34,67
1995-09-11 00:00:00.000,Bucharest Romania ATP World Tour,CLAY,2,Cedric Pioline,Slava Dosedel,Cedric Pioline,6-0; 6-0,R32,49,1,1,17,32,15,17,10,15,1,1,6,25,32,0,1,31,42,12,31,1,11,2,8,6,13,42
1995-09-11 00:00:00.000,Bucharest Romania ATP World Tour,CLAY,2,Renzo Furlan,Jose Imaz-Ruiz,Renzo Furlan,6-4; 6-0,R32,87,4,1,35,59,25,35,12,24,6,7,8,37,59,2,0,50,65,25,50,5,15,8,13,8,30,65
1995-09-11 00:00:00.000,Bucharest Romania ATP World Tour,CLAY,2,Arnaud Boetsch,Patrick Rafter,Arnaud Boetsch,6-4; 6-4,R32,83,0,3,38,63,29,38,11,25,7,9,10,40,63,1,6,34,69,22,34,16,35,4,8,10,38,69
1995-09-11 00:00:00.000,Bucharest Romania ATP World Tour,CLAY,2,Sergi Bruguera,George Cosac,Sergi Bruguera,7-6(3); 6-2,R32,100,5,0,35,71,25,35,24,36,5,6,10,49,71,2,6,44,81,34,44,13,37,6,9,10,47,81
1995-09-11 00:00:00.000,Bucharest Romania ATP World Tour,CLAY,2,Adrian Voinea,Fabrice Santoro,Adrian Voinea,6-3; 6-2,R32,76,2,1,26,51,21,26,18,25,3,3,9,39,51,3,1,36,54,22,36,8,18,3,6,8,30,54
1995-09-11 00:00:00.000,Bucharest Romania ATP World Tour,CLAY,2,Sandor Noszaly,Dinu Pescariu,Sandor Noszaly,6-2; 6-1,R32,54,4,4,34,44,25,34,5,10,1,2,8,30,44,2,0,31,44,15,31,4,13,7,12,7,19,44
1995-09-11 00:00:00.000,Bucharest Romania ATP World Tour,CLAY,2,Albert Costa,Javier Sanchez,Albert Costa,2-6; 6-4; 6-3,R32,99,1,0,68,84,41,68,9,16,6,10,14,50,84,2,2,47,73,32,47,9,26,3,7,13,41,73
1995-09-11 00:00:00.000,Bucharest Romania ATP World Tour,CLAY,2,Gilbert Schaller,Marc-Kevin Goellner,Gilbert Schaller,6-3; 7-6(5),R32,91,0,0,51,57,37,51,4,6,0,2,10,41,57,8,4,37,80,26,37,20,43,6,10,11,46,80
1995-09-11 00:00:00.000,Bucharest Romania ATP World Tour,CLAY,2,Bohdan Ulihrach,Guy Forget,Bohdan Ulihrach,6-4; 6-3,R32,79,3,0,20,41,16,20,15,21,1,3,9,31,41,2,2,40,81,26,40,15,41,7,12,10,41,81
1995-09-11 00:00:00.000,Bucharest Romania ATP World Tour,CLAY,2,Andrew Ilie,Remus Farcas,Andrew Ilie,7-5; 6-3,R32,73,6,4,35,64,23,35,16,29,3,5,11,39,64,1,0,46,55,26,46,6,9,3,7,10,32,55
1995-09-11 00:00:00.000,Bucharest Romania ATP World Tour,CLAY,2,Andrea Gaudenzi,Daniel Vacek,Andrea Gaudenzi,7-6(6); 6-4,R32,91,4,0,55,76,39,55,12,21,2,3,11,51,76,8,1,46,83,31,46,20,37,6,8,11,51,83
1995-09-11 00:00:00.000,Bucharest Romania ATP World Tour,CLAY,2,Francisco Clavet,Carlos Costa,Francisco Clavet,7-5 RET,R32,72,0,3,23,40,17,23,5,17,6,8,7,22,40,3,2,27,50,17,27,7,23,2,5,6,24,50
1995-09-11 00:00:00.000,Bucharest Romania ATP World Tour,CLAY,2,Jordi Arrese,Mark Philippoussis,Jordi Arrese,6-2; 6-2,R32,69,0,0,42,56,30,42,8,14,1,1,8,38,56,4,3,28,46,21,28,4,18,1,5,8,25,46
1995-09-11 00:00:00.000,Bucharest Romania ATP World Tour,CLAY,2,Christian Ruud,Karol Kucera,Christian Ruud,7-5; 0-6; 6-3,R32,128,1,1,53,83,29,53,14,30,5,11,13,43,83,3,7,48,91,33,48,15,43,4,10,14,48,91
1995-09-11 00:00:00.000,Bucharest Romania ATP World Tour,CLAY,2,Jeff Tarango,Michael Stich,Jeff Tarango,7-6(5); 6-3,R32,91,3,2,49,80,32,49,20,31,9,10,10,52,80,5,3,40,69,26,40,13,29,0,3,11,39,69
1995-09-11 00:00:00.000,Bucharest Romania ATP World Tour,CLAY,2,Thomas Muster,Cedric Pioline,Thomas Muster,7-5; 6-3,R16,85,3,1,37,55,30,37,9,18,2,3,10,39,55,3,2,41,73,23,41,16,32,3,7,11,39,73
1995-09-11 00:00:00.000,Bucharest Romania ATP World Tour,CLAY,2,Arnaud Boetsch,Renzo Furlan,Arnaud Boetsch,6-2; 6-2,R16,96,2,2,33,71,20,33,20,38,8,10,8,40,71,2,2,27,52,12,27,10,25,6,12,8,22,52
1995-09-11 00:00:00.000,Bucharest Romania ATP World Tour,CLAY,2,Sergi Bruguera,Adrian Voinea,Sergi Bruguera,6-1; 6-2,R16,51,5,0,22,42,20,22,14,20,0,0,8,34,42,0,0,28,45,13,28,8,17,4,8,7,21,45
1995-09-11 00:00:00.000,Bucharest Romania ATP World Tour,CLAY,2,Sandor Noszaly,Albert Costa,Sandor Noszaly,6-4; 3-0 RET,R16,48,6,1,24,37,20,24,9,13,1,1,7,29,37,1,1,28,34,17,28,2,6,1,3,7,19,34
1995-09-11 00:00:00.000,Bucharest Romania ATP World Tour,CLAY,2,Gilbert Schaller,Bohdan Ulihrach,Gilbert Schaller,7-5; 6-2,R16,102,1,0,45,72,28,45,16,27,8,11,10,44,72,0,3,42,72,22,42,11,30,10,16,10,33,72
1995-09-11 00:00:00.000,Bucharest Romania ATP World Tour,CLAY,2,Andrea Gaudenzi,Andrew Ilie,Andrea Gaudenzi,3-6; 6-3; 6-3,R16,106,0,0,50,78,34,50,16,28,4,6,13,50,78,7,8,50,90,34,50,20,40,5,9,14,54,90
1995-09-11 00:00:00.000,Bucharest Romania ATP World Tour,CLAY,2,Jordi Arrese,Francisco Clavet,Jordi Arrese,6-2; 6-3,R16,82,1,1,44,59,31,44,7,15,3,4,9,38,59,3,0,30,52,17,30,10,22,3,7,8,27,52
1995-09-11 00:00:00.000,Bucharest Romania ATP World Tour,CLAY,2,Christian Ruud,Jeff Tarango,Christian Ruud,6-2; 7-6(7),R16,114,6,3,57,78,36,57,10,21,5,8,10,46,78,2,2,60,94,31,60,17,34,10,15,10,48,94
1995-09-11 00:00:00.000,Bucharest Romania ATP World Tour,CLAY,2,Thomas Muster,Arnaud Boetsch,Thomas Muster,6-4; 6-4,Q,97,2,3,32,68,22,32,17,36,2,5,10,39,68,6,4,52,85,30,52,15,33,8,13,10,45,85
1995-09-11 00:00:00.000,Bucharest Romania ATP World Tour,CLAY,2,Sandor Noszaly,Sergi Bruguera,Sandor Noszaly,6-4; 6-2,Q,68,2,2,37,46,28,37,5,9,2,3,9,33,46,3,1,37,56,24,37,7,19,7,11,9,31,56
1995-09-11 00:00:00.000,Bucharest Romania ATP World Tour,CLAY,2,Gilbert Schaller,Andrea Gaudenzi,Gilbert Schaller,6-3; 4-6; 6-3,Q,128,2,0,54,74,35,54,11,20,4,8,14,46,74,4,3,54,91,34,54,15,37,6,12,14,49,91
1995-09-11 00:00:00.000,Bucharest Romania ATP World Tour,CLAY,2,Christian Ruud,Jordi Arrese,Christian Ruud,6-7(4); 6-4; 6-4,Q,175,1,3,57,103,33,57,25,46,9,14,15,58,103,2,1,87,112,44,87,14,25,12,20,15,58,112
1995-09-11 00:00:00.000,Bucharest Romania ATP World Tour,CLAY,2,Thomas Muster,Sandor Noszaly,Thomas Muster,6-2; 6-2,S,66,3,1,33,44,27,33,6,11,0,0,8,33,44,2,3,40,57,24,40,5,17,4,8,8,29,57
1995-09-11 00:00:00.000,Bucharest Romania ATP World Tour,CLAY,2,Gilbert Schaller,Christian Ruud,Gilbert Schaller,6-3; 7-6(5),S,114,3,2,41,64,27,41,10,23,1,5,11,37,64,0,2,41,70,25,41,10,29,3,8,10,35,70
1995-09-11 00:00:00.000,Bucharest Romania ATP World Tour,CLAY,2,Thomas Muster,Gilbert Schaller,Thomas Muster,6-3; 6-4,F,75,2,0,46,54,27,46,5,8,3,6,10,32,54,1,2,33,48,18,33,5,15,0,5,9,23,48
1995-09-25 00:00:00.000,Basel Switzerland ATP World Tour,HARD,2,Boris Becker,Byron Black,Boris Becker,6-4; 6-3,R32,85,11,7,36,68,32,36,14,32,2,2,10,46,68,3,7,34,68,26,34,14,34,4,6,9,40,68
1995-09-25 00:00:00.000,Basel Switzerland ATP World Tour,HARD,2,Yannick Noah,Martin Sinner,Yannick Noah,6-3; 7-6(7),R32,96,9,1,39,67,29,39,14,28,1,4,11,43,67,3,6,50,91,28,50,20,41,6,10,10,48,91
1995-09-25 00:00:00.000,Basel Switzerland ATP World Tour,HARD,2,Daniel Vacek,Alexander Volkov,Daniel Vacek,7-5; 6-2,R32,71,7,4,30,62,22,30,16,32,4,6,10,38,62,2,9,28,69,21,28,15,41,11,16,10,36,69
1995-09-25 00:00:00.000,Basel Switzerland ATP World Tour,HARD,2,Stefan Edberg,Cedric Pioline,Stefan Edberg,7-5; 4-6; 6-2,R32,114,4,6,47,86,36,47,22,39,3,6,15,58,86,5,3,56,96,37,56,18,40,6,11,15,55,96
1995-09-25 00:00:00.000,Basel Switzerland ATP World Tour,HARD,2,Thomas Enqvist,Todd Woodbridge,Thomas Enqvist,6-2; 6-3,R32,50,6,1,28,49,24,28,13,21,2,2,9,37,49,5,4,30,51,20,30,9,21,7,10,8,29,51
1995-09-25 00:00:00.000,Basel Switzerland ATP World Tour,HARD,2,Jan Siemerink,Christian Ruud,Jan Siemerink,6-4; 6-3,R32,72,7,5,37,63,30,37,13,26,4,5,10,43,63,0,4,29,52,21,29,8,23,0,3,9,29,52
1995-09-25 00:00:00.000,Basel Switzerland ATP World Tour,HARD,2,David Prinosil,Guillaume Raoux,David Prinosil,3-6; 6-3; 6-4,R32,105,13,3,28,77,25,28,28,49,1,3,14,53,77,3,2,57,93,41,57,15,36,2,5,14,56,93
1995-09-25 00:00:00.000,Basel Switzerland ATP World Tour,HARD,2,Petr Korda,Marc Rosset,Petr Korda,7-6(6); 6-3,R32,81,4,3,39,64,31,39,18,25,4,4,10,49,64,11,2,45,69,40,45,8,24,1,3,11,48,69
1995-09-25 00:00:00.000,Basel Switzerland ATP World Tour,HARD,2,Jim Courier,Karol Kucera,Jim Courier,6-4; 6-2,R32,83,4,3,32,64,26,32,17,32,7,7,9,43,64,3,3,22,48,16,22,12,26,2,5,9,28,48
1995-09-25 00:00:00.000,Basel Switzerland ATP World Tour,HARD,2,Lionel Roux,Joern Renzenbrink,Lionel Roux,4-6; 7-6(4); 6-3,R32,124,9,3,61,103,45,61,28,42,5,6,16,73,103,7,1,57,84,44,57,19,27,0,1,15,63,84
1995-09-25 00:00:00.000,Basel Switzerland ATP World Tour,HARD,2,Martin Damm,Olivier Delaitre,Martin Damm,3-6; 6-3; 7-6(4),R32,125,19,6,58,101,43,58,24,43,0,2,15,67,101,3,4,46,89,32,46,29,43,2,4,15,61,89
1995-09-25 00:00:00.000,Basel Switzerland ATP World Tour,HARD,2,Henrik Holm,Arnaud Boetsch,Henrik Holm,6-3; 7-6(6),R32,90,12,9,40,86,32,40,21,46,5,7,11,53,86,1,6,32,63,19,32,19,31,2,5,10,38,63
1995-09-25 00:00:00.000,Basel Switzerland ATP World Tour,HARD,2,Anders Jarryd,Wayne Ferreira,Anders Jarryd,7-6(4); 2-6; 6-0,R32,106,2,5,45,87,29,45,26,42,5,8,13,55,87,9,6,41,88,29,41,23,47,1,5,13,52,88
1995-09-25 00:00:00.000,Basel Switzerland ATP World Tour,HARD,2,Greg Rusedski,Jakob Hlasek,Greg Rusedski,7-6(2); 6-3,R32,60,12,1,39,61,34,39,15,22,0,0,11,49,61,6,1,42,57,33,42,7,15,2,3,10,40,57
1995-09-25 00:00:00.000,Basel Switzerland ATP World Tour,HARD,2,Jason Stoltenberg,Mats Wilander,Jason Stoltenberg,6-2; 6-2,R32,57,5,1,24,52,20,24,17,28,1,1,8,37,52,3,3,30,51,17,30,10,21,6,10,8,27,51
1995-09-25 00:00:00.000,Basel Switzerland ATP World Tour,HARD,2,Yevgeny Kafelnikov,Guy Forget,Yevgeny Kafelnikov,6-7(6); 6-4; 6-4,R32,134,12,6,52,101,43,52,26,49,4,5,16,69,101,26,7,62,113,51,62,20,51,10,13,16,71,113
1995-09-25 00:00:00.000,Basel Switzerland ATP World Tour,HARD,2,Boris Becker,Yannick Noah,Boris Becker,6-4; 7-5,R16,85,7,4,46,69,36,46,14,23,2,2,11,50,69,3,1,31,59,23,31,15,28,2,4,11,38,59
1995-09-25 00:00:00.000,Basel Switzerland ATP World Tour,HARD,2,Stefan Edberg,Daniel Vacek,Stefan Edberg,6-2; 6-7(4); 6-4,R16,101,7,5,52,83,41,52,22,31,0,0,15,63,83,3,3,65,105,44,65,22,40,4,7,15,66,105
1995-09-25 00:00:00.000,Basel Switzerland ATP World Tour,HARD,2,Jan Siemerink,Thomas Enqvist,Jan Siemerink,6-2; 6-2,R16,68,10,3,37,52,30,37,6,15,0,0,8,36,52,2,6,39,73,22,39,15,34,8,12,8,37,73
1995-09-25 00:00:00.000,Basel Switzerland ATP World Tour,HARD,2,Petr Korda,David Prinosil,Petr Korda,6-2; 7-6(4),R16,77,3,3,46,66,35,46,14,20,5,5,10,49,66,6,2,35,68,26,35,16,33,5,7,10,42,68
1995-09-25 00:00:00.000,Basel Switzerland ATP World Tour,HARD,2,Jim Courier,Lionel Roux,Jim Courier,7-5; 7-6(2),R16,113,12,0,51,75,43,51,12,24,1,1,12,55,75,9,1,39,77,27,39,25,38,1,2,12,52,77
1995-09-25 00:00:00.000,Basel Switzerland ATP World Tour,HARD,2,Martin Damm,Henrik Holm,Martin Damm,7-6(1); 6-4,R16,97,6,1,34,65,29,34,21,31,3,3,11,50,65,7,9,46,79,36,46,14,33,7,8,11,50,79
1995-09-25 00:00:00.000,Basel Switzerland ATP World Tour,HARD,2,Greg Rusedski,Anders Jarryd,Greg Rusedski,7-6(4); 7-6(3),R16,79,21,4,49,74,46,49,14,25,1,1,12,60,74,4,5,42,67,37,42,17,25,0,0,12,54,67
1995-09-25 00:00:00.000,Basel Switzerland ATP World Tour,HARD,2,Jason Stoltenberg,Yevgeny Kafelnikov,Jason Stoltenberg,6-3; 6-3,R16,60,5,4,25,46,24,25,12,21,0,0,9,36,46,0,1,33,53,22,33,9,20,5,8,9,31,53
1995-09-25 00:00:00.000,Basel Switzerland ATP World Tour,HARD,2,Boris Becker,Stefan Edberg,Boris Becker,6-4; 3-6; 6-3,Q,109,11,5,52,88,40,52,20,36,4,5,14,60,88,5,1,45,72,35,45,16,27,0,2,14,51,72
1995-09-25 00:00:00.000,Basel Switzerland ATP World Tour,HARD,2,Jan Siemerink,Petr Korda,Jan Siemerink,3-6; 7-6(4); 7-5,Q,138,9,6,61,101,48,61,15,40,3,7,17,63,101,4,5,83,114,57,83,15,31,10,13,16,72,114
1995-09-25 00:00:00.000,Basel Switzerland ATP World Tour,HARD,2,Jim Courier,Martin Damm,Jim Courier,7-6(5); 7-6(3),Q,119,1,2,44,74,37,44,20,30,0,1,12,57,74,14,4,41,92,30,41,30,51,7,8,12,60,92
1995-09-25 00:00:00.000,Basel Switzerland ATP World Tour,HARD,2,Greg Rusedski,Jason Stoltenberg,Greg Rusedski,3-6; 6-3; 6-2,Q,79,7,5,44,75,29,44,18,31,1,4,13,47,75,4,3,38,68,26,38,13,30,0,5,13,39,68
1995-09-25 00:00:00.000,Basel Switzerland ATP World Tour,HARD,2,Jan Siemerink,Boris Becker,Jan Siemerink,W/O,S,1,0,0,0,0,0,0,0,0,0,0,0,0,0,0,0,0,0,0,0,0,0,0,0,1,0,0
1995-09-25 00:00:00.000,Basel Switzerland ATP World Tour,HARD,2,Jim Courier,Greg Rusedski,Jim Courier,6-4; 6-4,S,77,2,3,36,59,29,36,14,23,3,3,10,43,59,15,4,34,59,28,34,11,25,3,5,10,39,59
1995-09-25 00:00:00.000,Basel Switzerland ATP World Tour,HARD,2,Jim Courier,Jan Siemerink,Jim Courier,6-7(2); 7-6(5); 5-7; 6-2; 7-5,F,249,3,7,114,184,84,114,36,70,9,13,28,120,184,17,6,93,170,73,93,40,77,5,11,28,113,170
1995-09-25 00:00:00.000,Palermo Italy ATP World Tour,CLAY,2,Magnus Norman,Alberto Berasategui,Magnus Norman,6-2; 7-5,R32,69,0,1,38,54,28,38,8,16,1,3,10,36,54,0,0,52,57,27,52,2,5,0,5,10,29,57
1995-09-25 00:00:00.000,Palermo Italy ATP World Tour,CLAY,2,Hernan Gumy,Gaston Etlis,Hernan Gumy,3-6; 6-4; 6-1,R32,103,4,1,33,63,27,33,20,30,1,3,13,47,63,7,2,46,85,32,46,16,39,8,12,13,48,85
1995-09-25 00:00:00.000,Palermo Italy ATP World Tour,CLAY,2,Fabrice Santoro,Corrado Borroni,Fabrice Santoro,7-5; 7-5,R32,103,1,2,49,76,33,49,15,27,6,8,12,48,76,4,6,44,76,30,44,14,32,6,10,12,44,76
1995-09-25 00:00:00.000,Palermo Italy ATP World Tour,CLAY,2,Javier Sanchez,Nuno Marques,Javier Sanchez,4-6; 6-3; 6-4,R32,110,3,1,70,95,38,70,17,25,6,10,15,55,95,6,6,58,87,39,58,10,29,10,15,14,49,87
1995-09-25 00:00:00.000,Palermo Italy ATP World Tour,CLAY,2,Gilbert Schaller,Marcos Ondruska,Gilbert Schaller,7-5; 6-4,R32,113,2,1,51,71,31,51,15,20,5,7,11,46,71,2,2,53,88,32,53,15,35,5,9,11,47,88
1995-09-25 00:00:00.000,Palermo Italy ATP World Tour,CLAY,2,Tomas Carbonell,Diego Nargiso,Tomas Carbonell,7-5; 4-6; 7-5,R32,127,0,1,78,92,46,78,9,14,4,10,17,55,92,7,4,51,100,35,51,21,49,2,9,17,56,100
1995-09-25 00:00:00.000,Palermo Italy ATP World Tour,CLAY,2,Adrian Voinea,Marco Meneschincheri,Adrian Voinea,6-4; 6-2,R32,62,4,3,32,52,26,32,15,20,7,7,9,41,52,1,0,34,53,21,34,10,19,3,6,9,31,53
1995-09-25 00:00:00.000,Palermo Italy ATP World Tour,CLAY,2,Francisco Clavet,Oliver Gross,Francisco Clavet,5-7; 7-5; 6-4,R32,146,2,6,67,108,42,67,23,41,6,11,17,65,108,4,3,71,116,45,71,21,45,5,11,17,66,116
1995-09-25 00:00:00.000,Palermo Italy ATP World Tour,CLAY,2,Bohdan Ulihrach,Karel Novacek,Bohdan Ulihrach,6-3; 6-3,R32,85,3,1,29,60,21,29,22,31,4,4,9,43,60,3,1,35,71,24,35,14,36,7,10,9,38,71
1995-09-25 00:00:00.000,Palermo Italy ATP World Tour,CLAY,2,Marc-Kevin Goellner,Henri Leconte,Marc-Kevin Goellner,7-6(8); 6-4,R32,89,10,2,39,74,30,39,21,35,3,4,11,51,74,7,4,47,79,30,47,20,32,5,7,11,50,79
1995-09-25 00:00:00.000,Palermo Italy ATP World Tour,CLAY,2,Omar Camporese,Richard Fromberg,Omar Camporese,7-6(2); 6-7(4); 6-3,R32,146,11,4,59,106,43,59,28,47,2,6,17,71,106,6,3,66,118,44,66,25,52,9,14,16,69,118
1995-09-25 00:00:00.000,Palermo Italy ATP World Tour,CLAY,2,Alex Corretja,Nicklas Utgren,Alex Corretja,6-1; 6-4,R32,68,1,2,25,47,19,25,15,22,4,5,9,34,47,1,4,30,54,19,30,7,24,4,8,8,26,54
1995-09-25 00:00:00.000,Palermo Italy ATP World Tour,CLAY,2,Alex Lopez Moron,Jordi Arrese,Alex Lopez Moron,4-6; 6-4; 6-4,R32,166,2,4,58,112,42,58,20,54,8,13,15,62,112,1,4,71,106,43,71,16,35,4,10,15,59,106
1995-09-25 00:00:00.000,Palermo Italy ATP World Tour,CLAY,2,Jordi Burillo,Carl-Uwe Steeb,Jordi Burillo,6-1; 6-4,R32,64,6,1,24,45,18,24,13,21,2,3,8,31,45,0,5,34,59,18,34,11,25,1,6,9,29,59
1995-09-25 00:00:00.000,Palermo Italy ATP World Tour,CLAY,2,Magnus Gustafsson,Oscar Martinez,Magnus Gustafsson,6-4; 6-1,R32,70,0,5,26,45,18,26,12,19,0,1,8,30,45,0,2,32,64,19,32,11,32,3,8,9,30,64
1995-09-25 00:00:00.000,Palermo Italy ATP World Tour,CLAY,2,Sjeng Schalken,Andrea Gaudenzi,Sjeng Schalken,6-4; 6-2,R32,63,6,0,31,46,29,31,9,15,2,2,9,38,46,1,2,28,56,17,28,15,28,2,5,9,32,56
1995-09-25 00:00:00.000,Palermo Italy ATP World Tour,CLAY,2,Hernan Gumy,Magnus Norman,Hernan Gumy,6-4; 6-1,R16,73,1,1,27,47,21,27,12,20,1,2,8,33,47,0,0,27,48,18,27,5,21,2,7,9,23,48
1995-09-25 00:00:00.000,Palermo Italy ATP World Tour,CLAY,2,Fabrice Santoro,Javier Sanchez,Fabrice Santoro,6-3; 6-3,R16,84,0,2,42,58,27,42,9,16,4,5,9,36,58,3,3,45,69,24,45,12,24,8,12,9,36,69
1995-09-25 00:00:00.000,Palermo Italy ATP World Tour,CLAY,2,Tomas Carbonell,Gilbert Schaller,Tomas Carbonell,6-7(3); 6-4; 6-4,R16,138,4,3,63,102,45,63,20,39,7,10,16,65,102,3,0,79,104,50,79,11,25,1,6,16,61,104
1995-09-25 00:00:00.000,Palermo Italy ATP World Tour,CLAY,2,Francisco Clavet,Adrian Voinea,Francisco Clavet,6-2; 7-6(4),R16,93,2,3,49,73,36,49,13,24,5,6,10,49,73,1,0,36,64,20,36,19,28,4,7,10,39,64
1995-09-25 00:00:00.000,Palermo Italy ATP World Tour,CLAY,2,Marc-Kevin Goellner,Bohdan Ulihrach,Marc-Kevin Goellner,6-4; 6-4,R16,74,6,0,28,53,23,28,16,25,0,1,10,39,53,1,2,38,70,23,38,17,32,6,9,10,40,70
1995-09-25 00:00:00.000,Palermo Italy ATP World Tour,CLAY,2,Omar Camporese,Alex Corretja,Omar Camporese,6-3; 3-6; 7-6(4),R16,130,3,1,55,106,43,55,27,51,3,5,15,70,106,5,1,74,88,52,74,9,14,4,6,15,61,88
1995-09-25 00:00:00.000,Palermo Italy ATP World Tour,CLAY,2,Jordi Burillo,Alex Lopez Moron,Jordi Burillo,7-6(4); 4-6; 6-3,R16,124,5,1,51,105,35,51,26,54,7,13,16,61,105,5,1,50,88,32,50,18,38,5,11,15,50,88
1995-09-25 00:00:00.000,Palermo Italy ATP World Tour,CLAY,2,Sjeng Schalken,Magnus Gustafsson,Sjeng Schalken,6-4; 6-3,R16,80,2,3,41,74,30,41,19,33,9,10,10,49,74,2,3,35,53,25,35,8,18,2,5,9,33,53
1995-09-25 00:00:00.000,Palermo Italy ATP World Tour,CLAY,2,Hernan Gumy,Fabrice Santoro,Hernan Gumy,3-6; 6-3; 6-3,Q,135,4,2,67,98,48,67,13,31,7,9,13,61,98,2,0,63,81,43,63,8,18,6,10,14,51,81
1995-09-25 00:00:00.000,Palermo Italy ATP World Tour,CLAY,2,Francisco Clavet,Tomas Carbonell,Francisco Clavet,6-4; 7-6(0),Q,90,0,2,40,67,30,40,18,27,3,4,11,48,67,4,1,35,76,27,35,20,41,2,4,11,47,76
1995-09-25 00:00:00.000,Palermo Italy ATP World Tour,CLAY,2,Omar Camporese,Marc-Kevin Goellner,Omar Camporese,5-7; 7-6(4); 7-6(3),Q,164,8,2,61,119,43,61,32,58,7,12,18,75,119,16,2,62,117,50,62,24,55,3,7,18,74,117
1995-09-25 00:00:00.000,Palermo Italy ATP World Tour,CLAY,2,Jordi Burillo,Sjeng Schalken,Jordi Burillo,6-7(4); 6-3; 6-4,Q,112,6,1,49,94,37,49,24,45,2,4,16,61,94,3,2,55,86,37,55,16,31,3,7,15,53,86
1995-09-25 00:00:00.000,Palermo Italy ATP World Tour,CLAY,2,Francisco Clavet,Hernan Gumy,Francisco Clavet,6-0; 6-3,S,71,0,0,30,43,20,30,8,13,0,1,7,28,43,1,1,31,58,13,31,11,27,2,8,8,24,58
1995-09-25 00:00:00.000,Palermo Italy ATP World Tour,CLAY,2,Jordi Burillo,Omar Camporese,Jordi Burillo,6-7(1); 6-3; 6-2,S,105,5,0,44,77,36,44,24,33,0,0,15,60,77,5,1,45,81,36,45,19,36,5,8,14,55,81
1995-09-25 00:00:00.000,Palermo Italy ATP World Tour,CLAY,2,Francisco Clavet,Jordi Burillo,Francisco Clavet,6-7(2); 6-3; 7-6(1),F,140,2,1,84,120,61,84,16,36,9,11,17,77,120,12,2,68,104,51,68,15,36,6,9,16,66,104
1995-10-02 00:00:00.000,Kuala Lumpur Malaysia ATP World Tour,HARD,2,Richard Krajicek,Adam Malik,Richard Krajicek,7-6(1); 6-4,R32,80,8,4,51,77,40,51,15,26,1,1,11,55,77,4,4,45,65,34,45,10,20,0,1,11,44,65
1995-10-02 00:00:00.000,Kuala Lumpur Malaysia ATP World Tour,HARD,2,Sebastien Lareau,Tommy Ho,Sebastien Lareau,7-6(3); 7-5,R32,102,8,4,58,85,41,58,13,27,5,8,12,54,85,5,4,46,83,29,46,17,37,4,8,12,46,83
1995-10-02 00:00:00.000,Kuala Lumpur Malaysia ATP World Tour,HARD,2,Andrei Olhovskiy,Nicola Bruno,Andrei Olhovskiy,4-6; 6-4; 6-1,R32,87,12,4,58,86,46,58,13,28,5,6,14,59,86,6,2,31,76,24,31,24,45,4,7,13,48,76
1995-10-02 00:00:00.000,Kuala Lumpur Malaysia ATP World Tour,HARD,2,Cristiano Caratti,Aaron Krickstein,Cristiano Caratti,7-5; 6-2,R32,71,7,3,38,61,30,38,14,23,2,2,10,44,61,2,1,35,59,22,35,14,24,5,8,10,36,59
1995-10-02 00:00:00.000,Kuala Lumpur Malaysia ATP World Tour,HARD,2,Jacco Eltingh,Tim Henman,Jacco Eltingh,6-3; 6-4,R32,65,6,1,36,58,27,36,14,22,0,1,10,41,58,0,2,28,48,18,28,12,20,6,9,9,30,48
1995-10-02 00:00:00.000,Kuala Lumpur Malaysia ATP World Tour,HARD,2,Paul Wekesa,Selvam Veerasingam,Paul Wekesa,1-6; 7-6(2); 6-4,R32,115,0,5,73,90,48,73,7,17,5,9,14,55,90,8,8,56,95,41,56,20,39,3,6,15,61,95
1995-10-02 00:00:00.000,Kuala Lumpur Malaysia ATP World Tour,HARD,2,Hendrik Dreekmann,Danny Sapsford,Hendrik Dreekmann,6-2; 6-3,R32,68,5,3,23,46,19,23,17,23,0,0,9,36,46,1,3,40,69,29,40,10,29,9,12,8,39,69
1995-10-02 00:00:00.000,Kuala Lumpur Malaysia ATP World Tour,HARD,2,Marcelo Rios,Sandon Stolle,Marcelo Rios,7-6(6); 4-6; 7-6(2),R32,142,7,2,80,119,58,80,19,39,6,9,17,77,119,13,6,81,119,60,81,14,38,5,7,17,74,119
1995-10-02 00:00:00.000,Kuala Lumpur Malaysia ATP World Tour,HARD,2,Renzo Furlan,Michael Tebbutt,Renzo Furlan,6-7(2); 6-0; 6-3,R32,124,3,2,50,87,38,50,24,37,4,4,14,62,87,10,4,46,100,35,46,25,54,9,13,13,60,100
1995-10-02 00:00:00.000,Kuala Lumpur Malaysia ATP World Tour,HARD,2,Gianluca Pozzi,Albert Chang,Gianluca Pozzi,6-4; 6-4,R32,72,3,1,30,55,22,30,18,25,1,2,10,40,55,4,4,31,54,25,31,11,23,3,6,10,36,54
1995-10-02 00:00:00.000,Kuala Lumpur Malaysia ATP World Tour,HARD,2,Lars Rehmann,Alexander Mronz,Lars Rehmann,4-6; 7-6(5); 7-5,R32,133,22,11,62,105,53,62,21,43,2,3,17,74,105,17,1,54,94,45,54,25,40,1,2,17,70,94
1995-10-02 00:00:00.000,Kuala Lumpur Malaysia ATP World Tour,HARD,2,Patrick McEnroe,Jonathan Stark,Patrick McEnroe,3-6; 6-3; 6-4,R32,111,3,2,60,84,46,60,14,24,3,4,14,60,84,16,2,51,85,42,51,14,34,3,5,14,56,85
1995-10-02 00:00:00.000,Kuala Lumpur Malaysia ATP World Tour,HARD,2,Byron Black,Jeremy Bates,Byron Black,7-6(7); 7-6(2),R32,105,6,3,40,84,32,40,23,44,3,5,12,55,84,6,3,41,80,31,41,21,39,3,5,12,52,80
1995-10-02 00:00:00.000,Kuala Lumpur Malaysia ATP World Tour,HARD,2,Mark Philippoussis,Jamie Morgan,Mark Philippoussis,1-6; 7-6(2); 6-4,R32,119,13,3,53,95,41,53,21,42,5,7,14,62,95,11,1,60,85,49,60,13,25,4,5,15,62,85
1995-10-02 00:00:00.000,Kuala Lumpur Malaysia ATP World Tour,HARD,2,Kenneth Carlsen,Michael Joyce,Kenneth Carlsen,7-6(1); 6-7(5); 6-0,R32,122,23,5,56,95,46,56,24,39,4,4,15,70,95,0,5,63,96,41,63,19,33,2,5,15,60,96
1995-10-02 00:00:00.000,Kuala Lumpur Malaysia ATP World Tour,HARD,2,Paul Haarhuis,Shuzo Matsuoka,Paul Haarhuis,6-7(5); 6-4; 6-3,R32,123,3,2,70,97,50,70,17,27,2,3,16,67,97,18,6,67,103,52,67,15,36,4,7,15,67,103
1995-10-02 00:00:00.000,Kuala Lumpur Malaysia ATP World Tour,HARD,2,Richard Krajicek,Sebastien Lareau,Richard Krajicek,7-6(3); 6-4,R16,75,16,1,44,59,35,44,8,15,0,1,11,43,59,6,2,47,74,28,47,17,27,5,7,11,45,74
1995-10-02 00:00:00.000,Kuala Lumpur Malaysia ATP World Tour,HARD,2,Cristiano Caratti,Andrei Olhovskiy,Cristiano Caratti,5-4 RET,R16,39,3,0,21,27,14,21,3,6,2,3,5,17,27,4,5,19,30,14,19,2,11,1,3,5,16,30
1995-10-02 00:00:00.000,Kuala Lumpur Malaysia ATP World Tour,HARD,2,Jacco Eltingh,Paul Wekesa,Jacco Eltingh,6-3; 6-2,R16,52,10,1,30,41,26,30,10,11,0,0,9,36,41,0,2,38,52,18,38,8,14,2,5,8,26,52
1995-10-02 00:00:00.000,Kuala Lumpur Malaysia ATP World Tour,HARD,2,Marcelo Rios,Hendrik Dreekmann,Marcelo Rios,3-6; 6-2; 6-2,R16,87,2,4,47,69,37,47,13,22,2,4,13,50,69,8,9,44,83,29,44,19,39,6,10,12,48,83
1995-10-02 00:00:00.000,Kuala Lumpur Malaysia ATP World Tour,HARD,2,Renzo Furlan,Gianluca Pozzi,Renzo Furlan,6-2; 6-1,R16,71,2,0,30,53,21,30,16,23,4,4,8,37,53,3,0,28,50,16,28,8,22,3,7,7,24,50
1995-10-02 00:00:00.000,Kuala Lumpur Malaysia ATP World Tour,HARD,2,Patrick McEnroe,Lars Rehmann,Patrick McEnroe,6-4; 6-2,R16,74,6,1,35,47,27,35,7,12,2,3,9,34,47,5,16,25,69,17,25,15,44,11,15,9,32,69
1995-10-02 00:00:00.000,Kuala Lumpur Malaysia ATP World Tour,HARD,2,Mark Philippoussis,Byron Black,Mark Philippoussis,6-7(4); 6-2; 6-4,R16,109,44,9,63,98,55,63,14,35,3,3,15,69,98,7,4,53,85,43,53,14,32,2,5,15,57,85
1995-10-02 00:00:00.000,Kuala Lumpur Malaysia ATP World Tour,HARD,2,Paul Haarhuis,Kenneth Carlsen,Paul Haarhuis,7-6(5); 7-6(3),R16,110,2,1,49,78,36,49,18,29,0,2,12,54,78,8,4,43,81,37,43,15,38,6,8,12,52,81
1995-10-02 00:00:00.000,Kuala Lumpur Malaysia ATP World Tour,HARD,2,Cristiano Caratti,Richard Krajicek,Cristiano Caratti,6-2; 6-4,Q,57,4,3,27,52,22,27,16,25,1,2,9,38,52,6,2,35,51,23,35,3,16,4,8,9,26,51
1995-10-02 00:00:00.000,Kuala Lumpur Malaysia ATP World Tour,HARD,2,Marcelo Rios,Jacco Eltingh,Marcelo Rios,7-5; 6-4,Q,71,4,0,37,52,28,37,13,15,0,1,11,41,52,10,6,50,71,35,50,9,21,3,6,11,44,71
1995-10-02 00:00:00.000,Kuala Lumpur Malaysia ATP World Tour,HARD,2,Patrick McEnroe,Renzo Furlan,Patrick McEnroe,7-5; 6-4,Q,98,2,1,35,64,23,35,21,29,2,3,11,44,64,9,1,45,76,28,45,17,31,5,8,11,45,76
1995-10-02 00:00:00.000,Kuala Lumpur Malaysia ATP World Tour,HARD,2,Mark Philippoussis,Paul Haarhuis,Mark Philippoussis,6-1; 6-2,Q,54,16,2,29,45,28,29,6,16,1,1,8,34,45,2,1,30,51,16,30,9,21,8,12,7,25,51
1995-10-02 00:00:00.000,Kuala Lumpur Malaysia ATP World Tour,HARD,2,Marcelo Rios,Cristiano Caratti,Marcelo Rios,6-4; 6-1,S,58,2,0,22,39,19,22,13,17,0,0,8,32,39,1,4,32,55,21,32,8,23,1,5,9,29,55
1995-10-02 00:00:00.000,Kuala Lumpur Malaysia ATP World Tour,HARD,2,Mark Philippoussis,Patrick McEnroe,Mark Philippoussis,6-3; 6-3,S,80,18,4,42,65,36,42,7,23,9,10,9,43,65,1,3,31,56,19,31,10,25,3,7,9,29,56
1995-10-02 00:00:00.000,Kuala Lumpur Malaysia ATP World Tour,HARD,2,Marcelo Rios,Mark Philippoussis,Marcelo Rios,7-6(6); 6-2,F,71,8,2,44,61,37,44,12,17,2,2,10,49,61,18,2,43,66,31,43,13,23,7,9,10,44,66
1995-10-02 00:00:00.000,Toulouse France ATP World Tour,HARD,2,Jim Courier,Martin Damm,Jim Courier,6-3; 6-7(5); 6-4,R32,139,8,2,56,89,44,56,27,33,2,2,16,71,89,21,5,60,110,45,60,26,50,4,6,15,71,110
1995-10-02 00:00:00.000,Toulouse France ATP World Tour,HARD,2,Rodolphe Gilbert,Olivier Delaitre,Rodolphe Gilbert,6-3; 0-6; 7-6(4),R32,133,12,2,45,113,32,45,36,68,10,13,14,68,113,4,2,42,81,32,42,26,39,2,3,13,58,81
1995-10-02 00:00:00.000,Toulouse France ATP World Tour,HARD,2,Jaime Yzaga,Jerome Golmard,Jaime Yzaga,6-4; 6-7(1); 6-4,R32,133,13,0,69,97,47,69,18,28,2,4,16,65,97,10,11,59,104,41,59,23,45,1,5,16,64,104
1995-10-02 00:00:00.000,Toulouse France ATP World Tour,HARD,2,Karol Kucera,Guy Forget,Karol Kucera,7-6(3); 6-3,R32,86,3,3,40,68,28,40,16,28,4,6,10,44,68,5,2,37,67,26,37,11,30,2,6,11,37,67
1995-10-02 00:00:00.000,Toulouse France ATP World Tour,HARD,2,Johan Van Herck,Jan Siemerink,Johan Van Herck,4-5 RET,R32,29,1,1,14,21,9,14,5,7,0,1,5,14,21,1,0,15,26,11,15,7,11,0,1,5,18,26
1995-10-02 00:00:00.000,Toulouse France ATP World Tour,HARD,2,Daniel Vacek,Lionel Roux,Daniel Vacek,4-6; 6-1; 7-5,R32,117,11,2,54,86,40,54,21,32,8,10,15,61,86,3,3,51,89,32,51,20,38,3,7,14,52,89
1995-10-02 00:00:00.000,Toulouse France ATP World Tour,HARD,2,Cedric Pioline,Guillaume Raoux,Cedric Pioline,4-6; 6-4; 6-4,R32,113,9,2,52,79,45,52,15,27,0,1,15,60,79,7,4,45,91,31,45,30,46,3,5,15,61,91
1995-10-02 00:00:00.000,Toulouse France ATP World Tour,HARD,2,Nicolas Escude,Bernd Karbacher,Nicolas Escude,7-6(3); 6-2,R32,79,0,1,38,66,28,38,16,28,4,5,10,44,66,4,1,38,63,24,38,13,25,5,8,10,37,63
1995-10-02 00:00:00.000,Toulouse France ATP World Tour,HARD,2,Jonas Bjorkman,Greg Rusedski,Jonas Bjorkman,3-6; 7-6(2); 6-2,R32,125,3,6,49,93,36,49,24,44,2,5,14,60,93,4,10,57,110,41,57,20,53,7,11,15,61,110
1995-10-02 00:00:00.000,Toulouse France ATP World Tour,HARD,2,Filip Dewulf,Martin Sinner,Filip Dewulf,6-2; 6-2,R32,65,2,1,37,59,29,37,10,22,5,5,8,39,59,0,8,30,58,20,30,8,28,4,8,8,28,58
1995-10-02 00:00:00.000,Toulouse France ATP World Tour,HARD,2,Stefano Pescosolido,David Prinosil,Stefano Pescosolido,7-6(3); 2-6; 7-6(5),R32,132,8,3,66,109,48,66,23,43,2,5,16,71,109,20,8,54,106,41,54,31,52,6,7,16,72,106
1995-10-02 00:00:00.000,Toulouse France ATP World Tour,HARD,2,Arnaud Boetsch,Andrei Chesnokov,Arnaud Boetsch,6-3; 6-4,R32,89,7,4,39,66,29,39,13,27,4,5,10,42,66,4,1,24,58,15,24,18,34,3,6,9,33,58
1995-10-02 00:00:00.000,Toulouse France ATP World Tour,HARD,2,Jared Palmer,Javier Frana,Jared Palmer,7-6(3); 7-6(4),R32,103,1,3,55,87,40,55,17,32,9,12,12,57,87,3,2,51,85,32,51,20,34,7,10,12,52,85
1995-10-02 00:00:00.000,Toulouse France ATP World Tour,HARD,2,Fabrice Santoro,Lionel Barthez,Fabrice Santoro,6-4; 6-3,R32,81,0,3,36,61,25,36,13,25,4,6,10,38,61,3,3,26,53,15,26,13,27,4,8,9,28,53
1995-10-02 00:00:00.000,Toulouse France ATP World Tour,HARD,2,Richey Reneberg,Clement N'Goran,Richey Reneberg,5-7; 6-4; 6-1,R32,120,6,3,48,81,37,48,19,33,6,8,14,56,81,5,1,59,97,38,59,18,38,11,16,15,56,97
1995-10-02 00:00:00.000,Toulouse France ATP World Tour,HARD,2,Marc Rosset,Dick Norman,Marc Rosset,6-2; 7-6(4),R32,77,8,4,35,65,31,35,18,30,4,4,10,49,65,9,5,35,61,29,35,12,26,2,4,10,41,61
1995-10-02 00:00:00.000,Toulouse France ATP World Tour,HARD,2,Jim Courier,Rodolphe Gilbert,Jim Courier,6-4; 6-4,R16,84,3,2,39,54,31,39,10,15,0,1,10,41,54,7,0,38,67,22,38,15,29,7,10,10,37,67
1995-10-02 00:00:00.000,Toulouse France ATP World Tour,HARD,2,Karol Kucera,Jaime Yzaga,Karol Kucera,6-3; 6-4,R16,101,5,2,40,69,28,40,11,29,5,8,10,39,69,0,2,52,85,28,52,15,33,20,25,9,43,85
1995-10-02 00:00:00.000,Toulouse France ATP World Tour,HARD,2,Daniel Vacek,Johan Van Herck,Daniel Vacek,6-3; 7-6(11),R16,92,5,2,38,68,32,38,17,30,0,1,11,49,68,2,2,51,82,34,51,15,31,5,7,10,49,82
1995-10-02 00:00:00.000,Toulouse France ATP World Tour,HARD,2,Cedric Pioline,Nicolas Escude,Cedric Pioline,6-3; 6-3,R16,72,7,0,30,48,26,30,12,18,2,2,9,38,48,1,3,38,65,23,38,13,27,2,5,9,36,65
1995-10-02 00:00:00.000,Toulouse France ATP World Tour,HARD,2,Filip Dewulf,Jonas Bjorkman,Filip Dewulf,7-6(4); 4-6; 6-3,R16,122,3,2,79,119,54,79,23,40,9,12,16,77,119,12,3,54,95,43,54,20,41,9,12,15,63,95
1995-10-02 00:00:00.000,Toulouse France ATP World Tour,HARD,2,Arnaud Boetsch,Stefano Pescosolido,Arnaud Boetsch,6-7(2); 7-5; 6-1,R16,143,9,4,40,92,33,40,28,52,4,7,16,61,92,5,4,63,114,44,63,20,51,7,13,15,64,114
1995-10-02 00:00:00.000,Toulouse France ATP World Tour,HARD,2,Jared Palmer,Fabrice Santoro,Jared Palmer,6-7(3); 7-5; 7-6(7),R16,175,3,9,70,126,50,70,26,56,9,15,18,76,126,7,5,72,126,47,72,27,54,7,14,18,74,126
1995-10-02 00:00:00.000,Toulouse France ATP World Tour,HARD,2,Marc Rosset,Richey Reneberg,Marc Rosset,6-7(4); 6-1; 6-4,R16,125,18,7,69,112,59,69,16,43,9,10,15,75,112,6,2,54,84,39,54,14,30,4,8,14,53,84
1995-10-02 00:00:00.000,Toulouse France ATP World Tour,HARD,2,Jim Courier,Karol Kucera,Jim Courier,6-1; 6-2,Q,83,5,0,35,51,28,35,9,16,7,7,8,37,51,4,6,40,65,21,40,9,25,8,12,7,30,65
1995-10-02 00:00:00.000,Toulouse France ATP World Tour,HARD,2,Cedric Pioline,Daniel Vacek,Cedric Pioline,6-4; 6-3,Q,82,9,1,49,69,36,49,9,20,6,6,9,45,69,3,3,36,58,26,36,10,22,6,9,10,36,58
1995-10-02 00:00:00.000,Toulouse France ATP World Tour,HARD,2,Arnaud Boetsch,Filip Dewulf,Arnaud Boetsch,6-2; 6-4,Q,62,13,3,27,53,23,27,16,26,2,2,9,39,53,2,1,41,58,28,41,6,17,4,7,9,34,58
1995-10-02 00:00:00.000,Toulouse France ATP World Tour,HARD,2,Marc Rosset,Jared Palmer,Marc Rosset,7-6(5); 6-3,Q,94,11,3,41,68,33,41,15,27,3,4,11,48,68,2,6,41,68,30,41,12,27,1,3,10,42,68
1995-10-02 00:00:00.000,Toulouse France ATP World Tour,HARD,2,Jim Courier,Cedric Pioline,Jim Courier,7-6(2); 6-4,S,103,6,1,41,64,35,41,16,23,1,1,11,51,64,6,3,46,73,37,46,11,27,2,3,11,48,73
1995-10-02 00:00:00.000,Toulouse France ATP World Tour,HARD,2,Arnaud Boetsch,Marc Rosset,Arnaud Boetsch,3-6; 7-6(5); 6-4,S,144,4,1,57,102,41,57,26,45,1,3,15,67,102,16,1,54,99,41,54,27,45,2,4,16,68,99
1995-10-02 00:00:00.000,Toulouse France ATP World Tour,HARD,2,Arnaud Boetsch,Jim Courier,Arnaud Boetsch,6-4; 6-7(5); 6-0,F,150,14,2,53,103,41,53,24,50,8,9,14,65,103,6,0,58,94,35,58,15,36,6,11,14,50,94
1995-10-02 00:00:00.000,Valencia Spain ATP World Tour,CLAY,2,Alberto Berasategui,Albert Portas,Alberto Berasategui,6-3; 6-3,R32,62,1,1,52,61,37,52,3,9,4,5,9,40,61,2,5,26,57,17,26,12,31,4,8,9,29,57
1995-10-02 00:00:00.000,Valencia Spain ATP World Tour,CLAY,2,Marcos Ondruska,Jordi Burillo,Marcos Ondruska,3-6; 6-3; 6-2,R32,100,4,5,40,78,29,40,20,38,7,10,13,49,78,4,4,34,80,24,34,20,46,4,9,13,44,80
1995-10-02 00:00:00.000,Valencia Spain ATP World Tour,CLAY,2,Sjeng Schalken,Carlos Moya,Sjeng Schalken,6-2; 6-2,R32,51,3,3,23,45,20,23,10,22,5,6,8,30,45,4,0,32,44,14,32,5,12,3,8,8,19,44
1995-10-02 00:00:00.000,Valencia Spain ATP World Tour,CLAY,2,Bohdan Ulihrach,Emilio Benfele Alvarez,Bohdan Ulihrach,6-3; 6-3,R32,80,1,1,28,61,20,28,22,33,5,5,9,42,61,3,0,28,51,18,28,13,23,1,4,9,31,51
1995-10-02 00:00:00.000,Valencia Spain ATP World Tour,CLAY,2,Albert Costa,Gaston Etlis,Albert Costa,6-3; 6-3,R32,64,2,1,38,59,29,38,9,21,1,2,9,38,59,3,0,24,50,18,24,11,26,0,4,9,29,50
1995-10-02 00:00:00.000,Valencia Spain ATP World Tour,CLAY,2,Magnus Gustafsson,Carl-Uwe Steeb,Magnus Gustafsson,6-2; 6-0,R32,54,2,3,21,46,15,21,18,25,2,2,7,33,46,2,5,22,44,10,22,8,22,4,9,7,18,44
1995-10-02 00:00:00.000,Valencia Spain ATP World Tour,CLAY,2,Felix Mantilla,Oscar Martinez,Felix Mantilla,6-1; 6-3,R32,67,0,1,26,46,20,26,11,20,2,3,8,31,46,0,3,22,58,14,22,13,36,7,12,8,27,58
1995-10-02 00:00:00.000,Valencia Spain ATP World Tour,CLAY,2,Kris Goossens,Carlos Costa,Kris Goossens,7-6(6); 6-0,R32,97,2,4,33,65,22,33,13,32,5,9,9,35,65,2,2,45,76,24,45,9,31,7,14,9,33,76
1995-10-02 00:00:00.000,Valencia Spain ATP World Tour,CLAY,2,Francisco Clavet,Libor Nemecek,Francisco Clavet,6-1; 6-1,R32,46,3,0,22,35,19,22,10,13,0,0,7,29,35,0,1,40,44,18,40,0,4,2,7,7,18,44
1995-10-02 00:00:00.000,Valencia Spain ATP World Tour,CLAY,2,Hernan Gumy,Alex Calatrava,Hernan Gumy,6-3; 6-4,R32,79,3,8,20,48,17,20,16,28,1,3,9,33,48,2,3,34,64,23,34,10,30,7,12,10,33,64
1995-10-02 00:00:00.000,Valencia Spain ATP World Tour,CLAY,2,Richard Fromberg,Karel Novacek,Richard Fromberg,6-4; 6-4,R32,72,10,0,27,46,25,27,16,19,1,1,10,41,46,4,2,40,74,22,40,21,34,7,9,10,43,74
1995-10-02 00:00:00.000,Valencia Spain ATP World Tour,CLAY,2,Alex Corretja,Juan Albert Viloca-Puig,Alex Corretja,7-6(4); 6-1,R32,98,2,1,38,61,29,38,16,23,2,3,10,45,61,2,1,45,76,27,45,16,31,6,9,9,43,76
1995-10-02 00:00:00.000,Valencia Spain ATP World Tour,CLAY,2,Tomas Carbonell,Jordi Arrese,Tomas Carbonell,4-6; 6-3; 6-3,R32,118,3,5,37,87,26,37,24,50,5,10,14,50,87,0,5,75,99,41,75,6,24,6,13,14,47,99
1995-10-02 00:00:00.000,Valencia Spain ATP World Tour,CLAY,2,Alex Lopez Moron,Carsten Arriens,Alex Lopez Moron,3-0 RET,R32,7,1,0,6,10,5,6,3,4,0,0,2,8,10,0,0,4,4,0,4,0,0,0,1,2,0,4
1995-10-02 00:00:00.000,Valencia Spain ATP World Tour,CLAY,2,Emilio Sanchez,Javier Sanchez,Emilio Sanchez,6-0; 6-7(2); 6-2,R32,108,6,0,63,89,43,63,11,26,5,8,13,54,89,3,5,52,85,31,52,9,33,5,13,13,40,85
1995-10-02 00:00:00.000,Valencia Spain ATP World Tour,CLAY,2,Gilbert Schaller,Frederik Fetterlein,Gilbert Schaller,6-4; 6-1,R32,85,2,0,29,51,20,29,12,22,3,5,8,32,51,0,7,43,66,26,43,3,23,5,11,9,29,66
1995-10-02 00:00:00.000,Valencia Spain ATP World Tour,CLAY,2,Alberto Berasategui,Marcos Ondruska,Alberto Berasategui,6-4; 7-6(3),R16,106,1,1,70,80,41,70,6,10,6,9,11,47,80,4,2,22,75,13,22,26,53,2,6,11,39,75
1995-10-02 00:00:00.000,Valencia Spain ATP World Tour,CLAY,2,Sjeng Schalken,Bohdan Ulihrach,Sjeng Schalken,4-6; 6-4; 6-2,R16,114,5,7,51,91,32,51,19,40,8,13,14,51,91,4,4,36,86,21,36,24,50,4,11,14,45,86
1995-10-02 00:00:00.000,Valencia Spain ATP World Tour,CLAY,2,Magnus Gustafsson,Albert Costa,Magnus Gustafsson,6-2; 6-4,R16,73,3,1,30,54,21,30,15,24,4,5,9,36,54,2,2,37,60,18,37,13,23,9,13,9,31,60
1995-10-02 00:00:00.000,Valencia Spain ATP World Tour,CLAY,2,Felix Mantilla,Kris Goossens,Felix Mantilla,6-2; 6-3,R16,87,0,0,40,62,25,40,17,22,3,3,9,42,62,2,1,30,57,20,30,12,27,5,8,8,32,57
1995-10-02 00:00:00.000,Valencia Spain ATP World Tour,CLAY,2,Hernan Gumy,Francisco Clavet,Hernan Gumy,6-4; 6-2,R16,77,3,5,32,53,22,32,10,21,3,6,9,32,53,1,1,31,50,14,31,9,19,5,11,9,23,50
1995-10-02 00:00:00.000,Valencia Spain ATP World Tour,CLAY,2,Richard Fromberg,Alex Corretja,Richard Fromberg,W/O,R16,0,0,0,0,0,0,0,0,0,0,0,1,0,0,0,0,0,0,0,0,0,0,0,0,0,0,0
1995-10-02 00:00:00.000,Valencia Spain ATP World Tour,CLAY,2,Tomas Carbonell,Alex Lopez Moron,Tomas Carbonell,2-6; 7-6(2); 6-4,R16,127,5,2,52,89,37,52,15,37,2,7,15,52,89,3,6,60,111,39,60,22,51,7,11,15,61,111
1995-10-02 00:00:00.000,Valencia Spain ATP World Tour,CLAY,2,Gilbert Schaller,Emilio Sanchez,Gilbert Schaller,7-6(2); 5-7; 7-6(5),R16,192,1,0,104,125,66,104,13,21,6,10,18,79,125,9,1,75,130,52,75,27,55,7,10,18,79,130
1995-10-02 00:00:00.000,Valencia Spain ATP World Tour,CLAY,2,Sjeng Schalken,Alberto Berasategui,Sjeng Schalken,3-6; 6-4; 7-6(3),Q,111,6,9,51,97,39,51,22,46,6,11,16,61,97,1,4,81,106,49,81,13,25,11,15,15,62,106
1995-10-02 00:00:00.000,Valencia Spain ATP World Tour,CLAY,2,Felix Mantilla,Magnus Gustafsson,Felix Mantilla,4-6; 7-6(6); 6-1,Q,135,0,2,75,110,42,75,20,35,7,12,15,62,110,7,13,55,101,34,55,18,46,8,14,14,52,101
1995-10-02 00:00:00.000,Valencia Spain ATP World Tour,CLAY,2,Hernan Gumy,Richard Fromberg,Hernan Gumy,6-1; 6-3,Q,81,2,1,31,50,22,31,12,19,1,1,8,34,50,2,2,25,56,17,25,12,31,7,11,8,29,56
1995-10-02 00:00:00.000,Valencia Spain ATP World Tour,CLAY,2,Gilbert Schaller,Tomas Carbonell,Gilbert Schaller,7-5; 6-2,Q,80,0,0,45,58,29,45,9,13,1,3,10,38,58,2,3,29,68,20,29,16,39,4,9,10,36,68
1995-10-02 00:00:00.000,Valencia Spain ATP World Tour,CLAY,2,Sjeng Schalken,Felix Mantilla,Sjeng Schalken,6-4; 4-6; 6-2,S,111,7,4,55,90,37,55,18,35,2,5,14,55,90,0,0,70,90,41,70,10,20,4,9,14,51,90
1995-10-02 00:00:00.000,Valencia Spain ATP World Tour,CLAY,2,Gilbert Schaller,Hernan Gumy,Gilbert Schaller,5-7; 6-0; 6-4,S,148,0,0,69,89,44,69,9,20,6,11,14,53,89,4,4,54,97,30,54,15,43,8,16,14,45,97
1995-10-02 00:00:00.000,Valencia Spain ATP World Tour,CLAY,2,Sjeng Schalken,Gilbert Schaller,Sjeng Schalken,6-4; 6-2,F,74,2,2,32,62,27,32,14,30,3,3,9,41,62,0,0,41,56,26,41,5,15,1,4,9,31,56
1995-10-09 00:00:00.000,Ostrava Czech Republic ATP World Tour,HARD,2,Bohdan Ulihrach,Yevgeny Kafelnikov,Bohdan Ulihrach,6-2; 6-4,R32,79,5,5,35,84,28,35,25,49,5,5,9,53,84,6,7,40,71,29,40,10,31,7,10,9,39,71
1995-10-09 00:00:00.000,Ostrava Czech Republic ATP World Tour,HARD,2,Patrik Kuhnen,Greg Rusedski,Patrik Kuhnen,1-6; 6-3; 7-6(6),R32,105,9,8,51,94,45,51,18,43,1,3,14,63,94,21,7,57,91,49,57,15,34,5,6,14,64,91
1995-10-09 00:00:00.000,Ostrava Czech Republic ATP World Tour,HARD,2,David Prinosil,Martin Sinner,David Prinosil,6-1; 2-6; 6-1,R32,79,10,1,41,77,29,41,21,36,3,5,12,50,77,4,5,25,66,17,25,22,41,2,6,12,39,66
1995-10-09 00:00:00.000,Ostrava Czech Republic ATP World Tour,HARD,2,Joost Winnink,Javier Frana,Joost Winnink,3-6; 7-5; 7-6(5),R32,123,5,6,55,106,43,55,23,51,8,12,16,66,106,10,5,52,111,37,52,32,59,4,8,17,69,111
1995-10-09 00:00:00.000,Ostrava Czech Republic ATP World Tour,HARD,2,Wayne Ferreira,Otakar Jurecka,Wayne Ferreira,6-1; 6-4,R32,57,9,1,30,54,27,30,11,24,0,0,9,38,54,1,0,38,48,21,38,5,10,5,8,8,26,48
1995-10-09 00:00:00.000,Ostrava Czech Republic ATP World Tour,HARD,2,Martin Damm,Adrian Voinea,Martin Damm,6-2; 3-6; 7-5,R32,106,8,2,47,79,39,47,19,32,5,6,14,58,79,4,5,62,99,45,62,19,37,8,11,15,64,99
1995-10-09 00:00:00.000,Ostrava Czech Republic ATP World Tour,HARD,2,Patrick Rafter,Tom Nijssen,Patrick Rafter,6-7(5); 6-3; 7-6(3),R32,138,13,6,62,105,52,62,21,43,2,3,17,73,105,4,8,57,107,41,57,24,50,4,6,16,65,107
1995-10-09 00:00:00.000,Ostrava Czech Republic ATP World Tour,HARD,2,Jiri Novak,Petr Korda,Jiri Novak,6-2; 6-7(2); 6-0,R32,109,3,0,64,89,48,64,10,25,1,2,13,58,89,7,8,53,97,35,53,19,44,8,14,13,54,97
1995-10-09 00:00:00.000,Ostrava Czech Republic ATP World Tour,HARD,2,Arnaud Boetsch,Daniel Vacek,Arnaud Boetsch,6-7(4); 6-4; 7-6(7),R32,122,7,7,60,116,44,60,32,56,4,7,17,76,116,15,10,61,108,51,61,19,47,0,4,17,70,108
1995-10-09 00:00:00.000,Ostrava Czech Republic ATP World Tour,HARD,2,Nicolas Kiefer,Andrei Chesnokov,Nicolas Kiefer,6-3; 3-6; 6-3,R32,86,6,5,56,86,41,56,14,30,4,7,14,55,86,3,4,48,73,35,48,10,25,5,9,13,45,73
1995-10-09 00:00:00.000,Ostrava Czech Republic ATP World Tour,HARD,2,Olivier Delaitre,Jerome Golmard,Olivier Delaitre,6-3; 6-3,R32,64,4,1,29,54,20,29,15,25,2,4,9,35,54,6,5,32,57,18,32,11,25,2,7,9,29,57
1995-10-09 00:00:00.000,Ostrava Czech Republic ATP World Tour,HARD,2,Andrei Medvedev,Lorenzo Manta,Andrei Medvedev,6-4; 3-6; 6-1,R32,86,5,3,46,78,34,46,17,32,4,5,13,51,78,4,7,41,78,31,41,18,37,3,6,13,49,78
1995-10-09 00:00:00.000,Ostrava Czech Republic ATP World Tour,HARD,2,Jonas Bjorkman,Cedric Pioline,Jonas Bjorkman,7-6(5); 7-5,R32,0,3,6,40,71,34,40,15,31,2,3,12,49,71,6,4,56,88,38,56,16,32,6,8,12,54,88
1995-10-09 00:00:00.000,Ostrava Czech Republic ATP World Tour,HARD,2,Karel Novacek,Lionel Roux,Karel Novacek,3-6; 6-3; 7-6(4),R32,118,12,2,44,89,39,44,27,45,2,3,15,66,89,3,1,52,86,41,52,18,34,1,2,15,59,86
1995-10-09 00:00:00.000,Ostrava Czech Republic ATP World Tour,HARD,2,MaliVai Washington,Petr Luxa,MaliVai Washington,6-1; 6-3,R32,65,3,1,29,53,25,29,12,24,4,4,8,37,53,2,4,31,53,19,31,8,22,5,9,8,27,53
1995-10-09 00:00:00.000,Ostrava Czech Republic ATP World Tour,HARD,2,Guy Forget,Jaroslav Bulant,Guy Forget,6-2; 6-4,R32,55,12,4,26,48,24,26,14,22,3,3,9,38,48,2,3,30,52,17,30,11,22,3,6,9,28,52
1995-10-09 00:00:00.000,Ostrava Czech Republic ATP World Tour,HARD,2,Patrik Kuhnen,Bohdan Ulihrach,Patrik Kuhnen,5-7; 6-3; 6-0,R16,100,10,8,55,97,44,55,16,42,4,6,14,60,97,7,4,62,85,35,62,11,23,4,9,13,46,85
1995-10-09 00:00:00.000,Ostrava Czech Republic ATP World Tour,HARD,2,Joost Winnink,David Prinosil,Joost Winnink,7-6(4); 6-2,R16,73,3,1,28,60,21,28,22,32,1,2,10,43,60,6,3,25,61,19,25,17,36,3,6,10,36,61
1995-10-09 00:00:00.000,Ostrava Czech Republic ATP World Tour,HARD,2,Wayne Ferreira,Martin Damm,Wayne Ferreira,6-4; 7-6(5),R16,94,10,1,38,77,32,38,24,39,5,5,11,56,77,7,7,36,76,29,36,21,40,2,3,11,50,76
1995-10-09 00:00:00.000,Ostrava Czech Republic ATP World Tour,HARD,2,Patrick Rafter,Jiri Novak,Patrick Rafter,6-3; 6-2,R16,59,9,5,29,53,24,29,15,24,3,3,9,39,53,1,2,37,48,26,37,2,11,3,6,8,28,48
1995-10-09 00:00:00.000,Ostrava Czech Republic ATP World Tour,HARD,2,Arnaud Boetsch,Nicolas Kiefer,Arnaud Boetsch,7-5; 6-3,R16,69,5,4,32,58,26,32,17,26,4,4,10,43,58,4,2,39,71,29,39,15,32,3,6,11,44,71
1995-10-09 00:00:00.000,Ostrava Czech Republic ATP World Tour,HARD,2,Andrei Medvedev,Olivier Delaitre,Andrei Medvedev,6-4; 6-4,R16,67,5,1,34,59,27,34,11,25,3,5,10,38,59,3,9,31,63,18,31,15,32,3,7,10,33,63
1995-10-09 00:00:00.000,Ostrava Czech Republic ATP World Tour,HARD,2,Jonas Bjorkman,Karel Novacek,Jonas Bjorkman,6-4; 4-6; 7-5,R16,131,5,6,59,109,43,59,27,50,9,11,16,70,109,15,3,76,123,53,76,20,47,10,13,16,73,123
1995-10-09 00:00:00.000,Ostrava Czech Republic ATP World Tour,HARD,2,MaliVai Washington,Guy Forget,MaliVai Washington,7-6(2); 6-4,R16,98,10,2,48,77,35,48,18,29,6,7,11,53,77,13,6,46,86,37,46,15,40,5,7,11,52,86
1995-10-09 00:00:00.000,Ostrava Czech Republic ATP World Tour,HARD,2,Patrik Kuhnen,Joost Winnink,Patrik Kuhnen,4-6; 6-1; 6-1,Q,90,7,2,34,68,27,34,21,34,1,2,12,48,68,11,9,48,84,37,48,9,36,6,11,12,46,84
1995-10-09 00:00:00.000,Ostrava Czech Republic ATP World Tour,HARD,2,Wayne Ferreira,Patrick Rafter,Wayne Ferreira,6-4; 6-4,Q,65,5,0,27,46,23,27,17,19,0,0,10,40,46,2,1,31,54,22,31,13,23,2,4,10,35,54
1995-10-09 00:00:00.000,Ostrava Czech Republic ATP World Tour,HARD,2,Arnaud Boetsch,Andrei Medvedev,Arnaud Boetsch,6-1; 6-1,Q,53,11,2,23,39,19,23,10,16,0,0,7,29,39,4,2,29,56,17,29,8,27,8,13,7,25,56
1995-10-09 00:00:00.000,Ostrava Czech Republic ATP World Tour,HARD,2,MaliVai Washington,Jonas Bjorkman,MaliVai Washington,6-2; 6-4,Q,74,2,1,42,64,30,42,11,22,4,5,9,41,64,4,7,29,60,19,29,13,31,3,7,9,32,60
1995-10-09 00:00:00.000,Ostrava Czech Republic ATP World Tour,HARD,2,Wayne Ferreira,Patrik Kuhnen,Wayne Ferreira,6-2; 7-5,S,72,9,0,38,68,30,38,14,30,7,8,10,44,68,1,0,29,56,17,29,14,27,2,6,10,31,56
1995-10-09 00:00:00.000,Ostrava Czech Republic ATP World Tour,HARD,2,MaliVai Washington,Arnaud Boetsch,MaliVai Washington,6-3; 6-2,S,70,3,0,36,57,27,36,11,21,3,4,9,38,57,4,1,28,60,14,28,15,32,5,9,8,29,60
1995-10-09 00:00:00.000,Ostrava Czech Republic ATP World Tour,HARD,2,Wayne Ferreira,MaliVai Washington,Wayne Ferreira,3-6; 6-4; 6-3,F,124,12,3,46,107,35,46,27,61,6,10,14,62,107,3,3,58,93,41,58,12,35,8,13,14,53,93
1995-10-09 00:00:00.000,Tel Aviv Israel ATP World Tour,HARD,2,Thomas Muster,Joern Renzenbrink,Thomas Muster,6-7(5); 6-3; 6-4,R32,102,3,3,54,98,40,54,28,44,0,1,16,68,98,10,6,49,88,38,49,19,39,3,6,15,57,88
1995-10-09 00:00:00.000,Tel Aviv Israel ATP World Tour,HARD,2,Frederik Fetterlein,Rodolphe Gilbert,Frederik Fetterlein,7-6(5); 6-4,R32,110,5,5,41,68,34,41,14,27,0,1,11,48,68,7,2,44,92,33,44,22,48,7,9,11,55,92
1995-10-09 00:00:00.000,Tel Aviv Israel ATP World Tour,HARD,2,Arne Thoms,Sandor Noszaly,Arne Thoms,6-4; 6-4,R32,77,6,3,40,64,28,40,13,24,9,11,10,41,64,8,9,39,67,28,39,9,28,2,6,10,37,67
1995-10-09 00:00:00.000,Tel Aviv Israel ATP World Tour,HARD,2,Stefano Pescosolido,Johan Van Herck,Stefano Pescosolido,6-3; 3-6; 6-4,R32,106,12,2,40,66,35,40,16,26,1,3,14,51,66,1,6,67,105,49,67,16,38,8,11,14,65,105
1995-10-09 00:00:00.000,Tel Aviv Israel ATP World Tour,HARD,2,Javier Sanchez,Oliver Gross,Javier Sanchez,6-4; 6-2,R32,63,1,3,35,47,28,35,5,12,3,4,9,33,47,3,6,42,63,24,42,10,21,5,9,9,34,63
1995-10-09 00:00:00.000,Tel Aviv Israel ATP World Tour,HARD,2,Eyal Ran,Wayne Black,Eyal Ran,6-3; 6-1,R32,83,1,2,20,46,13,20,16,26,0,2,8,29,46,0,2,37,71,19,37,13,34,11,17,8,32,71
1995-10-09 00:00:00.000,Tel Aviv Israel ATP World Tour,HARD,2,Richard Fromberg,Chris Wilkinson,Richard Fromberg,6-4; 6-3,R32,61,11,3,30,49,28,30,10,19,2,2,9,38,49,3,1,40,64,31,40,8,24,4,7,10,39,64
1995-10-09 00:00:00.000,Tel Aviv Israel ATP World Tour,HARD,2,Jared Palmer,Nuno Marques,Jared Palmer,6-2; 6-3,R32,61,5,2,37,59,28,37,12,22,4,4,9,40,59,2,4,25,41,20,25,5,16,2,5,8,25,41
1995-10-09 00:00:00.000,Tel Aviv Israel ATP World Tour,HARD,2,Karim Alami,Eyal Erlich,Karim Alami,6-0; 6-2,R32,58,6,0,20,46,17,20,16,26,5,5,7,33,46,2,4,23,46,9,23,10,23,5,10,7,19,46
1995-10-09 00:00:00.000,Tel Aviv Israel ATP World Tour,HARD,2,Radomir Vasek,Jim Grabb,Radomir Vasek,6-2; 1-6; 7-6(4),R32,128,1,10,41,90,32,41,23,49,5,9,14,55,90,4,1,58,94,39,58,20,36,7,10,13,59,94
1995-10-09 00:00:00.000,Tel Aviv Israel ATP World Tour,HARD,2,Noam Behr,Jeff Tarango,Noam Behr,6-4; 3-6; 7-5,R32,117,9,3,62,99,47,62,19,37,3,4,15,66,99,4,5,52,101,38,52,30,49,7,9,16,68,101
1995-10-09 00:00:00.000,Tel Aviv Israel ATP World Tour,HARD,2,David Wheaton,Rainer Schuettler,David Wheaton,6-4; 7-5,R32,90,7,2,50,72,36,50,10,22,7,9,11,46,72,2,5,50,74,30,50,11,24,7,11,11,41,74
1995-10-09 00:00:00.000,Tel Aviv Israel ATP World Tour,HARD,2,Jason Stoltenberg,Gilad Bloom,Jason Stoltenberg,6-3; 6-3,R32,71,1,3,23,50,16,23,14,27,3,5,9,30,50,0,1,25,54,15,25,10,29,5,10,9,25,54
1995-10-09 00:00:00.000,Tel Aviv Israel ATP World Tour,HARD,2,Marcos Ondruska,Wojtek Kowalski,Marcos Ondruska,6-4; 6-4,R32,74,2,1,35,61,23,35,17,26,4,6,10,40,61,5,2,32,58,19,32,13,26,6,10,10,32,58
1995-10-09 00:00:00.000,Tel Aviv Israel ATP World Tour,HARD,2,Jan Kroslak,Thierry Guardiola,Jan Kroslak,6-0; 4-6; 6-3,R32,93,4,3,54,88,41,54,17,34,5,6,13,58,88,7,4,32,68,25,32,14,36,2,6,12,39,68
1995-10-09 00:00:00.000,Tel Aviv Israel ATP World Tour,HARD,2,Oleg Ogorodov,Andrea Gaudenzi,Oleg Ogorodov,6-7(1); 6-4; 7-6(7),R32,155,11,2,68,132,53,68,32,64,9,10,17,85,132,4,5,72,114,56,72,19,42,6,8,17,75,114
1995-10-09 00:00:00.000,Tel Aviv Israel ATP World Tour,HARD,2,Frederik Fetterlein,Thomas Muster,Frederik Fetterlein,6-2; 6-7(1); 6-1,R16,107,3,6,48,85,41,48,16,37,5,6,14,57,85,1,6,49,89,33,49,15,40,9,14,13,48,89
1995-10-09 00:00:00.000,Tel Aviv Israel ATP World Tour,HARD,2,Stefano Pescosolido,Arne Thoms,Stefano Pescosolido,6-3; 7-6(2),R16,70,6,0,39,59,32,39,15,20,2,3,11,47,59,7,5,33,65,26,33,16,32,1,3,10,42,65
1995-10-09 00:00:00.000,Tel Aviv Israel ATP World Tour,HARD,2,Javier Sanchez,Eyal Ran,Javier Sanchez,3-6; 7-5; 7-5,R16,140,3,5,48,89,31,48,18,41,5,11,16,49,89,7,3,53,111,36,53,26,58,5,12,17,62,111
1995-10-09 00:00:00.000,Tel Aviv Israel ATP World Tour,HARD,2,Jared Palmer,Richard Fromberg,Jared Palmer,7-6(7); 7-5,R16,97,1,4,34,68,26,34,21,34,2,4,12,47,68,12,5,38,78,33,38,14,40,5,8,12,47,78
1995-10-09 00:00:00.000,Tel Aviv Israel ATP World Tour,HARD,2,Radomir Vasek,Karim Alami,Radomir Vasek,6-3; 6-4,R16,86,2,3,34,74,25,34,23,40,6,7,10,48,74,4,2,26,58,18,26,15,32,3,6,9,33,58
1995-10-09 00:00:00.000,Tel Aviv Israel ATP World Tour,HARD,2,David Wheaton,Noam Behr,David Wheaton,6-7(4); 6-3; 7-6(10),R16,145,12,4,62,94,50,62,21,32,0,1,16,71,94,9,8,62,126,46,62,34,64,4,7,17,80,126
1995-10-09 00:00:00.000,Tel Aviv Israel ATP World Tour,HARD,2,Jason Stoltenberg,Marcos Ondruska,Jason Stoltenberg,2-6; 7-6(6); 6-1,R16,136,3,0,53,97,34,53,23,44,5,9,14,57,97,0,3,69,102,46,69,11,33,10,14,13,57,102
1995-10-09 00:00:00.000,Tel Aviv Israel ATP World Tour,HARD,2,Jan Kroslak,Oleg Ogorodov,Jan Kroslak,6-7(12); 7-5; 6-3,R16,131,10,2,84,113,60,84,15,29,6,8,17,75,113,7,1,65,113,49,65,17,48,5,9,16,66,113
1995-10-09 00:00:00.000,Tel Aviv Israel ATP World Tour,HARD,2,Stefano Pescosolido,Frederik Fetterlein,Stefano Pescosolido,6-3; 7-6(8),Q,105,7,3,33,68,26,33,19,35,0,2,11,45,68,5,6,46,88,29,46,19,42,11,14,10,48,88
1995-10-09 00:00:00.000,Tel Aviv Israel ATP World Tour,HARD,2,Javier Sanchez,Jared Palmer,Javier Sanchez,7-6(5); 6-3,Q,73,3,1,46,65,36,46,11,19,2,3,11,47,65,2,7,31,62,24,31,14,31,0,2,10,38,62
1995-10-09 00:00:00.000,Tel Aviv Israel ATP World Tour,HARD,2,David Wheaton,Radomir Vasek,David Wheaton,6-2; 6-0,Q,59,5,1,22,36,19,22,10,14,0,0,7,29,36,1,10,23,52,12,23,10,29,9,14,7,22,52
1995-10-09 00:00:00.000,Tel Aviv Israel ATP World Tour,HARD,2,Jan Kroslak,Jason Stoltenberg,Jan Kroslak,1-6; 6-3; 6-4,Q,103,5,5,50,87,30,50,19,37,8,12,13,49,87,2,3,53,88,37,53,13,35,3,7,13,50,88
1995-10-09 00:00:00.000,Tel Aviv Israel ATP World Tour,HARD,2,Javier Sanchez,Stefano Pescosolido,Javier Sanchez,6-2; 6-7(5); 7-6(8),S,157,11,2,75,116,49,75,21,41,8,13,16,70,116,1,7,51,119,38,51,28,68,2,9,16,66,119
1995-10-09 00:00:00.000,Tel Aviv Israel ATP World Tour,HARD,2,Jan Kroslak,David Wheaton,Jan Kroslak,6-2; 1-6; 6-4,S,104,7,8,51,85,34,51,17,34,9,11,12,51,85,9,2,49,78,37,49,13,29,3,6,13,50,78
1995-10-09 00:00:00.000,Tel Aviv Israel ATP World Tour,HARD,2,Jan Kroslak,Javier Sanchez,Jan Kroslak,6-3; 6-4,F,69,3,3,35,48,25,35,7,13,1,3,9,32,48,2,7,46,78,27,46,11,32,5,10,10,38,78
1995-10-09 00:00:00.000,Tokyo Indoor Japan ATP World Tour,HARD,2,Michael Chang,N/A Bye,Michael Chang,,R64,0,0,0,0,0,0,0,0,0,0,0,0,0,0,0,0,0,0,0,0,0,0,0,0,0,0,0
1995-10-09 00:00:00.000,Tokyo Indoor Japan ATP World Tour,HARD,2,Dick Norman,Gouichi Motomura,Dick Norman,6-3; 6-4,R64,72,7,3,37,62,29,37,15,25,3,3,10,44,62,1,6,38,66,29,38,11,28,6,8,9,40,66
1995-10-09 00:00:00.000,Tokyo Indoor Japan ATP World Tour,HARD,2,Jakob Hlasek,Albert Chang,Jakob Hlasek,7-6(7); 3-6; 6-3,R64,135,7,7,76,115,54,76,15,39,9,13,15,69,115,6,3,70,102,54,70,9,32,3,7,15,63,102
1995-10-09 00:00:00.000,Tokyo Indoor Japan ATP World Tour,HARD,2,Patrick McEnroe,N/A Bye,Patrick McEnroe,,R64,0,0,0,0,0,0,0,0,0,0,0,0,0,0,0,0,0,0,0,0,0,0,0,0,0,0,0
1995-10-09 00:00:00.000,Tokyo Indoor Japan ATP World Tour,HARD,2,Alexander Volkov,N/A Bye,Alexander Volkov,,R64,0,0,0,0,0,0,0,0,0,0,0,0,0,0,0,0,0,0,0,0,0,0,0,0,0,0,0
1995-10-09 00:00:00.000,Tokyo Indoor Japan ATP World Tour,HARD,2,Fernon Wibier,Michael Joyce,Fernon Wibier,7-6(9); 6-7(5); 6-4,R64,164,16,7,91,138,62,91,21,47,7,11,17,83,138,0,5,69,133,47,69,31,64,9,14,17,78,133
1995-10-09 00:00:00.000,Tokyo Indoor Japan ATP World Tour,HARD,2,Tommy Ho,Paul Wekesa,Tommy Ho,6-1; 6-1,R64,64,4,5,31,62,21,31,15,31,7,8,7,36,62,1,5,33,53,14,33,7,20,8,14,7,21,53
1995-10-09 00:00:00.000,Tokyo Indoor Japan ATP World Tour,HARD,2,Jacco Eltingh,N/A Bye,Jacco Eltingh,,R64,0,0,0,0,0,0,0,0,0,0,0,0,0,0,0,0,0,0,0,0,0,0,0,0,0,0,0
1995-10-09 00:00:00.000,Tokyo Indoor Japan ATP World Tour,HARD,2,Sergi Bruguera,N/A Bye,Sergi Bruguera,,R64,0,0,0,0,0,0,0,0,0,0,0,0,0,0,0,0,0,0,0,0,0,0,0,0,0,0,0
1995-10-09 00:00:00.000,Tokyo Indoor Japan ATP World Tour,HARD,2,Leander Paes,Kotaro Miyachi,Leander Paes,6-2; 6-4,R64,65,3,1,36,61,28,36,12,25,4,5,9,40,61,2,2,32,51,19,32,10,19,5,9,9,29,51
1995-10-09 00:00:00.000,Tokyo Indoor Japan ATP World Tour,HARD,2,Michael Tebbutt,Sebastien Lareau,Michael Tebbutt,6-1; 6-7(7); 6-4,R64,102,23,11,65,109,56,65,20,44,3,3,15,76,109,8,7,43,82,35,43,20,39,0,3,14,55,82
1995-10-09 00:00:00.000,Tokyo Indoor Japan ATP World Tour,HARD,2,Byron Black,N/A Bye,Byron Black,,R64,0,0,0,0,0,0,0,0,0,0,0,0,0,0,0,0,0,0,0,0,0,0,0,0,0,0,0
1995-10-09 00:00:00.000,Tokyo Indoor Japan ATP World Tour,HARD,2,Mark Woodforde,N/A Bye,Mark Woodforde,,R64,0,0,0,0,0,0,0,0,0,0,0,0,0,0,0,0,0,0,0,0,0,0,0,0,0,0,0
1995-10-09 00:00:00.000,Tokyo Indoor Japan ATP World Tour,HARD,2,Henrik Holm,Jamie Morgan,Henrik Holm,3-6; 7-6(2); 6-3,R64,114,12,11,40,89,33,40,29,49,7,8,14,62,89,10,6,60,103,47,60,20,43,2,4,16,67,103
1995-10-09 00:00:00.000,Tokyo Indoor Japan ATP World Tour,HARD,2,Jeremy Bates,Bryan Shelton,Jeremy Bates,6-7(7); 7-6(2); 7-5,R64,148,8,9,82,131,69,82,21,49,6,7,18,90,131,11,7,69,118,55,69,28,49,1,3,18,83,118
1995-10-09 00:00:00.000,Tokyo Indoor Japan ATP World Tour,HARD,2,Todd Martin,N/A Bye,Todd Martin,,R64,0,0,0,0,0,0,0,0,0,0,0,0,0,0,0,0,0,0,0,0,0,0,0,0,0,0,0
1995-10-09 00:00:00.000,Tokyo Indoor Japan ATP World Tour,HARD,2,Stefan Edberg,N/A Bye,Stefan Edberg,,R64,0,0,0,0,0,0,0,0,0,0,0,0,0,0,0,0,0,0,0,0,0,0,0,0,0,0,0
1995-10-09 00:00:00.000,Tokyo Indoor Japan ATP World Tour,HARD,2,Mark Philippoussis,Alexander Mronz,Mark Philippoussis,6-3; 6-3,R64,56,10,6,24,46,22,24,14,22,0,0,9,36,46,5,3,29,54,20,29,11,25,1,4,9,31,54
1995-10-09 00:00:00.000,Tokyo Indoor Japan ATP World Tour,HARD,2,Cristiano Caratti,Scott Draper,Cristiano Caratti,6-3; 7-6(2),R64,89,5,0,33,53,26,33,16,20,0,1,10,42,53,7,5,38,87,26,38,22,49,9,12,11,48,87
1995-10-09 00:00:00.000,Tokyo Indoor Japan ATP World Tour,HARD,2,Brett Steven,N/A Bye,Brett Steven,,R64,0,0,0,0,0,0,0,0,0,0,0,0,0,0,0,0,0,0,0,0,0,0,0,0,0,0,0
1995-10-09 00:00:00.000,Tokyo Indoor Japan ATP World Tour,HARD,2,Renzo Furlan,N/A Bye,Renzo Furlan,,R64,0,0,0,0,0,0,0,0,0,0,0,0,0,0,0,0,0,0,0,0,0,0,0,0,0,0,0
1995-10-09 00:00:00.000,Tokyo Indoor Japan ATP World Tour,HARD,2,Sandon Stolle,Gianluca Pozzi,Sandon Stolle,6-3; 6-4,R64,68,4,4,46,72,34,46,12,26,7,8,10,46,72,0,1,22,45,14,22,13,23,1,4,9,27,45
1995-10-09 00:00:00.000,Tokyo Indoor Japan ATP World Tour,HARD,2,Alex O'Brien,Hideki Kaneko,Alex O'Brien,5-7; 6-1; 7-5,R64,129,5,1,56,92,42,56,14,36,5,10,16,56,92,1,2,96,123,52,96,11,27,8,15,15,63,123
1995-10-09 00:00:00.000,Tokyo Indoor Japan ATP World Tour,HARD,2,Richard Krajicek,N/A Bye,Richard Krajicek,,R64,0,0,0,0,0,0,0,0,0,0,0,0,0,0,0,0,0,0,0,0,0,0,0,0,0,0,0
1995-10-09 00:00:00.000,Tokyo Indoor Japan ATP World Tour,HARD,2,Paul Haarhuis,N/A Bye,Paul Haarhuis,,R64,0,0,0,0,0,0,0,0,0,0,0,0,0,0,0,0,0,0,0,0,0,0,0,0,0,0,0
1995-10-09 00:00:00.000,Tokyo Indoor Japan ATP World Tour,HARD,2,Hendrik Dreekmann,Shuzo Matsuoka,Hendrik Dreekmann,6-3; 6-3,R64,78,3,5,24,52,22,24,17,28,1,1,9,39,52,10,2,44,70,30,44,10,26,8,11,9,40,70
1995-10-09 00:00:00.000,Tokyo Indoor Japan ATP World Tour,HARD,2,Jonathan Stark,Lars Rehmann,Jonathan Stark,6-3; 6-2,R64,77,6,3,25,48,20,25,15,23,1,2,9,35,48,6,8,36,68,26,36,9,32,8,12,8,35,68
1995-10-09 00:00:00.000,Tokyo Indoor Japan ATP World Tour,HARD,2,Marcelo Rios,N/A Bye,Marcelo Rios,,R64,0,0,0,0,0,0,0,0,0,0,0,0,0,0,0,0,0,0,0,0,0,0,0,0,0,0,0
1995-10-09 00:00:00.000,Tokyo Indoor Japan ATP World Tour,HARD,2,Aaron Krickstein,N/A Bye,Aaron Krickstein,,R64,0,0,0,0,0,0,0,0,0,0,0,0,0,0,0,0,0,0,0,0,0,0,0,0,0,0,0
1995-10-09 00:00:00.000,Tokyo Indoor Japan ATP World Tour,HARD,2,Kenneth Carlsen,Danny Sapsford,Kenneth Carlsen,7-5; 6-1,R64,68,9,3,32,52,28,32,10,20,1,2,10,38,52,0,2,39,57,21,39,8,18,1,5,9,29,57
1995-10-09 00:00:00.000,Tokyo Indoor Japan ATP World Tour,HARD,2,Louis Gloria,Takao Suzuki,Louis Gloria,6-4; 6-2,R64,60,2,1,29,49,25,29,14,20,2,2,9,39,49,2,2,35,52,22,35,7,17,3,6,9,29,52
1995-10-09 00:00:00.000,Tokyo Indoor Japan ATP World Tour,HARD,2,Goran Ivanisevic,N/A Bye,Goran Ivanisevic,,R64,0,0,0,0,0,0,0,0,0,0,0,0,0,0,0,0,0,0,0,0,0,0,0,0,0,0,0
1995-10-09 00:00:00.000,Tokyo Indoor Japan ATP World Tour,HARD,2,Michael Chang,Dick Norman,Michael Chang,6-3; 6-4,R32,62,6,1,35,55,32,35,10,20,2,2,10,42,55,12,5,31,51,24,31,10,20,0,2,9,34,51
1995-10-09 00:00:00.000,Tokyo Indoor Japan ATP World Tour,HARD,2,Jakob Hlasek,Patrick McEnroe,Jakob Hlasek,7-6(2); 3-6; 7-6(3),R32,139,13,2,58,103,47,58,22,45,5,8,16,69,103,7,4,84,120,54,84,22,36,12,14,17,76,120
1995-10-09 00:00:00.000,Tokyo Indoor Japan ATP World Tour,HARD,2,Alexander Volkov,Fernon Wibier,Alexander Volkov,7-5; 6-2,R32,76,5,2,35,68,25,35,17,33,7,9,10,42,68,7,4,42,67,22,42,10,25,7,12,10,32,67
1995-10-09 00:00:00.000,Tokyo Indoor Japan ATP World Tour,HARD,2,Jacco Eltingh,Tommy Ho,Jacco Eltingh,4-6; 6-3; 6-2,R32,105,16,8,43,83,33,43,25,40,3,4,14,58,83,5,2,52,91,35,52,21,39,9,12,13,56,91
1995-10-09 00:00:00.000,Tokyo Indoor Japan ATP World Tour,HARD,2,Sergi Bruguera,Leander Paes,Sergi Bruguera,6-3; 6-0,R32,52,2,0,32,44,24,32,7,12,1,2,8,31,44,0,3,23,46,10,23,8,23,5,10,7,18,46
1995-10-09 00:00:00.000,Tokyo Indoor Japan ATP World Tour,HARD,2,Byron Black,Michael Tebbutt,Byron Black,6-3; 7-6(4),R32,75,6,1,36,55,33,36,12,19,0,0,10,45,55,12,7,32,76,30,32,17,44,7,9,11,47,76
1995-10-09 00:00:00.000,Tokyo Indoor Japan ATP World Tour,HARD,2,Henrik Holm,Mark Woodforde,Henrik Holm,4-6; 6-1; 7-6(3),R32,110,10,10,50,86,41,50,20,36,1,3,15,61,86,0,5,50,94,35,50,24,44,3,6,14,59,94
1995-10-09 00:00:00.000,Tokyo Indoor Japan ATP World Tour,HARD,2,Todd Martin,Jeremy Bates,Todd Martin,3-6; 6-4; 6-4,R32,109,16,5,47,84,35,47,19,37,1,4,15,54,84,10,6,65,109,48,65,16,44,9,12,14,64,109
1995-10-09 00:00:00.000,Tokyo Indoor Japan ATP World Tour,HARD,2,Mark Philippoussis,Stefan Edberg,Mark Philippoussis,6-0; 6-2,R32,43,3,1,21,34,19,21,9,13,0,0,7,28,34,2,4,31,49,19,31,3,18,2,7,7,22,49
1995-10-09 00:00:00.000,Tokyo Indoor Japan ATP World Tour,HARD,2,Brett Steven,Cristiano Caratti,Brett Steven,6-4; 6-3,R32,70,1,2,39,57,30,39,13,18,4,4,10,43,57,2,2,31,58,20,31,18,27,5,7,9,38,58
1995-10-09 00:00:00.000,Tokyo Indoor Japan ATP World Tour,HARD,2,Renzo Furlan,Sandon Stolle,Renzo Furlan,6-2; 3-6; 6-1,R32,80,4,3,44,75,29,44,18,31,6,8,12,47,75,4,6,34,61,22,34,12,27,1,6,12,34,61
1995-10-09 00:00:00.000,Tokyo Indoor Japan ATP World Tour,HARD,2,Richard Krajicek,Alex O'Brien,Richard Krajicek,7-5; 7-6(4),R32,99,15,1,44,79,35,44,19,35,7,8,12,54,79,0,1,68,96,44,68,15,28,7,9,12,59,96
1995-10-09 00:00:00.000,Tokyo Indoor Japan ATP World Tour,HARD,2,Hendrik Dreekmann,Paul Haarhuis,Hendrik Dreekmann,6-7(5); 6-4; 6-2,R32,113,3,7,43,104,35,43,32,61,8,9,15,67,104,4,3,46,91,30,46,26,45,3,7,15,56,91
1995-10-09 00:00:00.000,Tokyo Indoor Japan ATP World Tour,HARD,2,Jonathan Stark,Marcelo Rios,Jonathan Stark,6-7(6); 6-4; 6-4,R32,114,16,6,68,109,53,68,24,41,9,9,16,77,109,2,3,59,100,44,59,25,41,6,8,16,69,100
1995-10-09 00:00:00.000,Tokyo Indoor Japan ATP World Tour,HARD,2,Kenneth Carlsen,Aaron Krickstein,Kenneth Carlsen,6-4; 6-0,R32,56,9,2,21,44,19,21,15,23,1,1,8,34,44,1,2,22,46,12,22,10,24,3,7,8,22,46
1995-10-09 00:00:00.000,Tokyo Indoor Japan ATP World Tour,HARD,2,Goran Ivanisevic,Louis Gloria,Goran Ivanisevic,6-7(2); 6-4; 7-6(7),R32,141,29,14,67,138,52,67,30,71,11,15,17,82,138,5,8,80,123,49,80,24,43,8,13,17,73,123
1995-10-09 00:00:00.000,Tokyo Indoor Japan ATP World Tour,HARD,2,Michael Chang,Jakob Hlasek,Michael Chang,6-1; 6-3,R16,56,11,1,25,44,20,25,13,19,2,2,8,33,44,5,0,21,45,14,21,12,24,3,7,8,26,45
1995-10-09 00:00:00.000,Tokyo Indoor Japan ATP World Tour,HARD,2,Alexander Volkov,Jacco Eltingh,Alexander Volkov,3-6; 6-4; 7-5,R16,107,9,5,43,89,32,43,29,46,7,9,15,61,89,13,8,56,93,44,56,16,37,5,8,16,60,93
1995-10-09 00:00:00.000,Tokyo Indoor Japan ATP World Tour,HARD,2,Byron Black,Sergi Bruguera,Byron Black,6-1; 7-6(6),R16,64,2,1,34,55,24,34,12,21,1,3,9,36,55,6,4,39,69,22,39,11,30,4,9,10,33,69
1995-10-09 00:00:00.000,Tokyo Indoor Japan ATP World Tour,HARD,2,Henrik Holm,Todd Martin,Henrik Holm,6-2; 3-6; 6-4,R16,114,10,11,43,85,35,43,22,42,5,6,13,57,85,2,5,58,97,45,58,16,39,10,13,14,61,97
1995-10-09 00:00:00.000,Tokyo Indoor Japan ATP World Tour,HARD,2,Mark Philippoussis,Brett Steven,Mark Philippoussis,7-6(4); 6-3,R16,83,11,8,37,73,34,37,18,36,2,2,11,52,73,2,2,43,60,32,43,9,17,0,1,10,41,60
1995-10-09 00:00:00.000,Tokyo Indoor Japan ATP World Tour,HARD,2,Richard Krajicek,Renzo Furlan,Richard Krajicek,6-3; 6-2,R16,59,10,1,31,49,26,31,11,18,0,0,9,37,49,0,0,32,56,23,32,8,24,3,6,8,31,56
1995-10-09 00:00:00.000,Tokyo Indoor Japan ATP World Tour,HARD,2,Hendrik Dreekmann,Jonathan Stark,Hendrik Dreekmann,4-6; 6-3; 6-4,R16,119,3,7,45,100,33,45,32,55,13,15,15,65,100,11,4,55,95,37,55,21,40,5,8,14,58,95
1995-10-09 00:00:00.000,Tokyo Indoor Japan ATP World Tour,HARD,2,Goran Ivanisevic,Kenneth Carlsen,Goran Ivanisevic,6-4; 6-7(2); 6-3,R16,106,18,4,49,98,43,49,26,49,1,2,16,69,98,12,3,56,92,45,56,19,36,8,11,15,64,92
1995-10-09 00:00:00.000,Tokyo Indoor Japan ATP World Tour,HARD,2,Michael Chang,Alexander Volkov,Michael Chang,6-2; 6-0,Q,50,5,0,17,30,14,17,10,13,0,1,7,24,30,7,3,30,60,17,30,8,30,9,15,7,25,60
1995-10-09 00:00:00.000,Tokyo Indoor Japan ATP World Tour,HARD,2,Henrik Holm,Byron Black,Henrik Holm,6-3; 6-7(8); 6-1,Q,132,22,13,52,109,45,52,28,57,4,5,15,73,109,0,3,66,100,42,66,14,34,6,10,13,56,100
1995-10-09 00:00:00.000,Tokyo Indoor Japan ATP World Tour,HARD,2,Mark Philippoussis,Richard Krajicek,Mark Philippoussis,6-7(4); 7-6(5); 6-3,Q,113,10,9,55,97,49,55,26,42,0,0,17,75,97,27,5,66,110,55,66,21,44,2,3,16,76,110
1995-10-09 00:00:00.000,Tokyo Indoor Japan ATP World Tour,HARD,2,Hendrik Dreekmann,Goran Ivanisevic,Hendrik Dreekmann,7-6(2); 7-6(5),Q,86,6,4,45,74,39,45,15,29,0,1,12,54,74,16,6,48,95,37,48,24,47,8,9,12,61,95
1995-10-09 00:00:00.000,Tokyo Indoor Japan ATP World Tour,HARD,2,Michael Chang,Henrik Holm,Michael Chang,5-7; 6-4; 6-4,S,163,4,1,68,129,42,68,35,61,9,12,16,77,129,17,11,57,107,40,57,21,50,7,11,16,61,107
1995-10-09 00:00:00.000,Tokyo Indoor Japan ATP World Tour,HARD,2,Mark Philippoussis,Hendrik Dreekmann,Mark Philippoussis,6-4; 4-6; 6-2,S,99,21,10,50,78,44,50,12,28,5,6,14,56,78,4,6,49,95,35,49,24,46,5,8,14,59,95
1995-10-09 00:00:00.000,Tokyo Indoor Japan ATP World Tour,HARD,2,Michael Chang,Mark Philippoussis,Michael Chang,6-3; 6-4,F,80,8,1,25,52,23,25,16,27,0,1,10,39,52,7,5,47,70,28,47,8,23,9,12,9,36,70
1995-10-16 00:00:00.000,Beijing China ATP World Tour,HARD,2,Michael Chang,Wojtek Kowalski,Michael Chang,6-3; 6-4,R32,66,4,2,23,53,20,23,19,30,2,3,10,39,53,4,6,31,51,23,31,7,20,2,5,9,30,51
1995-10-16 00:00:00.000,Beijing China ATP World Tour,HARD,2,Jeremy Bates,Albert Chang,Jeremy Bates,6-2; 6-4,R32,68,3,1,49,69,32,49,10,20,4,6,9,42,69,3,2,45,56,21,45,6,11,5,10,9,27,56
1995-10-16 00:00:00.000,Beijing China ATP World Tour,HARD,2,Dick Norman,Jia-Ping Xia,Dick Norman,6-3; 6-3,R32,65,9,8,32,58,28,32,12,26,1,1,9,40,58,1,2,46,72,25,46,15,26,9,12,9,40,72
1995-10-16 00:00:00.000,Beijing China ATP World Tour,HARD,2,Michael Tebbutt,Paul Wekesa,Michael Tebbutt,6-3; 6-2,R32,56,18,4,29,50,29,29,9,21,1,1,9,38,50,5,0,36,53,20,36,9,17,1,4,8,29,53
1995-10-16 00:00:00.000,Beijing China ATP World Tour,HARD,2,Kenneth Carlsen,Cristiano Caratti,Kenneth Carlsen,6-4; 7-5(5),R32,100,10,2,39,68,32,39,18,29,3,3,11,50,68,2,4,55,90,37,55,20,35,5,6,11,57,90
1995-10-16 00:00:00.000,Beijing China ATP World Tour,HARD,2,Leander Paes,Joshua Eagle,Leander Paes,6-7(7); 7-6(2); 6-1,R32,127,4,8,76,109,56,76,12,33,2,4,16,68,109,6,0,75,104,50,75,15,29,6,10,15,65,104
1995-10-16 00:00:00.000,Beijing China ATP World Tour,HARD,2,Mark Petchey,Carl Chang,Mark Petchey,6-3; 6-4,R32,66,10,4,33,50,29,33,10,17,0,1,10,39,50,2,4,27,51,18,27,13,24,2,5,9,31,51
1995-10-16 00:00:00.000,Beijing China ATP World Tour,HARD,2,David Nainkin,Michael Joyce,David Nainkin,6-3; 5-7; 6-1,R32,92,2,4,55,83,36,55,14,28,4,8,14,50,83,4,5,44,83,26,44,17,39,4,11,14,43,83
1995-10-16 00:00:00.000,Beijing China ATP World Tour,HARD,2,Scott Draper,Paul Kilderry,Scott Draper,6-3; 6-4,R32,66,8,2,38,65,31,38,15,27,3,3,10,46,65,4,1,28,50,23,28,9,22,0,2,9,32,50
1995-10-16 00:00:00.000,Beijing China ATP World Tour,HARD,2,Hendrik Dreekmann,Andrew Richardson,Hendrik Dreekmann,7-6(5); 6-0,R32,60,3,0,29,47,28,29,12,18,0,0,9,40,47,7,5,34,56,23,34,12,22,5,8,9,35,56
1995-10-16 00:00:00.000,Beijing China ATP World Tour,HARD,2,Sebastien Lareau,Eyal Ran,Sebastien Lareau,6-2; 6-3,R32,68,6,5,31,50,27,31,7,19,3,3,8,34,50,1,5,30,62,21,30,13,32,4,8,9,34,62
1995-10-16 00:00:00.000,Beijing China ATP World Tour,HARD,2,Shuzo Matsuoka,Lars Rehmann,Shuzo Matsuoka,6-4; 6-0,R32,60,8,2,28,41,28,28,5,13,0,0,8,33,41,1,8,21,50,12,21,13,29,5,9,8,25,50
1995-10-16 00:00:00.000,Beijing China ATP World Tour,HARD,2,Tommy Ho,Bing Pan,Tommy Ho,6-1; 6-7(8); 6-2,R32,104,1,2,48,81,39,48,18,33,0,2,14,57,81,6,3,50,89,31,50,17,39,5,11,13,48,89
1995-10-16 00:00:00.000,Beijing China ATP World Tour,HARD,2,Gianluca Pozzi,Kelly Jones,Gianluca Pozzi,7-5; 6-3,R32,91,10,0,41,68,30,41,19,27,4,4,11,49,68,0,0,55,75,36,55,9,20,4,6,10,45,75
1995-10-16 00:00:00.000,Beijing China ATP World Tour,HARD,2,Tim Henman,Danny Sapsford,Tim Henman,3-6; 6-4; 6-4,R32,125,5,2,45,81,34,45,15,36,1,4,14,49,81,6,1,76,118,49,76,20,42,12,16,15,69,118
1995-10-16 00:00:00.000,Beijing China ATP World Tour,HARD,2,Renzo Furlan,Bryan Shelton,Renzo Furlan,3-6; 6-4; 7-5,R32,117,2,2,53,93,38,53,22,40,4,6,15,60,93,8,11,69,103,50,69,14,34,9,12,15,64,103
1995-10-16 00:00:00.000,Beijing China ATP World Tour,HARD,2,Michael Chang,Jeremy Bates,Michael Chang,6-3; 6-2,R16,51,7,0,23,45,21,23,15,22,0,0,9,36,45,2,0,19,36,16,19,5,17,0,3,8,21,36
1995-10-16 00:00:00.000,Beijing China ATP World Tour,HARD,2,Michael Tebbutt,Dick Norman,Michael Tebbutt,6-7(0); 6-2; 7-6(2),R16,103,23,5,55,96,47,55,25,41,3,3,16,72,96,23,7,52,86,44,52,20,34,1,3,16,64,86
1995-10-16 00:00:00.000,Beijing China ATP World Tour,HARD,2,Leander Paes,Kenneth Carlsen,Leander Paes,6-3; 6-2,R16,73,3,2,37,54,24,37,14,17,2,2,9,38,54,3,6,39,65,22,39,13,26,5,8,8,35,65
1995-10-16 00:00:00.000,Beijing China ATP World Tour,HARD,2,David Nainkin,Mark Petchey,David Nainkin,7-6(7); 7-5,R16,90,2,6,56,87,35,56,19,31,3,6,12,54,87,9,5,44,78,28,44,19,34,5,9,12,47,78
1995-10-16 00:00:00.000,Beijing China ATP World Tour,HARD,2,Scott Draper,Hendrik Dreekmann,Scott Draper,4-6; 6-3; 6-4,R16,95,7,5,44,96,33,44,28,52,5,7,15,61,96,8,9,39,72,33,39,15,33,0,3,14,48,72
1995-10-16 00:00:00.000,Beijing China ATP World Tour,HARD,2,Shuzo Matsuoka,Sebastien Lareau,Shuzo Matsuoka,6-3; 7-6(7),R16,92,11,2,55,84,44,55,13,29,2,2,11,57,84,3,4,55,73,41,55,8,18,2,3,10,49,73
1995-10-16 00:00:00.000,Beijing China ATP World Tour,HARD,2,Gianluca Pozzi,Tommy Ho,Gianluca Pozzi,7-5; 6-2,R16,99,5,4,32,79,27,32,24,47,9,10,10,51,79,1,1,43,74,24,43,16,31,9,13,10,40,74
1995-10-16 00:00:00.000,Beijing China ATP World Tour,HARD,2,Renzo Furlan,Tim Henman,Renzo Furlan,5-7; 6-3; 6-3,R16,114,6,0,52,83,37,52,23,31,4,6,15,60,83,7,7,57,100,40,57,20,43,8,12,15,60,100
1995-10-16 00:00:00.000,Beijing China ATP World Tour,HARD,2,Michael Chang,Michael Tebbutt,Michael Chang,7-6(5); 6-2,Q,86,4,3,38,59,32,38,15,21,1,1,10,47,59,10,3,37,76,31,37,18,39,5,7,10,49,76
1995-10-16 00:00:00.000,Beijing China ATP World Tour,HARD,2,David Nainkin,Leander Paes,David Nainkin,6-7(7); 6-4; 7-5,Q,155,2,5,84,127,54,84,18,43,14,19,17,72,127,7,5,68,113,42,68,21,45,7,14,17,63,113
1995-10-16 00:00:00.000,Beijing China ATP World Tour,HARD,2,Shuzo Matsuoka,Scott Draper,Shuzo Matsuoka,7-5; 6-3,Q,79,11,0,38,57,32,38,11,19,1,2,11,43,57,7,2,32,71,26,32,17,39,8,11,10,43,71
1995-10-16 00:00:00.000,Beijing China ATP World Tour,HARD,2,Renzo Furlan,Gianluca Pozzi,Renzo Furlan,4-6; 6-3; 6-4,Q,118,2,0,58,95,43,58,22,37,4,5,15,65,95,7,0,52,92,39,52,21,40,7,9,14,60,92
1995-10-16 00:00:00.000,Beijing China ATP World Tour,HARD,2,Michael Chang,David Nainkin,Michael Chang,6-1; 6-2,S,58,3,1,26,39,22,26,10,13,0,0,8,32,39,1,3,34,53,20,34,5,19,7,11,7,25,53
1995-10-16 00:00:00.000,Beijing China ATP World Tour,HARD,2,Renzo Furlan,Shuzo Matsuoka,Renzo Furlan,3-6; 6-3; 6-4,S,120,5,0,59,83,45,59,15,24,2,3,14,60,83,11,1,68,102,49,68,15,34,11,13,14,64,102
1995-10-16 00:00:00.000,Beijing China ATP World Tour,HARD,2,Michael Chang,Renzo Furlan,Michael Chang,7-5; 6-3,F,94,4,1,32,61,27,32,17,29,4,5,11,44,61,1,0,33,62,23,33,14,29,1,4,10,37,62
1995-10-16 00:00:00.000,Lyon France ATP World Tour,HARD,2,Pete Sampras,Guy Forget,Pete Sampras,6-3; 6-4,R32,65,10,2,37,57,33,37,8,20,0,0,10,41,57,10,0,26,41,22,26,8,15,0,2,9,30,41
1995-10-16 00:00:00.000,Lyon France ATP World Tour,HARD,2,Ronald Agenor,Jerome Hanquez,Ronald Agenor,6-4; 6-2,R32,72,7,4,28,52,24,28,12,24,3,4,9,36,52,4,2,27,56,20,27,12,29,4,8,9,32,56
1995-10-16 00:00:00.000,Lyon France ATP World Tour,HARD,2,Maxime Huard,Javier Frana,Maxime Huard,7-5; 6-4,R32,87,2,3,37,68,29,37,14,31,3,5,11,43,68,7,2,38,74,27,38,16,36,5,9,11,43,74
1995-10-16 00:00:00.000,Lyon France ATP World Tour,HARD,2,Greg Rusedski,Yannick Noah,Greg Rusedski,6-3; 6-2,R32,60,8,2,27,45,25,27,12,18,0,0,9,37,45,1,3,26,50,22,26,7,24,4,7,8,29,50
1995-10-16 00:00:00.000,Lyon France ATP World Tour,HARD,2,Jean-Philippe Fleurian,Marc Rosset,Jean-Philippe Fleurian,4-6; 6-4; 6-4,R32,122,1,2,53,84,41,53,18,31,3,5,15,59,84,16,5,51,86,43,51,12,35,4,7,15,55,86
1995-10-16 00:00:00.000,Lyon France ATP World Tour,HARD,2,Patrick Rafter,Carl-Uwe Steeb,Patrick Rafter,6-3; 6-1,R32,52,9,1,22,40,21,22,12,18,0,0,8,33,40,0,5,28,45,16,28,7,17,3,7,8,23,45
1995-10-16 00:00:00.000,Lyon France ATP World Tour,HARD,2,Lionel Roux,Nicolas Escude,Lionel Roux,6-3; 7-5(12),R32,124,1,1,51,90,35,51,21,39,4,6,11,56,90,1,3,60,88,36,60,13,28,3,6,10,49,88
1995-10-16 00:00:00.000,Lyon France ATP World Tour,HARD,2,Todd Martin,Andrei Chesnokov,Todd Martin,7-6(5); 7-6(3),R32,100,8,5,41,81,34,41,23,40,2,4,12,57,81,4,2,42,87,38,42,21,45,6,8,12,59,87
1995-10-16 00:00:00.000,Lyon France ATP World Tour,HARD,2,David Prinosil,Arnaud Boetsch,David Prinosil,6-2; 6-4,R32,76,5,3,27,60,20,27,17,33,5,7,9,37,60,2,2,30,63,20,30,11,33,6,11,9,31,63
1995-10-16 00:00:00.000,Lyon France ATP World Tour,HARD,2,Jakob Hlasek,Jared Palmer,Jakob Hlasek,6-2; 6-1,R32,61,3,0,22,40,16,22,11,18,3,4,7,27,40,1,4,27,56,12,27,11,29,6,12,8,23,56
1995-10-16 00:00:00.000,Lyon France ATP World Tour,HARD,2,Martin Damm,Daniel Vacek,Martin Damm,6-3; 4-6; 6-3,R32,112,12,6,40,81,35,40,20,41,4,6,14,55,81,7,7,45,84,33,45,19,39,5,9,14,52,84
1995-10-16 00:00:00.000,Lyon France ATP World Tour,HARD,2,Wayne Ferreira,Jerome Golmard,Wayne Ferreira,5-7; 6-2; 6-4,R32,119,6,4,36,85,27,36,29,49,3,6,15,56,85,6,8,57,104,37,57,20,47,7,12,15,57,104
1995-10-16 00:00:00.000,Lyon France ATP World Tour,HARD,2,Cedric Pioline,Bernd Karbacher,Cedric Pioline,6-7(6); 6-2; 6-4,R32,129,8,2,49,86,39,49,20,37,2,4,15,59,86,5,4,51,101,31,51,26,50,3,8,15,57,101
1995-10-16 00:00:00.000,Lyon France ATP World Tour,HARD,2,Tomas Carbonell,Stefano Pescosolido,Tomas Carbonell,3-6; 6-4; 6-2,R32,108,9,3,44,69,36,44,13,25,2,4,13,49,69,11,3,48,97,35,48,24,49,11,15,14,59,97
1995-10-16 00:00:00.000,Lyon France ATP World Tour,HARD,2,Henrik Holm,Olivier Delaitre,Henrik Holm,2-6; 6-3; 6-3,R32,110,15,11,51,89,38,51,16,38,7,10,13,54,89,0,3,47,85,29,47,19,38,3,7,13,48,85
1995-10-16 00:00:00.000,Lyon France ATP World Tour,HARD,2,Yevgeny Kafelnikov,Guillaume Raoux,Yevgeny Kafelnikov,6-0; 6-2,R32,53,8,1,19,35,16,19,12,16,0,0,7,28,35,5,2,23,55,14,23,10,32,4,9,7,24,55
1995-10-16 00:00:00.000,Lyon France ATP World Tour,HARD,2,Pete Sampras,Ronald Agenor,Pete Sampras,6-4; 6-1,R16,53,14,1,28,44,24,28,10,16,1,2,9,34,44,4,4,28,42,15,28,5,14,0,4,8,20,42
1995-10-16 00:00:00.000,Lyon France ATP World Tour,HARD,2,Maxime Huard,Greg Rusedski,Maxime Huard,6-4; 6-3,R16,76,2,3,35,70,30,35,18,35,4,4,10,48,70,6,6,23,49,20,23,13,26,0,2,9,33,49
1995-10-16 00:00:00.000,Lyon France ATP World Tour,HARD,2,Patrick Rafter,Jean-Philippe Fleurian,Patrick Rafter,6-3; 7-6(3),R16,104,8,2,52,78,34,52,16,26,6,8,11,50,78,2,5,36,69,23,36,16,33,3,6,10,39,69
1995-10-16 00:00:00.000,Lyon France ATP World Tour,HARD,2,Todd Martin,Lionel Roux,Todd Martin,6-3; 6-4,R16,75,9,3,27,57,22,27,19,30,0,0,10,41,57,3,1,29,49,20,29,12,20,2,4,9,32,49
1995-10-16 00:00:00.000,Lyon France ATP World Tour,HARD,2,David Prinosil,Jakob Hlasek,David Prinosil,6-1; 6-4,R16,53,6,0,21,50,18,21,19,29,1,1,9,37,50,2,1,31,49,19,31,7,18,0,3,8,26,49
1995-10-16 00:00:00.000,Lyon France ATP World Tour,HARD,2,Wayne Ferreira,Martin Damm,Wayne Ferreira,6-7(4); 6-3; 6-1,R16,103,10,3,50,81,41,50,15,31,1,2,14,56,81,4,1,41,84,26,41,22,43,2,7,14,48,84
1995-10-16 00:00:00.000,Lyon France ATP World Tour,HARD,2,Cedric Pioline,Tomas Carbonell,Cedric Pioline,6-2; 6-2,R16,61,5,4,30,56,21,30,14,26,4,5,8,35,56,3,1,27,41,13,27,5,14,3,8,8,18,41
1995-10-16 00:00:00.000,Lyon France ATP World Tour,HARD,2,Yevgeny Kafelnikov,Henrik Holm,Yevgeny Kafelnikov,7-5; 6-3,R16,85,3,4,31,55,25,31,15,24,3,4,10,40,55,12,11,39,84,28,39,17,45,5,9,11,45,84
1995-10-16 00:00:00.000,Lyon France ATP World Tour,HARD,2,Pete Sampras,Maxime Huard,Pete Sampras,6-4; 6-2,Q,65,4,6,24,49,20,24,13,25,0,1,9,33,49,1,2,27,55,18,27,10,28,4,8,9,28,55
1995-10-16 00:00:00.000,Lyon France ATP World Tour,HARD,2,Todd Martin,Patrick Rafter,Todd Martin,3-6; 7-6(2); 6-2,Q,114,8,4,48,78,40,48,18,30,2,4,14,58,78,2,3,59,84,40,59,15,25,4,7,15,55,84
1995-10-16 00:00:00.000,Lyon France ATP World Tour,HARD,2,Wayne Ferreira,David Prinosil,Wayne Ferreira,6-2; 1-6; 6-3,Q,84,5,1,55,87,35,55,18,32,4,6,12,53,87,4,3,38,68,28,38,14,30,2,5,12,42,68
1995-10-16 00:00:00.000,Lyon France ATP World Tour,HARD,2,Yevgeny Kafelnikov,Cedric Pioline,Yevgeny Kafelnikov,6-3; 6-4,Q,80,13,4,33,72,24,33,22,39,7,8,10,46,72,4,4,24,51,16,24,13,27,4,7,9,29,51
1995-10-16 00:00:00.000,Lyon France ATP World Tour,HARD,2,Pete Sampras,Todd Martin,Pete Sampras,7-6(2); 6-4,S,91,8,5,38,70,33,38,16,32,3,5,11,49,70,5,1,45,76,29,45,15,31,2,5,11,44,76
1995-10-16 00:00:00.000,Lyon France ATP World Tour,HARD,2,Wayne Ferreira,Yevgeny Kafelnikov,Wayne Ferreira,1-6; 7-6(3); 6-3,S,105,5,2,58,86,37,58,17,28,5,8,13,54,86,5,2,59,94,41,59,20,35,3,6,15,61,94
1995-10-16 00:00:00.000,Lyon France ATP World Tour,HARD,2,Wayne Ferreira,Pete Sampras,Wayne Ferreira,7-6(2); 5-7; 6-3,F,138,7,1,69,112,52,69,17,43,7,11,17,69,112,5,6,60,120,46,60,22,60,7,11,16,68,120
1995-10-16 00:00:00.000,Vienna Austria ATP World Tour,HARD,2,Thomas Muster,MaliVai Washington,Thomas Muster,6-4; 1-6; 6-3,R32,87,2,1,46,70,32,46,16,24,1,3,13,48,70,7,3,51,78,40,51,11,27,2,4,13,51,78
1995-10-16 00:00:00.000,Vienna Austria ATP World Tour,HARD,2,Mark Woodforde,Markus Hipfl,Mark Woodforde,6-3; 6-1,R32,65,6,6,27,55,21,27,15,28,4,5,8,36,55,2,6,27,55,14,27,11,28,1,6,8,25,55
1995-10-16 00:00:00.000,Vienna Austria ATP World Tour,HARD,2,Adrian Voinea,Marc-Kevin Goellner,Adrian Voinea,6-3; 6-4,R32,63,12,1,37,60,32,37,12,23,3,3,10,44,60,10,8,34,62,29,34,11,28,6,8,9,40,62
1995-10-16 00:00:00.000,Vienna Austria ATP World Tour,HARD,2,Alexander Volkov,Oliver Gross,Alexander Volkov,6-3; 6-1,R32,60,1,3,24,45,19,24,10,21,0,2,8,29,45,2,7,31,68,16,31,14,37,8,14,8,30,68
1995-10-16 00:00:00.000,Vienna Austria ATP World Tour,HARD,2,Michael Stich,Wolfgang Schranz,Michael Stich,6-4; 6-4,R32,80,6,6,35,60,30,35,13,25,1,1,10,43,60,4,1,47,83,32,47,17,36,9,11,10,49,83
1995-10-16 00:00:00.000,Vienna Austria ATP World Tour,HARD,2,Thomas Johansson,Magnus Gustafsson,Thomas Johansson,6-2; 6-4,R32,67,4,3,38,61,31,38,12,23,3,3,9,43,61,2,1,26,49,16,26,13,23,2,5,9,29,49
1995-10-16 00:00:00.000,Vienna Austria ATP World Tour,HARD,2,Todd Woodbridge,Vincent Spadea,Todd Woodbridge,7-6(3); 7-6(1),R32,109,3,5,54,97,43,54,22,43,6,7,12,65,97,1,4,43,83,35,43,21,40,4,5,12,56,83
1995-10-16 00:00:00.000,Vienna Austria ATP World Tour,HARD,2,Jan Siemerink,Richard Fromberg,Jan Siemerink,6-3; 6-2,R32,68,4,1,25,47,19,25,18,22,0,0,9,37,47,3,4,32,63,21,32,12,31,9,12,8,33,63
1995-10-16 00:00:00.000,Vienna Austria ATP World Tour,HARD,2,Gilbert Schaller,Martin Sinner,Gilbert Schaller,3-6; 6-4; 7-6(2),R32,137,8,6,85,111,57,85,12,26,5,9,15,69,111,8,8,55,111,43,55,23,56,6,10,16,66,111
1995-10-16 00:00:00.000,Vienna Austria ATP World Tour,HARD,2,Filip Dewulf,David Wheaton,Filip Dewulf,6-2; 6-3,R32,53,4,0,28,44,24,28,10,16,1,1,8,34,44,6,4,36,51,23,36,2,15,1,5,9,25,51
1995-10-16 00:00:00.000,Vienna Austria ATP World Tour,HARD,2,Patrik Kuhnen,Karel Novacek,Patrik Kuhnen,7-6(3); 6-4,R32,85,12,1,49,77,41,49,14,28,4,4,11,55,77,10,1,37,63,31,37,15,26,0,1,11,46,63
1995-10-16 00:00:00.000,Vienna Austria ATP World Tour,HARD,2,Oleg Ogorodov,Andrei Medvedev,Oleg Ogorodov,6-3; 6-1,R32,61,4,1,35,60,27,35,11,25,7,8,8,38,60,1,3,21,46,13,21,7,25,4,9,8,20,46
1995-10-16 00:00:00.000,Vienna Austria ATP World Tour,HARD,2,Jonas Bjorkman,Christian Bergstrom,Jonas Bjorkman,3-6; 6-3; 6-3,R32,118,5,2,52,89,31,52,20,37,4,9,14,51,89,6,10,48,104,31,48,21,56,6,12,13,52,104
1995-10-16 00:00:00.000,Vienna Austria ATP World Tour,HARD,2,Marcos Ondruska,Clemens Trimmel,Marcos Ondruska,6-7(4); 6-2; 7-5,R32,139,6,4,55,113,40,55,28,58,6,9,16,68,113,4,6,62,109,39,62,22,47,6,12,16,61,109
1995-10-16 00:00:00.000,Vienna Austria ATP World Tour,HARD,2,Jeff Tarango,Jan Kroslak,Jeff Tarango,6-4; 7-5,R32,72,4,3,37,63,27,37,16,26,1,2,11,43,63,7,5,40,63,31,40,7,23,0,3,11,38,63
1995-10-16 00:00:00.000,Vienna Austria ATP World Tour,HARD,2,Brett Steven,Thomas Enqvist,Brett Steven,7-6(6); 3-6; 6-2,R32,114,1,3,57,83,34,57,16,26,3,7,14,50,83,4,5,57,91,36,57,18,34,2,7,15,54,91
1995-10-16 00:00:00.000,Vienna Austria ATP World Tour,HARD,2,Thomas Muster,Mark Woodforde,Thomas Muster,6-3; 6-4,R16,99,6,4,24,60,20,24,19,36,3,4,9,39,60,7,6,36,82,25,36,18,46,4,8,10,43,82
1995-10-16 00:00:00.000,Vienna Austria ATP World Tour,HARD,2,Alexander Volkov,Adrian Voinea,Alexander Volkov,6-7(2); 6-4; 7-6(5),R16,143,3,2,57,112,44,57,29,55,6,8,17,73,112,15,11,64,132,51,64,30,68,6,9,17,81,132
1995-10-16 00:00:00.000,Vienna Austria ATP World Tour,HARD,2,Michael Stich,Thomas Johansson,Michael Stich,7-6(5); 6-4,R16,75,10,4,34,63,30,34,20,29,0,0,11,50,63,4,3,33,64,28,33,20,31,2,3,11,48,64
1995-10-16 00:00:00.000,Vienna Austria ATP World Tour,HARD,2,Todd Woodbridge,Jan Siemerink,Todd Woodbridge,6-4; 7-5,R16,87,3,8,36,69,34,36,14,33,2,2,11,48,69,4,7,38,71,28,38,17,33,7,9,11,45,71
1995-10-16 00:00:00.000,Vienna Austria ATP World Tour,HARD,2,Filip Dewulf,Gilbert Schaller,Filip Dewulf,6-3; 6-4,R16,68,3,3,30,56,27,30,15,26,1,1,10,42,56,2,1,44,64,29,44,11,20,6,8,9,40,64
1995-10-16 00:00:00.000,Vienna Austria ATP World Tour,HARD,2,Oleg Ogorodov,Patrik Kuhnen,Oleg Ogorodov,6-4; 6-3,R16,66,7,0,28,43,27,28,9,15,0,0,9,36,43,7,4,30,66,21,30,16,36,3,6,10,37,66
1995-10-16 00:00:00.000,Vienna Austria ATP World Tour,HARD,2,Jonas Bjorkman,Marcos Ondruska,Jonas Bjorkman,6-4; 6-4,R16,74,3,0,32,53,20,32,14,21,0,2,10,34,53,1,3,48,69,31,48,6,21,5,9,10,37,69
1995-10-16 00:00:00.000,Vienna Austria ATP World Tour,HARD,2,Jeff Tarango,Brett Steven,Jeff Tarango,6-1; 7-5,R16,77,4,1,35,52,26,35,11,17,1,2,10,37,52,2,0,56,80,32,56,8,24,5,9,9,40,80
1995-10-16 00:00:00.000,Vienna Austria ATP World Tour,HARD,2,Thomas Muster,Alexander Volkov,Thomas Muster,7-6(4); 6-1,Q,84,4,1,29,64,24,29,21,35,0,1,10,45,64,7,4,30,68,23,30,17,38,7,10,9,40,68
1995-10-16 00:00:00.000,Vienna Austria ATP World Tour,HARD,2,Todd Woodbridge,Michael Stich,Todd Woodbridge,2-2 RET,Q,20,0,1,7,18,4,7,7,11,0,0,3,11,18,2,0,7,11,5,7,3,4,0,0,2,8,11
1995-10-16 00:00:00.000,Vienna Austria ATP World Tour,HARD,2,Filip Dewulf,Oleg Ogorodov,Filip Dewulf,6-3; 6-1,Q,50,3,0,27,41,21,27,10,14,2,3,8,31,41,5,1,40,63,22,40,6,23,5,10,8,28,63
1995-10-16 00:00:00.000,Vienna Austria ATP World Tour,HARD,2,Jonas Bjorkman,Jeff Tarango,Jonas Bjorkman,6-2; 6-3,Q,84,6,1,44,77,33,44,15,33,9,10,9,48,77,0,3,34,63,19,34,12,29,7,11,8,31,63
1995-10-16 00:00:00.000,Vienna Austria ATP World Tour,HARD,2,Thomas Muster,Todd Woodbridge,Thomas Muster,6-4; 7-5,S,93,6,1,35,68,26,35,17,33,3,5,11,43,68,5,3,41,70,30,41,8,29,6,10,11,38,70
1995-10-16 00:00:00.000,Vienna Austria ATP World Tour,HARD,2,Filip Dewulf,Jonas Bjorkman,Filip Dewulf,7-6(5); 6-3,S,80,4,1,45,78,35,45,15,33,2,4,11,50,78,4,6,33,64,24,33,12,31,5,8,10,36,64
1995-10-16 00:00:00.000,Vienna Austria ATP World Tour,HARD,2,Filip Dewulf,Thomas Muster,Filip Dewulf,7-5; 6-2; 1-6; 7-5,F,135,13,6,65,123,46,65,28,58,8,12,19,74,123,10,5,70,112,51,70,21,42,4,10,20,72,112
1995-10-23 00:00:00.000,ATP Masters Series Essen Germany ATP World Tour,HARD,2,Andre Agassi,N/A Bye,Andre Agassi,,R64,0,0,0,0,0,0,0,0,0,0,0,0,0,0,0,0,0,0,0,0,0,0,0,0,0,0,0
1995-10-23 00:00:00.000,ATP Masters Series Essen Germany ATP World Tour,HARD,2,Jacco Eltingh,Bernd Karbacher,Jacco Eltingh,6-2; 6-4,R64,66,3,1,41,57,28,41,11,16,4,5,9,39,57,5,3,32,53,20,32,8,21,0,4,9,28,53
1995-10-23 00:00:00.000,ATP Masters Series Essen Germany ATP World Tour,HARD,2,MaliVai Washington,Nicolas Kiefer,MaliVai Washington,3-6; 6-0; 6-4,R64,103,8,2,55,88,41,55,17,33,9,10,12,58,88,6,2,50,85,33,50,17,35,5,9,13,50,85
1995-10-23 00:00:00.000,ATP Masters Series Essen Germany ATP World Tour,HARD,2,Andrea Gaudenzi,N/A Bye,Andrea Gaudenzi,,R64,0,0,0,0,0,0,0,0,0,0,0,0,0,0,0,0,0,0,0,0,0,0,0,0,0,0,0
1995-10-23 00:00:00.000,ATP Masters Series Essen Germany ATP World Tour,HARD,2,Thomas Enqvist,N/A Bye,Thomas Enqvist,,R64,0,0,0,0,0,0,0,0,0,0,0,0,0,0,0,0,0,0,0,0,0,0,0,0,0,0,0
1995-10-23 00:00:00.000,ATP Masters Series Essen Germany ATP World Tour,HARD,2,Todd Martin,David Wheaton,Todd Martin,7-6(7); 6-4,R64,111,11,6,52,86,40,52,16,34,5,6,11,56,86,7,4,43,80,36,43,12,37,2,4,11,48,80
1995-10-23 00:00:00.000,ATP Masters Series Essen Germany ATP World Tour,HARD,2,Martin Sinner,Mark Philippoussis,Martin Sinner,3-6; 6-4; 6-3,R64,116,8,10,40,83,31,40,25,43,1,3,14,56,83,13,9,69,113,50,69,16,44,13,16,14,66,113
1995-10-23 00:00:00.000,ATP Masters Series Essen Germany ATP World Tour,HARD,2,Goran Ivanisevic,N/A Bye,Goran Ivanisevic,,R64,0,0,0,0,0,0,0,0,0,0,0,0,0,0,0,0,0,0,0,0,0,0,0,0,0,0,0
1995-10-23 00:00:00.000,ATP Masters Series Essen Germany ATP World Tour,HARD,2,Boris Becker,N/A Bye,Boris Becker,,R64,0,0,0,0,0,0,0,0,0,0,0,0,0,0,0,0,0,0,0,0,0,0,0,0,0,0,0
1995-10-23 00:00:00.000,ATP Masters Series Essen Germany ATP World Tour,HARD,2,Magnus Gustafsson,Aaron Krickstein,Magnus Gustafsson,6-4; 6-2,R64,67,4,0,36,57,26,36,12,21,4,5,9,38,57,2,4,28,56,21,28,11,28,4,8,9,32,56
1995-10-23 00:00:00.000,ATP Masters Series Essen Germany ATP World Tour,HARD,2,Brett Steven,Alex O'Brien,Brett Steven,7-6(4); 6-3,R64,109,6,3,57,83,40,57,14,26,6,7,11,54,83,3,0,35,71,23,35,21,36,4,6,10,44,71
1995-10-23 00:00:00.000,ATP Masters Series Essen Germany ATP World Tour,HARD,2,Richard Krajicek,N/A Bye,Richard Krajicek,,R64,0,0,0,0,0,0,0,0,0,0,0,0,0,0,0,0,0,0,0,0,0,0,0,0,0,0,0
1995-10-23 00:00:00.000,ATP Masters Series Essen Germany ATP World Tour,HARD,2,Wayne Ferreira,N/A Bye,Wayne Ferreira,,R64,0,0,0,0,0,0,0,0,0,0,0,0,0,0,0,0,0,0,0,0,0,0,0,0,0,0,0
1995-10-23 00:00:00.000,ATP Masters Series Essen Germany ATP World Tour,HARD,2,Arnaud Boetsch,Todd Woodbridge,Arnaud Boetsch,6-3; 6-4,R64,68,1,1,17,44,11,17,19,27,0,2,9,30,44,3,4,36,64,24,36,9,28,3,8,10,33,64
1995-10-23 00:00:00.000,ATP Masters Series Essen Germany ATP World Tour,HARD,2,Alexander Volkov,Alberto Berasategui,Alexander Volkov,7-6(5); 6-2,R64,62,13,0,41,66,35,41,12,25,2,3,10,47,66,1,3,37,56,27,37,9,19,1,4,10,36,56
1995-10-23 00:00:00.000,ATP Masters Series Essen Germany ATP World Tour,HARD,2,Yevgeny Kafelnikov,N/A Bye,Yevgeny Kafelnikov,,R64,0,0,0,0,0,0,0,0,0,0,0,0,0,0,0,0,0,0,0,0,0,0,0,0,0,0,0
1995-10-23 00:00:00.000,ATP Masters Series Essen Germany ATP World Tour,HARD,2,Michael Chang,N/A Bye,Michael Chang,,R64,0,0,0,0,0,0,0,0,0,0,0,0,0,0,0,0,0,0,0,0,0,0,0,0,0,0,0
1995-10-23 00:00:00.000,ATP Masters Series Essen Germany ATP World Tour,HARD,2,Daniel Vacek,Guy Forget,Daniel Vacek,6-3; 1-6; 6-1,R64,91,11,5,38,68,32,38,15,30,3,5,12,47,68,7,0,45,73,29,45,13,28,4,7,11,42,73
1995-10-23 00:00:00.000,ATP Masters Series Essen Germany ATP World Tour,HARD,2,Joost Winnink,Paul Haarhuis,Joost Winnink,6-1; 6-1,R64,45,6,0,20,36,19,20,10,16,1,1,7,29,36,0,3,21,45,12,21,6,24,5,10,7,18,45
1995-10-23 00:00:00.000,ATP Masters Series Essen Germany ATP World Tour,HARD,2,Sergi Bruguera,N/A Bye,Sergi Bruguera,,R64,0,0,0,0,0,0,0,0,0,0,0,0,0,0,0,0,0,0,0,0,0,0,0,0,0,0,0
1995-10-23 00:00:00.000,ATP Masters Series Essen Germany ATP World Tour,HARD,2,Andrei Medvedev,N/A Bye,Andrei Medvedev,,R64,0,0,0,0,0,0,0,0,0,0,0,0,0,0,0,0,0,0,0,0,0,0,0,0,0,0,0
1995-10-23 00:00:00.000,ATP Masters Series Essen Germany ATP World Tour,HARD,2,Javier Frana,Oleg Ogorodov,Javier Frana,6-2; 6-2,R64,59,4,0,23,49,17,23,18,26,1,1,8,35,49,1,1,27,51,18,27,9,24,2,6,8,27,51
1995-10-23 00:00:00.000,ATP Masters Series Essen Germany ATP World Tour,HARD,2,Byron Black,Patrik Kuhnen,Byron Black,6-3; 6-1,R64,49,5,2,22,40,20,22,12,18,0,0,8,32,40,9,3,22,42,15,22,8,20,1,5,8,23,42
1995-10-23 00:00:00.000,ATP Masters Series Essen Germany ATP World Tour,HARD,2,Thomas Muster,N/A Bye,Thomas Muster,,R64,0,0,0,0,0,0,0,0,0,0,0,0,0,0,0,0,0,0,0,0,0,0,0,0,0,0,0
1995-10-23 00:00:00.000,ATP Masters Series Essen Germany ATP World Tour,HARD,2,Jim Courier,N/A Bye,Jim Courier,,R64,0,0,0,0,0,0,0,0,0,0,0,0,0,0,0,0,0,0,0,0,0,0,0,0,0,0,0
1995-10-23 00:00:00.000,ATP Masters Series Essen Germany ATP World Tour,HARD,2,Alex Radulescu,Carl-Uwe Steeb,Alex Radulescu,6-0; 6-7(2); 7-5,R64,103,22,4,50,93,39,50,29,43,3,3,15,68,93,7,3,60,97,42,60,20,37,7,11,15,62,97
1995-10-23 00:00:00.000,ATP Masters Series Essen Germany ATP World Tour,HARD,2,Greg Rusedski,Jonas Bjorkman,Greg Rusedski,3-6; 7-6(7); 6-4,R64,109,12,13,70,115,54,70,18,45,7,10,16,72,115,0,1,65,93,46,65,17,28,1,3,15,63,93
1995-10-23 00:00:00.000,ATP Masters Series Essen Germany ATP World Tour,HARD,2,Marc Rosset,N/A Bye,Marc Rosset,,R64,0,0,0,0,0,0,0,0,0,0,0,0,0,0,0,0,0,0,0,0,0,0,0,0,0,0,0
1995-10-23 00:00:00.000,ATP Masters Series Essen Germany ATP World Tour,HARD,2,Jan Siemerink,N/A Bye,Jan Siemerink,,R64,0,0,0,0,0,0,0,0,0,0,0,0,0,0,0,0,0,0,0,0,0,0,0,0,0,0,0
1995-10-23 00:00:00.000,ATP Masters Series Essen Germany ATP World Tour,HARD,2,Mark Woodforde,Patrick McEnroe,Mark Woodforde,6-3; 6-2,R64,69,7,0,38,52,31,38,8,14,2,2,9,39,52,1,7,25,57,17,25,12,32,6,9,8,29,57
1995-10-23 00:00:00.000,ATP Masters Series Essen Germany ATP World Tour,HARD,2,Stefan Edberg,Renzo Furlan,Stefan Edberg,6-3; 6-1,R64,58,4,1,30,45,26,30,7,15,0,0,8,33,45,1,1,26,53,16,26,10,27,3,7,8,26,53
1995-10-23 00:00:00.000,ATP Masters Series Essen Germany ATP World Tour,HARD,2,Pete Sampras,N/A Bye,Pete Sampras,,R64,0,0,0,0,0,0,0,0,0,0,0,0,0,0,0,0,0,0,0,0,0,0,0,0,0,0,0
1995-10-23 00:00:00.000,ATP Masters Series Essen Germany ATP World Tour,HARD,2,Andre Agassi,Jacco Eltingh,Andre Agassi,6-2; 6-4,R32,77,9,1,38,61,29,38,13,23,4,4,9,42,61,10,2,44,69,29,44,10,25,7,10,9,39,69
1995-10-23 00:00:00.000,ATP Masters Series Essen Germany ATP World Tour,HARD,2,MaliVai Washington,Andrea Gaudenzi,MaliVai Washington,7-5; 4-6; 6-3,R32,121,12,3,49,94,39,49,24,45,2,4,16,63,94,5,5,51,101,38,51,27,50,9,12,15,65,101
1995-10-23 00:00:00.000,ATP Masters Series Essen Germany ATP World Tour,HARD,2,Thomas Enqvist,Todd Martin,Thomas Enqvist,6-3; 6-4,R32,66,2,3,25,54,23,25,19,29,2,2,10,42,54,9,4,33,51,26,33,5,18,1,3,9,31,51
1995-10-23 00:00:00.000,ATP Masters Series Essen Germany ATP World Tour,HARD,2,Martin Sinner,Goran Ivanisevic,Martin Sinner,4-6; 7-6(5); 6-4,R32,117,8,4,51,95,39,51,22,44,2,5,16,61,95,16,7,51,102,41,51,25,51,6,9,16,66,102
1995-10-23 00:00:00.000,ATP Masters Series Essen Germany ATP World Tour,HARD,2,Boris Becker,Magnus Gustafsson,Boris Becker,7-6(2); 6-4,R32,89,11,4,46,74,36,46,13,28,2,4,11,49,74,2,2,42,65,28,42,11,23,0,3,11,39,65
1995-10-23 00:00:00.000,ATP Masters Series Essen Germany ATP World Tour,HARD,2,Richard Krajicek,Brett Steven,Richard Krajicek,6-3; 6-4,R32,65,11,1,27,50,24,27,14,23,2,2,9,38,50,1,2,39,56,28,39,7,17,2,5,10,35,56
1995-10-23 00:00:00.000,ATP Masters Series Essen Germany ATP World Tour,HARD,2,Arnaud Boetsch,Wayne Ferreira,Arnaud Boetsch,6-3; 6-2,R32,62,4,2,25,55,16,25,18,30,3,5,8,34,55,0,3,42,61,21,42,3,19,2,8,9,24,61
1995-10-23 00:00:00.000,ATP Masters Series Essen Germany ATP World Tour,HARD,2,Yevgeny Kafelnikov,Alexander Volkov,Yevgeny Kafelnikov,6-4; 2-6; 6-1,R32,82,12,7,38,82,27,38,25,44,5,8,13,52,82,11,1,38,68,31,38,10,30,0,4,12,41,68
1995-10-23 00:00:00.000,ATP Masters Series Essen Germany ATP World Tour,HARD,2,Daniel Vacek,Michael Chang,Daniel Vacek,6-2; 7-6(5),R32,99,14,6,54,88,44,54,12,34,7,8,10,56,88,4,4,33,73,24,33,18,40,4,7,10,42,73
1995-10-23 00:00:00.000,ATP Masters Series Essen Germany ATP World Tour,HARD,2,Sergi Bruguera,Joost Winnink,Sergi Bruguera,6-3; 6-2,R32,65,0,0,27,51,19,27,15,24,5,7,9,34,51,4,2,29,60,16,29,12,31,6,11,8,28,60
1995-10-23 00:00:00.000,ATP Masters Series Essen Germany ATP World Tour,HARD,2,Andrei Medvedev,Javier Frana,Andrei Medvedev,6-2; 6-4,R32,72,4,4,29,61,22,29,16,32,4,5,9,38,61,4,1,32,63,17,32,14,31,6,10,9,31,63
1995-10-23 00:00:00.000,ATP Masters Series Essen Germany ATP World Tour,HARD,2,Thomas Muster,Byron Black,Thomas Muster,6-2; 6-3,R32,70,2,1,31,66,25,31,19,35,3,3,9,44,66,1,3,27,48,15,27,12,21,2,5,8,27,48
1995-10-23 00:00:00.000,ATP Masters Series Essen Germany ATP World Tour,HARD,2,Jim Courier,Alex Radulescu,Jim Courier,6-0; 7-6(3),R32,74,1,1,30,51,26,30,17,21,2,2,9,43,51,3,0,32,56,23,32,11,24,4,7,9,34,56
1995-10-23 00:00:00.000,ATP Masters Series Essen Germany ATP World Tour,HARD,2,Marc Rosset,Greg Rusedski,Marc Rosset,6-4; 6-4,R32,57,4,4,35,59,30,35,13,24,5,5,10,43,59,4,3,30,56,23,30,14,26,1,3,10,37,56
1995-10-23 00:00:00.000,ATP Masters Series Essen Germany ATP World Tour,HARD,2,Mark Woodforde,Jan Siemerink,Mark Woodforde,6-3; 6-4,R32,84,1,2,43,66,32,43,13,23,4,4,10,45,66,5,7,36,72,23,36,18,36,7,9,9,41,72
1995-10-23 00:00:00.000,ATP Masters Series Essen Germany ATP World Tour,HARD,2,Pete Sampras,Stefan Edberg,Pete Sampras,6-3; 6-2,R32,63,12,5,38,61,33,38,7,23,4,5,9,40,61,1,2,39,50,24,39,2,11,5,9,8,26,50
1995-10-23 00:00:00.000,ATP Masters Series Essen Germany ATP World Tour,HARD,2,MaliVai Washington,Andre Agassi,MaliVai Washington,4-6; 6-1; 6-1,R16,89,12,1,45,71,35,45,14,26,3,4,12,49,71,2,6,45,84,32,45,14,39,7,12,12,46,84
1995-10-23 00:00:00.000,ATP Masters Series Essen Germany ATP World Tour,HARD,2,Thomas Enqvist,Martin Sinner,Thomas Enqvist,6-4; 6-3,R16,82,6,1,32,59,20,32,19,27,6,7,9,39,59,1,3,33,63,22,33,13,30,6,10,10,35,63
1995-10-23 00:00:00.000,ATP Masters Series Essen Germany ATP World Tour,HARD,2,Richard Krajicek,Boris Becker,Richard Krajicek,6-4; 6-7(4); 6-3,R16,145,16,7,79,130,55,79,28,51,9,10,16,83,130,9,7,50,92,42,50,19,42,1,4,15,61,92
1995-10-23 00:00:00.000,ATP Masters Series Essen Germany ATP World Tour,HARD,2,Arnaud Boetsch,Yevgeny Kafelnikov,Arnaud Boetsch,2-6; 6-3; 6-1,R16,87,6,6,41,74,28,41,15,33,9,13,12,43,74,3,7,44,87,28,44,15,43,7,13,12,43,87
1995-10-23 00:00:00.000,ATP Masters Series Essen Germany ATP World Tour,HARD,2,Sergi Bruguera,Daniel Vacek,Sergi Bruguera,7-6(6); 7-6(1),R16,96,9,2,56,86,40,56,15,30,4,6,12,55,86,8,6,50,84,39,50,14,34,4,6,12,53,84
1995-10-23 00:00:00.000,ATP Masters Series Essen Germany ATP World Tour,HARD,2,Thomas Muster,Andrei Medvedev,Thomas Muster,6-4; 6-3,R16,80,5,2,42,64,28,42,14,22,5,6,9,42,64,4,8,38,76,25,38,15,38,2,6,10,40,76
1995-10-23 00:00:00.000,ATP Masters Series Essen Germany ATP World Tour,HARD,2,Jim Courier,Marc Rosset,Jim Courier,7-6(4); 3-6; 6-3,R16,134,8,3,62,97,50,62,15,35,5,7,15,65,97,11,7,53,95,44,53,19,42,4,6,15,63,95
1995-10-23 00:00:00.000,ATP Masters Series Essen Germany ATP World Tour,HARD,2,Pete Sampras,Mark Woodforde,Pete Sampras,6-2; 6-4,R16,65,10,2,32,54,28,32,11,22,3,3,9,39,54,3,3,33,55,24,33,9,22,5,8,9,33,55
1995-10-23 00:00:00.000,ATP Masters Series Essen Germany ATP World Tour,HARD,2,MaliVai Washington,Thomas Enqvist,MaliVai Washington,7-5; 6-4,Q,81,8,1,30,61,26,30,23,31,2,2,11,49,61,5,3,45,73,33,45,13,28,3,5,11,46,73
1995-10-23 00:00:00.000,ATP Masters Series Essen Germany ATP World Tour,HARD,2,Arnaud Boetsch,Richard Krajicek,Arnaud Boetsch,6-4; 6-2,Q,58,5,0,23,42,21,23,15,19,0,0,9,36,42,6,5,40,69,28,40,11,29,10,13,9,39,69
1995-10-23 00:00:00.000,ATP Masters Series Essen Germany ATP World Tour,HARD,2,Thomas Muster,Sergi Bruguera,Thomas Muster,6-4; 7-6(3),Q,102,2,3,40,75,26,40,23,35,4,6,11,49,75,5,2,33,70,22,33,20,37,1,4,11,42,70
1995-10-23 00:00:00.000,ATP Masters Series Essen Germany ATP World Tour,HARD,2,Pete Sampras,Jim Courier,Pete Sampras,6-2; 7-6(6),Q,95,13,1,35,71,30,35,17,36,4,5,10,47,71,4,1,43,65,30,43,9,22,1,4,10,39,65
1995-10-23 00:00:00.000,ATP Masters Series Essen Germany ATP World Tour,HARD,2,MaliVai Washington,Arnaud Boetsch,MaliVai Washington,7-5; 6-2,S,63,6,0,38,54,30,38,12,16,2,2,10,42,54,5,2,28,46,22,28,8,18,0,3,10,30,46
1995-10-23 00:00:00.000,ATP Masters Series Essen Germany ATP World Tour,HARD,2,Thomas Muster,Pete Sampras,Thomas Muster,7-6(6); 6-2,S,90,2,1,46,70,33,46,12,24,5,7,10,45,70,6,3,38,69,25,38,12,31,2,6,10,37,69
1995-10-23 00:00:00.000,ATP Masters Series Essen Germany ATP World Tour,HARD,2,Thomas Muster,MaliVai Washington,Thomas Muster,7-6(6); 2-6; 6-3; 6-4,F,151,5,2,61,109,45,61,33,48,1,4,20,78,109,15,2,69,127,54,69,28,58,6,9,19,82,127
1995-10-23 00:00:00.000,Santiago Chile ATP World Tour,CLAY,2,Gilbert Schaller,Fernando Meligeni,Gilbert Schaller,6-4; 6-3,R32,69,4,1,27,42,21,27,10,15,1,3,9,31,42,1,4,25,55,21,25,9,30,5,10,10,30,55
1995-10-23 00:00:00.000,Santiago Chile ATP World Tour,CLAY,2,Hernan Gumy,Christian Ruud,Hernan Gumy,6-7(2); 6-3; 6-0,R32,155,2,3,66,104,46,66,19,38,9,11,14,65,104,4,7,45,90,30,45,18,45,4,10,13,48,90
1995-10-23 00:00:00.000,Santiago Chile ATP World Tour,CLAY,2,Tomas Carbonell,Jiri Novak,Tomas Carbonell,6-3; 6-2,R32,56,5,2,37,54,27,37,11,17,3,4,9,38,54,2,5,30,49,17,30,9,19,8,12,8,26,49
1995-10-23 00:00:00.000,Santiago Chile ATP World Tour,CLAY,2,Alex Corretja,Nuno Marques,Alex Corretja,4-6; 7-5; 6-3,R32,128,3,1,75,102,48,75,16,27,3,6,16,64,102,3,4,65,103,41,65,19,38,12,16,15,60,103
1995-10-23 00:00:00.000,Santiago Chile ATP World Tour,CLAY,2,Marcelo Rios,Jordi Burillo,Marcelo Rios,7-6(2); 7-5,R32,82,8,3,49,76,39,49,13,27,6,8,12,52,76,8,3,31,73,22,31,24,42,3,6,12,46,73
1995-10-23 00:00:00.000,Santiago Chile ATP World Tour,CLAY,2,Karim Alami,Franco Davin,Karim Alami,6-3; 4-6; 6-4,R32,111,7,5,50,105,32,50,29,55,13,18,15,61,105,4,4,54,84,38,54,8,30,6,12,14,46,84
1995-10-23 00:00:00.000,Santiago Chile ATP World Tour,CLAY,2,Jaime Yzaga,Frederic Fontang,Jaime Yzaga,6-2; 2-6; 6-2,R32,91,0,2,43,70,30,43,14,27,0,3,12,44,70,1,4,47,75,31,47,10,28,1,6,12,41,75
1995-10-23 00:00:00.000,Santiago Chile ATP World Tour,CLAY,2,David Rikl,Javier Sanchez,David Rikl,7-5; 6-3,R32,65,4,6,40,61,30,40,10,21,1,3,11,40,61,1,1,33,55,20,33,11,22,3,7,10,31,55
1995-10-23 00:00:00.000,Santiago Chile ATP World Tour,CLAY,2,Fabrice Santoro,Bohdan Ulihrach,Fabrice Santoro,6-2; 2-6; 6-3,R32,123,4,7,46,89,30,46,14,43,4,10,13,44,89,4,7,32,88,19,32,21,56,5,12,12,40,88
1995-10-23 00:00:00.000,Santiago Chile ATP World Tour,CLAY,2,Mauricio Hadad,Marcelo Filippini,Mauricio Hadad,6-1; 7-6(6),R32,96,0,0,30,66,21,30,25,36,2,3,10,46,66,1,3,45,74,25,45,15,29,6,9,9,40,74
1995-10-23 00:00:00.000,Santiago Chile ATP World Tour,CLAY,2,Slava Dosedel,Gabriel Silberstein,Slava Dosedel,6-3; 6-3,R32,69,3,2,36,60,27,36,12,24,2,3,9,39,60,2,1,34,53,22,34,8,19,3,7,9,30,53
1995-10-23 00:00:00.000,Santiago Chile ATP World Tour,CLAY,2,Jaime Oncins,Francisco Clavet,Jaime Oncins,6-3; 6-2,R32,94,6,5,38,65,28,38,13,27,8,9,9,41,65,2,6,37,77,23,37,14,40,13,17,8,37,77
1995-10-23 00:00:00.000,Santiago Chile ATP World Tour,CLAY,2,Sjeng Schalken,Vincent Spadea,Sjeng Schalken,5-7; 6-4; 6-4,R32,120,9,13,63,103,46,63,14,40,7,11,16,60,103,6,5,51,94,37,51,16,43,6,11,16,53,94
1995-10-23 00:00:00.000,Santiago Chile ATP World Tour,CLAY,2,Nicolas Pereira,Emilio Sanchez,Nicolas Pereira,6-4; 7-5,R32,93,8,2,56,92,42,56,18,36,11,11,11,60,92,3,1,61,72,39,61,6,11,6,8,11,45,72
1995-10-23 00:00:00.000,Santiago Chile ATP World Tour,CLAY,2,Razvan Sabau,Carlos Moya,Razvan Sabau,7-6(7); 6-1,R32,74,0,1,38,66,26,38,17,28,4,5,9,43,66,4,3,35,72,23,35,16,37,6,10,10,39,72
1995-10-23 00:00:00.000,Santiago Chile ATP World Tour,CLAY,2,Albert Costa,Jordi Arrese,Albert Costa,6-4; 7-6(4),R32,86,4,4,42,68,30,42,15,26,0,2,11,45,68,1,2,51,74,35,51,9,23,3,6,11,44,74
1995-10-23 00:00:00.000,Santiago Chile ATP World Tour,CLAY,2,Hernan Gumy,Gilbert Schaller,Hernan Gumy,6-4; 7-6(0),R16,89,4,3,38,58,32,38,13,20,0,1,11,45,58,0,0,40,67,27,40,16,27,3,5,11,43,67
1995-10-23 00:00:00.000,Santiago Chile ATP World Tour,CLAY,2,Alex Corretja,Tomas Carbonell,Alex Corretja,7-5; 7-5,R16,95,3,1,62,86,44,62,12,24,5,6,12,56,86,6,2,46,74,31,46,13,28,5,8,12,44,74
1995-10-23 00:00:00.000,Santiago Chile ATP World Tour,CLAY,2,Marcelo Rios,Karim Alami,Marcelo Rios,6-1; 6-2,R16,56,1,1,24,41,22,24,11,17,0,0,8,33,41,3,2,25,55,17,25,8,30,7,11,7,25,55
1995-10-23 00:00:00.000,Santiago Chile ATP World Tour,CLAY,2,David Rikl,Jaime Yzaga,David Rikl,6-1; 6-1,R16,59,2,3,29,53,25,29,10,24,3,3,7,35,53,0,5,26,54,16,26,7,28,4,9,7,23,54
1995-10-23 00:00:00.000,Santiago Chile ATP World Tour,CLAY,2,Mauricio Hadad,Fabrice Santoro,Mauricio Hadad,4-6; 6-3; 6-2,R16,125,3,3,58,92,43,58,16,34,2,4,14,59,92,1,3,39,77,24,39,22,38,4,8,13,46,77
1995-10-23 00:00:00.000,Santiago Chile ATP World Tour,CLAY,2,Slava Dosedel,Jaime Oncins,Slava Dosedel,6-2; 7-5,R16,85,1,1,38,60,27,38,14,22,3,4,10,41,60,2,7,43,75,30,43,10,32,4,8,10,40,75
1995-10-23 00:00:00.000,Santiago Chile ATP World Tour,CLAY,2,Sjeng Schalken,Nicolas Pereira,Sjeng Schalken,6-1; 6-4,R16,63,6,0,31,44,27,31,9,13,0,0,9,36,44,2,0,37,63,27,37,7,26,5,8,8,34,63
1995-10-23 00:00:00.000,Santiago Chile ATP World Tour,CLAY,2,Albert Costa,Razvan Sabau,Albert Costa,6-2; 6-3,R16,59,2,2,30,48,23,30,9,18,1,2,8,32,48,2,2,36,65,18,36,14,29,11,16,9,32,65
1995-10-23 00:00:00.000,Santiago Chile ATP World Tour,CLAY,2,Hernan Gumy,Alex Corretja,Hernan Gumy,7-6(2); 6-1,Q,84,4,2,36,51,29,36,9,15,0,1,9,38,51,1,0,35,55,18,35,10,20,0,4,10,28,55
1995-10-23 00:00:00.000,Santiago Chile ATP World Tour,CLAY,2,Marcelo Rios,David Rikl,Marcelo Rios,6-2; 4-6; 6-4,Q,91,4,2,49,66,38,49,12,17,2,4,14,50,66,7,5,50,90,34,50,19,40,9,13,14,53,90
1995-10-23 00:00:00.000,Santiago Chile ATP World Tour,CLAY,2,Slava Dosedel,Mauricio Hadad,Slava Dosedel,5-7; 7-5; 6-3,Q,138,4,0,76,116,46,76,18,40,10,16,16,64,116,4,6,58,101,36,58,15,43,2,10,17,51,101
1995-10-23 00:00:00.000,Santiago Chile ATP World Tour,CLAY,2,Albert Costa,Sjeng Schalken,Albert Costa,6-7(1); 7-5; 6-3,Q,134,4,4,93,132,54,93,17,39,7,12,17,71,132,1,9,68,114,44,68,19,46,8,15,16,63,114
1995-10-23 00:00:00.000,Santiago Chile ATP World Tour,CLAY,2,Marcelo Rios,Hernan Gumy,Marcelo Rios,3-6; 6-4; 6-2,S,104,6,0,57,80,37,57,16,23,2,4,13,53,80,5,2,48,79,35,48,14,31,7,11,14,49,79
1995-10-23 00:00:00.000,Santiago Chile ATP World Tour,CLAY,2,Slava Dosedel,Albert Costa,Slava Dosedel,6-4; 6-0,S,63,3,2,28,46,21,28,10,18,4,5,8,31,46,0,3,37,58,17,37,9,21,3,8,8,26,58
1995-10-23 00:00:00.000,Santiago Chile ATP World Tour,CLAY,2,Slava Dosedel,Marcelo Rios,Slava Dosedel,7-6(3); 6-3,F,87,5,0,50,67,37,50,10,17,2,3,11,47,67,3,2,40,71,26,40,16,31,4,6,10,42,71
1995-10-30 00:00:00.000,ATP Masters Series Paris France ATP World Tour,HARD,2,Pete Sampras,N/A Bye,Pete Sampras,,R64,0,0,0,0,0,0,0,0,0,0,0,0,0,0,0,0,0,0,0,0,0,0,0,0,0,0,0
1995-10-30 00:00:00.000,ATP Masters Series Paris France ATP World Tour,HARD,2,Arnaud Boetsch,Jonas Bjorkman,Arnaud Boetsch,6-2; 7-6(3),R64,81,1,2,37,66,25,37,18,29,2,5,10,43,66,0,2,31,62,15,31,15,31,5,10,10,30,62
1995-10-30 00:00:00.000,ATP Masters Series Paris France ATP World Tour,HARD,2,David Wheaton,Renzo Furlan,David Wheaton,6-2; 6-3,R64,72,7,1,39,58,30,39,10,19,2,3,9,40,58,1,1,28,51,15,28,11,23,4,8,8,26,51
1995-10-30 00:00:00.000,ATP Masters Series Paris France ATP World Tour,HARD,2,Jan Siemerink,N/A Bye,Jan Siemerink,,R64,0,0,0,0,0,0,0,0,0,0,0,0,0,0,0,0,0,0,0,0,0,0,0,0,0,0,0
1995-10-30 00:00:00.000,ATP Masters Series Paris France ATP World Tour,HARD,2,Marc Rosset,N/A Bye,Marc Rosset,,R64,0,0,0,0,0,0,0,0,0,0,0,0,0,0,0,0,0,0,0,0,0,0,0,0,0,0,0
1995-10-30 00:00:00.000,ATP Masters Series Paris France ATP World Tour,HARD,2,Guillaume Raoux,Oleg Ogorodov,Guillaume Raoux,6-4; 6-3,R64,76,6,5,33,66,26,33,20,33,4,4,10,46,66,7,3,27,57,24,27,11,30,4,6,9,35,57
1995-10-30 00:00:00.000,ATP Masters Series Paris France ATP World Tour,HARD,2,Jakob Hlasek,Bernd Karbacher,Jakob Hlasek,6-1; 6-3,R64,56,2,3,29,50,22,29,12,21,2,3,8,34,50,1,2,26,54,14,26,11,28,2,7,8,25,54
1995-10-30 00:00:00.000,ATP Masters Series Paris France ATP World Tour,HARD,2,Thomas Enqvist,N/A Bye,Thomas Enqvist,,R64,0,0,0,0,0,0,0,0,0,0,0,0,0,0,0,0,0,0,0,0,0,0,0,0,0,0,0
1995-10-30 00:00:00.000,ATP Masters Series Paris France ATP World Tour,HARD,2,Michael Chang,N/A Bye,Michael Chang,,R64,0,0,0,0,0,0,0,0,0,0,0,0,0,0,0,0,0,0,0,0,0,0,0,0,0,0,0
1995-10-30 00:00:00.000,ATP Masters Series Paris France ATP World Tour,HARD,2,Byron Black,Andrei Pavel,Byron Black,7-6(4); 6-3,R64,84,2,0,42,76,28,42,22,34,3,5,11,50,76,5,3,46,75,32,46,10,29,5,8,10,42,75
1995-10-30 00:00:00.000,ATP Masters Series Paris France ATP World Tour,HARD,2,MaliVai Washington,Todd Woodbridge,MaliVai Washington,4-6; 6-4; 6-2,R64,123,3,1,60,106,42,60,20,46,12,16,14,62,106,3,7,43,90,26,43,22,47,5,11,14,48,90
1995-10-30 00:00:00.000,ATP Masters Series Paris France ATP World Tour,HARD,2,Andrei Medvedev,N/A Bye,Andrei Medvedev,,R64,0,0,0,0,0,0,0,0,0,0,0,0,0,0,0,0,0,0,0,0,0,0,0,0,0,0,0
1995-10-30 00:00:00.000,ATP Masters Series Paris France ATP World Tour,HARD,2,Magnus Larsson,N/A Bye,Magnus Larsson,,R64,0,0,0,0,0,0,0,0,0,0,0,0,0,0,0,0,0,0,0,0,0,0,0,0,0,0,0
1995-10-30 00:00:00.000,ATP Masters Series Paris France ATP World Tour,HARD,2,Mark Woodforde,Jim Grabb,Mark Woodforde,6-1; 6-3,R64,71,1,3,25,47,20,25,12,22,4,5,8,32,47,6,3,41,63,25,41,5,22,3,8,8,30,63
1995-10-30 00:00:00.000,ATP Masters Series Paris France ATP World Tour,HARD,2,Jacco Eltingh,Brett Steven,Jacco Eltingh,6-4; 3-6; 7-6(2),R64,121,3,3,68,94,54,68,12,26,5,6,15,66,94,7,3,69,106,48,69,23,37,4,5,16,71,106
1995-10-30 00:00:00.000,ATP Masters Series Paris France ATP World Tour,HARD,2,Jim Courier,N/A Bye,Jim Courier,,R64,0,0,0,0,0,0,0,0,0,0,0,0,0,0,0,0,0,0,0,0,0,0,0,0,0,0,0
1995-10-30 00:00:00.000,ATP Masters Series Paris France ATP World Tour,HARD,2,Goran Ivanisevic,N/A Bye,Goran Ivanisevic,,R64,0,0,0,0,0,0,0,0,0,0,0,0,0,0,0,0,0,0,0,0,0,0,0,0,0,0,0
1995-10-30 00:00:00.000,ATP Masters Series Paris France ATP World Tour,HARD,2,Paul Haarhuis,Adrian Voinea,Paul Haarhuis,6-3; 2-6; 6-3,R64,100,8,3,56,91,41,56,18,35,8,10,13,59,91,4,5,43,76,32,43,17,33,2,5,13,49,76
1995-10-30 00:00:00.000,ATP Masters Series Paris France ATP World Tour,HARD,2,Cedric Pioline,Magnus Gustafsson,Cedric Pioline,6-2; 6-4,R64,77,4,2,28,55,22,28,12,27,4,6,9,34,55,1,3,32,57,16,32,12,25,3,8,9,28,57
1995-10-30 00:00:00.000,ATP Masters Series Paris France ATP World Tour,HARD,2,Richard Krajicek,N/A Bye,Richard Krajicek,,R64,0,0,0,0,0,0,0,0,0,0,0,0,0,0,0,0,0,0,0,0,0,0,0,0,0,0,0
1995-10-30 00:00:00.000,ATP Masters Series Paris France ATP World Tour,HARD,2,Todd Martin,N/A Bye,Todd Martin,,R64,0,0,0,0,0,0,0,0,0,0,0,0,0,0,0,0,0,0,0,0,0,0,0,0,0,0,0
1995-10-30 00:00:00.000,ATP Masters Series Paris France ATP World Tour,HARD,2,Hendrik Jan Davids,Lionel Roux,Hendrik Jan Davids,6-2; 3-6; 6-3,R64,118,4,3,54,92,38,54,20,38,3,4,13,58,92,1,3,48,91,30,48,25,43,5,8,13,55,91
1995-10-30 00:00:00.000,ATP Masters Series Paris France ATP World Tour,HARD,2,Alexander Volkov,Daniel Courcol,Alexander Volkov,4-6; 6-3; 6-3,R64,97,3,3,48,78,37,48,17,30,0,2,14,54,78,9,6,42,91,29,42,23,49,5,9,14,52,91
1995-10-30 00:00:00.000,ATP Masters Series Paris France ATP World Tour,HARD,2,Boris Becker,N/A Bye,Boris Becker,,R64,0,0,0,0,0,0,0,0,0,0,0,0,0,0,0,0,0,0,0,0,0,0,0,0,0,0,0
1995-10-30 00:00:00.000,ATP Masters Series Paris France ATP World Tour,HARD,2,Sergi Bruguera,N/A Bye,Sergi Bruguera,,R64,0,0,0,0,0,0,0,0,0,0,0,0,0,0,0,0,0,0,0,0,0,0,0,0,0,0,0
1995-10-30 00:00:00.000,ATP Masters Series Paris France ATP World Tour,HARD,2,Henri Leconte,Aaron Krickstein,Henri Leconte,7-5; 6-3,R64,80,7,3,27,58,21,27,19,31,1,3,11,40,58,2,3,37,65,21,37,16,28,7,11,10,37,65
1995-10-30 00:00:00.000,ATP Masters Series Paris France ATP World Tour,HARD,2,Richey Reneberg,Martin Sinner,Richey Reneberg,6-2; 7-5,R64,85,10,0,40,62,31,40,10,22,2,3,10,41,62,2,9,31,66,19,31,16,35,1,5,10,35,66
1995-10-30 00:00:00.000,ATP Masters Series Paris France ATP World Tour,HARD,2,Wayne Ferreira,N/A Bye,Wayne Ferreira,,R64,0,0,0,0,0,0,0,0,0,0,0,0,0,0,0,0,0,0,0,0,0,0,0,0,0,0,0
1995-10-30 00:00:00.000,ATP Masters Series Paris France ATP World Tour,HARD,2,Andrea Gaudenzi,N/A Bye,Andrea Gaudenzi,,R64,0,0,0,0,0,0,0,0,0,0,0,0,0,0,0,0,0,0,0,0,0,0,0,0,0,0,0
1995-10-30 00:00:00.000,ATP Masters Series Paris France ATP World Tour,HARD,2,Daniel Vacek,Patrick McEnroe,Daniel Vacek,6-7(3); 6-4; 6-1,R64,125,17,5,57,91,45,57,18,34,5,6,14,63,91,2,1,54,97,34,54,25,43,6,11,15,59,97
1995-10-30 00:00:00.000,ATP Masters Series Paris France ATP World Tour,HARD,2,Guy Forget,Jerome Golmard,Guy Forget,6-7(5); 6-4; 6-1,R64,120,14,4,57,102,43,57,31,45,2,2,15,74,102,10,6,46,87,35,46,23,41,2,5,14,58,87
1995-10-30 00:00:00.000,ATP Masters Series Paris France ATP World Tour,HARD,2,Thomas Muster,N/A Bye,Thomas Muster,,R64,0,0,0,0,0,0,0,0,0,0,0,0,0,0,0,0,0,0,0,0,0,0,0,0,0,0,0
1995-10-30 00:00:00.000,ATP Masters Series Paris France ATP World Tour,HARD,2,Pete Sampras,Arnaud Boetsch,Pete Sampras,6-3; 6-4,R32,77,9,5,31,55,29,31,12,24,0,0,10,41,55,5,5,26,63,18,26,19,37,6,8,9,37,63
1995-10-30 00:00:00.000,ATP Masters Series Paris France ATP World Tour,HARD,2,Jan Siemerink,David Wheaton,Jan Siemerink,7-6(6); 7-6(4),R32,101,5,4,50,82,40,50,20,32,1,2,12,60,82,3,3,49,75,41,49,13,26,0,1,12,54,75
1995-10-30 00:00:00.000,ATP Masters Series Paris France ATP World Tour,HARD,2,Marc Rosset,Guillaume Raoux,Marc Rosset,6-4; 6-2,R32,70,8,2,26,55,22,26,17,29,3,3,9,39,55,4,4,23,62,15,23,21,39,3,6,9,36,62
1995-10-30 00:00:00.000,ATP Masters Series Paris France ATP World Tour,HARD,2,Jakob Hlasek,Thomas Enqvist,Jakob Hlasek,7-6(3); 6-3,R32,87,8,1,55,82,44,55,9,27,8,9,10,53,82,7,6,40,79,30,40,17,39,7,10,11,47,79
1995-10-30 00:00:00.000,ATP Masters Series Paris France ATP World Tour,HARD,2,Michael Chang,Byron Black,Michael Chang,4-6; 6-3; 6-3,R32,124,14,5,32,89,24,32,29,57,6,10,14,53,89,4,2,55,97,35,55,18,42,4,10,14,53,97
1995-10-30 00:00:00.000,ATP Masters Series Paris France ATP World Tour,HARD,2,Andrei Medvedev,MaliVai Washington,Andrei Medvedev,6-4; 6-4,R32,81,8,5,32,67,24,32,18,35,6,8,10,42,67,6,4,32,65,21,32,15,33,3,7,10,36,65
1995-10-30 00:00:00.000,ATP Masters Series Paris France ATP World Tour,HARD,2,Magnus Larsson,Mark Woodforde,Magnus Larsson,4-6; 7-6(8); 6-0,R32,123,10,2,60,98,33,60,19,38,4,9,13,52,98,3,10,48,107,29,48,26,59,7,14,14,55,107
1995-10-30 00:00:00.000,ATP Masters Series Paris France ATP World Tour,HARD,2,Jim Courier,Jacco Eltingh,Jim Courier,6-1; 6-7(2); 6-2,R32,113,9,0,56,81,45,56,17,25,4,4,14,62,81,12,3,53,81,37,53,14,28,3,7,13,51,81
1995-10-30 00:00:00.000,ATP Masters Series Paris France ATP World Tour,HARD,2,Paul Haarhuis,Goran Ivanisevic,Paul Haarhuis,6-3; 4-6; 6-4,R32,87,15,2,52,82,41,52,19,30,0,1,15,60,82,14,2,44,81,34,44,19,37,3,5,14,53,81
1995-10-30 00:00:00.000,ATP Masters Series Paris France ATP World Tour,HARD,2,Richard Krajicek,Cedric Pioline,Richard Krajicek,4-6; 6-4; 7-5,R32,136,17,5,67,115,50,67,23,48,8,9,16,73,115,7,2,56,96,44,56,22,40,2,4,16,66,96
1995-10-30 00:00:00.000,ATP Masters Series Paris France ATP World Tour,HARD,2,Todd Martin,Hendrik Jan Davids,Todd Martin,6-3; 6-4,R32,69,8,4,39,66,29,39,15,27,6,7,10,44,66,2,0,29,51,16,29,13,22,3,6,9,29,51
1995-10-30 00:00:00.000,ATP Masters Series Paris France ATP World Tour,HARD,2,Boris Becker,Alexander Volkov,Boris Becker,3-6; 6-3; 6-4,R32,104,9,4,46,84,37,46,16,38,3,6,14,53,84,7,3,44,79,32,44,16,35,0,4,14,48,79
1995-10-30 00:00:00.000,ATP Masters Series Paris France ATP World Tour,HARD,2,Sergi Bruguera,Henri Leconte,Sergi Bruguera,6-4; 4-6; 6-2,R32,118,6,1,48,74,37,48,15,26,5,7,14,52,74,7,4,47,106,31,47,28,59,8,12,14,59,106
1995-10-30 00:00:00.000,ATP Masters Series Paris France ATP World Tour,HARD,2,Wayne Ferreira,Richey Reneberg,Wayne Ferreira,6-2; 5-7; 6-4,R32,107,9,3,60,104,47,60,17,44,9,12,15,64,104,1,3,54,99,34,54,22,45,2,7,15,56,99
1995-10-30 00:00:00.000,ATP Masters Series Paris France ATP World Tour,HARD,2,Daniel Vacek,Andrea Gaudenzi,Daniel Vacek,6-4; 6-3,R32,72,10,4,37,57,31,37,12,20,2,2,10,43,57,1,2,46,68,28,46,11,22,11,13,9,39,68
1995-10-30 00:00:00.000,ATP Masters Series Paris France ATP World Tour,HARD,2,Guy Forget,Thomas Muster,Guy Forget,6-3; 7-6(4),R32,95,17,2,47,74,38,47,14,27,1,2,11,52,74,6,2,46,76,31,46,14,30,6,8,10,45,76
1995-10-30 00:00:00.000,ATP Masters Series Paris France ATP World Tour,HARD,2,Pete Sampras,Jan Siemerink,Pete Sampras,6-3; 6-4,R16,63,9,0,27,51,25,27,17,24,0,0,10,42,51,4,2,40,57,28,40,8,17,3,5,9,36,57
1995-10-30 00:00:00.000,ATP Masters Series Paris France ATP World Tour,HARD,2,Jakob Hlasek,Marc Rosset,Jakob Hlasek,2-6; 7-6(1); 7-6(3),R16,125,9,4,79,116,59,79,19,37,12,14,16,78,116,23,4,64,98,53,64,18,34,2,2,16,71,98
1995-10-30 00:00:00.000,ATP Masters Series Paris France ATP World Tour,HARD,2,Michael Chang,Andrei Medvedev,Michael Chang,2-6; 6-3; 7-5,R16,143,4,4,41,85,32,41,24,44,6,9,15,56,85,7,4,57,114,38,57,27,57,14,17,14,65,114
1995-10-30 00:00:00.000,ATP Masters Series Paris France ATP World Tour,HARD,2,Jim Courier,Magnus Larsson,Jim Courier,6-3; 6-4,R16,74,5,0,33,51,27,33,13,18,0,0,10,40,51,5,3,40,65,30,40,10,25,4,6,9,40,65
1995-10-30 00:00:00.000,ATP Masters Series Paris France ATP World Tour,HARD,2,Richard Krajicek,Paul Haarhuis,Richard Krajicek,6-4; 6-2,R16,56,13,3,29,49,27,29,12,20,1,1,9,39,49,4,4,27,49,21,27,8,22,3,6,9,29,49
1995-10-30 00:00:00.000,ATP Masters Series Paris France ATP World Tour,HARD,2,Boris Becker,Todd Martin,Boris Becker,6-4; 4-6; 7-5,R16,149,12,8,42,93,32,42,27,51,2,6,16,59,93,10,3,66,118,47,66,20,52,12,17,16,67,118
1995-10-30 00:00:00.000,ATP Masters Series Paris France ATP World Tour,HARD,2,Wayne Ferreira,Sergi Bruguera,Wayne Ferreira,6-2; 3-6; 7-6(3),R16,101,7,2,49,89,35,49,17,40,5,9,14,52,89,8,1,48,90,30,48,23,42,3,8,15,53,90
1995-10-30 00:00:00.000,ATP Masters Series Paris France ATP World Tour,HARD,2,Daniel Vacek,Guy Forget,Daniel Vacek,5-2 RET,R16,41,3,1,13,23,10,13,8,10,2,2,4,18,23,1,0,20,25,11,20,3,5,1,2,4,14,25
1995-10-30 00:00:00.000,ATP Masters Series Paris France ATP World Tour,HARD,2,Pete Sampras,Jakob Hlasek,Pete Sampras,6-2; 6-3,Q,74,15,2,39,72,32,39,16,33,7,7,9,48,72,7,3,35,60,25,35,8,25,4,7,8,33,60
1995-10-30 00:00:00.000,ATP Masters Series Paris France ATP World Tour,HARD,2,Jim Courier,Michael Chang,Jim Courier,6-2; 7-6(5),Q,96,3,1,45,71,31,45,16,26,6,7,10,47,71,6,4,31,62,24,31,13,31,2,5,10,37,62
1995-10-30 00:00:00.000,ATP Masters Series Paris France ATP World Tour,HARD,2,Boris Becker,Richard Krajicek,Boris Becker,4-6; 7-6(5); 6-4,Q,146,15,7,56,110,48,56,22,54,6,10,16,70,110,19,5,63,108,46,63,19,45,6,10,16,65,108
1995-10-30 00:00:00.000,ATP Masters Series Paris France ATP World Tour,HARD,2,Wayne Ferreira,Daniel Vacek,Wayne Ferreira,6-2; 6-4,Q,64,5,1,42,65,33,42,10,23,3,3,9,43,65,2,1,37,54,24,37,8,17,2,5,9,32,54
1995-10-30 00:00:00.000,ATP Masters Series Paris France ATP World Tour,HARD,2,Pete Sampras,Jim Courier,Pete Sampras,6-4; 3-6; 6-3,S,123,17,2,48,82,39,48,15,34,2,4,14,54,82,6,3,54,83,38,54,17,29,2,5,14,55,83
1995-10-30 00:00:00.000,ATP Masters Series Paris France ATP World Tour,HARD,2,Boris Becker,Wayne Ferreira,Boris Becker,6-2; 6-1,S,69,6,5,30,56,23,30,13,26,3,3,7,36,56,3,0,32,61,18,32,11,29,8,13,8,29,61
1995-10-30 00:00:00.000,ATP Masters Series Paris France ATP World Tour,HARD,2,Pete Sampras,Boris Becker,Pete Sampras,7-6(5); 6-4; 6-4,F,161,12,5,56,111,46,56,28,55,6,7,16,74,111,19,6,64,137,45,64,34,73,12,15,16,79,137
1995-10-30 00:00:00.000,Montevideo Uruguay ATP World Tour,CLAY,2,Karim Alami,Gilbert Schaller,Karim Alami,6-3; 4-6; 6-3,R32,109,7,0,34,86,24,34,25,52,3,8,14,49,86,0,0,74,85,39,74,4,11,4,11,14,43,85
1995-10-30 00:00:00.000,Montevideo Uruguay ATP World Tour,CLAY,2,Fabrice Santoro,David Rikl,Fabrice Santoro,6-2; 6-4,R32,80,10,1,32,51,20,32,12,19,2,4,9,32,51,2,4,33,60,19,33,12,27,6,11,9,31,60
1995-10-30 00:00:00.000,Montevideo Uruguay ATP World Tour,CLAY,2,Nicolas Pereira,Nuno Marques,Nicolas Pereira,6-3; 6-4,R32,82,6,0,46,68,36,46,11,22,3,3,10,47,68,1,1,34,66,23,34,15,32,3,5,9,38,66
1995-10-30 00:00:00.000,Montevideo Uruguay ATP World Tour,CLAY,2,Bohdan Ulihrach,Jordi Arrese,Bohdan Ulihrach,6-4; 4-6; 7-5,R32,130,2,5,55,96,35,55,17,41,3,9,16,52,96,1,3,75,101,45,75,11,26,6,13,16,56,101
1995-10-30 00:00:00.000,Montevideo Uruguay ATP World Tour,CLAY,2,Jiri Novak,Marcelo Rios,Jiri Novak,6-4; 4-6; 6-2,R32,110,5,2,75,111,44,75,18,36,15,20,14,62,111,1,0,57,95,32,57,18,38,10,17,14,50,95
1995-10-30 00:00:00.000,Montevideo Uruguay ATP World Tour,CLAY,2,Hernan Gumy,Gabriel Silberstein,Hernan Gumy,6-3; 6-4,R32,92,2,0,40,61,27,40,16,21,5,6,10,43,61,3,3,39,69,23,39,15,30,5,8,9,38,69
1995-10-30 00:00:00.000,Montevideo Uruguay ATP World Tour,CLAY,2,Galo Blanco,Slava Dosedel,Galo Blanco,3-6; 6-2; 7-5,R32,134,4,3,58,79,40,58,13,21,2,5,14,53,79,6,2,74,117,47,74,17,43,9,14,15,64,117
1995-10-30 00:00:00.000,Montevideo Uruguay ATP World Tour,CLAY,2,Francisco Clavet,Christian Ruud,Francisco Clavet,6-4; 6-2,R32,91,2,0,37,55,23,37,11,18,5,8,9,34,55,1,5,41,68,20,41,10,27,5,11,9,30,68
1995-10-30 00:00:00.000,Montevideo Uruguay ATP World Tour,CLAY,2,Carlos Costa,Mauricio Hadad,Carlos Costa,7-5; 6-3,R32,82,0,0,37,61,21,37,17,24,0,3,11,38,61,0,0,39,65,19,39,13,26,1,6,10,32,65
1995-10-30 00:00:00.000,Montevideo Uruguay ATP World Tour,CLAY,2,Fernando Meligeni,Sjeng Schalken,Fernando Meligeni,4-6; 6-4; 6-3,R32,120,2,1,39,86,27,39,24,47,4,8,14,51,86,4,2,59,100,36,59,17,41,9,15,15,53,100
1995-10-30 00:00:00.000,Montevideo Uruguay ATP World Tour,CLAY,2,Carlos Moya,Jaime Yzaga,Carlos Moya,6-3; 1-6; 6-3,R32,102,1,0,66,95,33,66,21,29,9,13,13,54,95,3,3,38,67,22,38,18,29,1,5,12,40,67
1995-10-30 00:00:00.000,Montevideo Uruguay ATP World Tour,CLAY,2,Jordi Burillo,Albert Costa,Jordi Burillo,7-5; 6-2,R32,78,5,2,32,74,22,32,23,42,5,7,10,45,74,1,2,47,60,21,47,7,13,6,11,10,28,60
1995-10-30 00:00:00.000,Montevideo Uruguay ATP World Tour,CLAY,2,Javier Sanchez,Sandor Noszaly,Javier Sanchez,7-6(5); 4-6; 7-6(5),R32,171,5,4,76,119,52,76,22,43,4,8,17,74,119,7,4,95,132,63,95,18,37,10,13,17,81,132
1995-10-30 00:00:00.000,Montevideo Uruguay ATP World Tour,CLAY,2,Marcelo Filippini,Alex Corretja,Marcelo Filippini,6-3; 7-6(3),R32,119,2,0,49,72,31,49,13,23,4,7,10,44,72,3,0,66,92,39,66,10,26,8,13,11,49,92
1995-10-30 00:00:00.000,Montevideo Uruguay ATP World Tour,CLAY,2,Emilio Sanchez,Vincent Spadea,Emilio Sanchez,7-5; 7-5,R32,118,4,0,47,68,28,47,8,21,1,6,12,36,68,3,0,54,95,31,54,14,41,7,14,12,45,95
1995-10-30 00:00:00.000,Montevideo Uruguay ATP World Tour,CLAY,2,Alberto Berasategui,Tomas Carbonell,Alberto Berasategui,6-2; 6-4,R32,59,0,0,40,50,26,40,6,10,2,4,9,32,50,3,3,28,53,18,28,9,25,1,6,9,27,53
1995-10-30 00:00:00.000,Montevideo Uruguay ATP World Tour,CLAY,2,Karim Alami,Fabrice Santoro,Karim Alami,3-6; 6-2; 6-3,R16,130,9,3,44,93,35,44,26,49,13,14,13,61,93,2,2,62,86,41,62,12,24,3,6,13,53,86
1995-10-30 00:00:00.000,Montevideo Uruguay ATP World Tour,CLAY,2,Bohdan Ulihrach,Nicolas Pereira,Bohdan Ulihrach,7-6(4); 6-2,R16,84,1,4,40,73,30,40,16,33,4,6,10,46,73,2,2,37,62,24,37,10,25,0,4,10,34,62
1995-10-30 00:00:00.000,Montevideo Uruguay ATP World Tour,CLAY,2,Hernan Gumy,Jiri Novak,Hernan Gumy,7-6(6); 7-5,R16,112,3,5,47,80,37,47,17,33,5,7,12,54,80,8,0,61,83,38,61,11,22,7,10,12,49,83
1995-10-30 00:00:00.000,Montevideo Uruguay ATP World Tour,CLAY,2,Francisco Clavet,Galo Blanco,Francisco Clavet,6-1; 6-4,R16,88,6,2,37,62,27,37,14,25,3,4,9,41,62,0,2,42,73,25,42,11,31,12,16,8,36,73
1995-10-30 00:00:00.000,Montevideo Uruguay ATP World Tour,CLAY,2,Fernando Meligeni,Carlos Costa,Fernando Meligeni,6-4; 7-6(5),R16,93,5,1,31,68,26,31,23,37,3,4,11,49,68,2,1,51,71,33,51,11,20,3,5,11,44,71
1995-10-30 00:00:00.000,Montevideo Uruguay ATP World Tour,CLAY,2,Jordi Burillo,Carlos Moya,Jordi Burillo,7-6(2); 7-5,R16,99,5,4,48,92,35,48,28,44,8,9,12,63,92,2,5,44,77,32,44,16,33,0,2,12,48,77
1995-10-30 00:00:00.000,Montevideo Uruguay ATP World Tour,CLAY,2,Marcelo Filippini,Javier Sanchez,Marcelo Filippini,7-6(5); 4-6; 7-5,R16,150,1,1,82,113,55,82,15,31,5,8,17,70,113,2,5,76,119,50,76,23,43,9,12,17,73,119
1995-10-30 00:00:00.000,Montevideo Uruguay ATP World Tour,CLAY,2,Alberto Berasategui,Emilio Sanchez,Alberto Berasategui,6-0; 6-2,R16,57,3,2,25,40,16,25,10,15,6,7,7,26,40,2,1,44,65,20,44,7,21,13,19,7,27,65
1995-10-30 00:00:00.000,Montevideo Uruguay ATP World Tour,CLAY,2,Bohdan Ulihrach,Karim Alami,Bohdan Ulihrach,6-1; 6-3,Q,55,0,0,24,42,19,24,14,18,1,1,8,33,42,1,2,27,48,15,27,9,21,2,6,8,24,48
1995-10-30 00:00:00.000,Montevideo Uruguay ATP World Tour,CLAY,2,Francisco Clavet,Hernan Gumy,Francisco Clavet,7-6(3); 6-1,Q,98,2,0,36,53,25,36,10,17,1,3,9,35,53,0,1,49,81,25,49,14,32,10,15,10,39,81
1995-10-30 00:00:00.000,Montevideo Uruguay ATP World Tour,CLAY,2,Jordi Burillo,Fernando Meligeni,Jordi Burillo,6-2; 1-6; 6-2,Q,92,5,5,35,75,21,35,19,40,4,8,11,40,75,3,1,29,72,19,29,18,43,4,10,12,37,72
1995-10-30 00:00:00.000,Montevideo Uruguay ATP World Tour,CLAY,2,Alberto Berasategui,Marcelo Filippini,Alberto Berasategui,6-2; 6-1,Q,67,0,1,39,48,25,39,5,9,1,2,7,30,48,1,0,38,64,19,38,9,26,8,14,8,28,64
1995-10-30 00:00:00.000,Montevideo Uruguay ATP World Tour,CLAY,2,Bohdan Ulihrach,Francisco Clavet,Bohdan Ulihrach,7-5; 6-4,S,108,2,4,43,81,27,43,18,38,7,11,11,45,81,1,2,43,77,23,43,14,34,5,11,11,37,77
1995-10-30 00:00:00.000,Montevideo Uruguay ATP World Tour,CLAY,2,Alberto Berasategui,Jordi Burillo,Alberto Berasategui,5-7; 6-3; 7-5,S,121,2,0,74,107,50,74,15,33,8,12,17,65,107,17,5,61,114,43,61,20,53,5,10,16,63,114
1995-10-30 00:00:00.000,Montevideo Uruguay ATP World Tour,CLAY,2,Bohdan Ulihrach,Alberto Berasategui,Bohdan Ulihrach,6-2; 6-3,F,56,3,0,27,45,22,27,11,18,0,0,8,33,45,1,0,47,62,25,47,8,15,6,10,9,33,62
1995-11-06 00:00:00.000,Buenos Aires Argentina ATP World Tour,CLAY,2,Jordi Burillo,Gilbert Schaller,Jordi Burillo,6-3; 2-6; 6-4,R32,106,10,2,40,76,30,40,19,36,0,3,14,49,76,5,6,46,94,34,46,22,48,4,7,13,56,94
1995-11-06 00:00:00.000,Buenos Aires Argentina ATP World Tour,CLAY,2,Galo Blanco,Alex Lopez Moron,Galo Blanco,6-4; 0-6; 6-3,R32,105,1,2,54,86,34,54,14,32,9,13,12,48,86,1,2,72,91,44,72,9,19,7,11,13,53,91
1995-11-06 00:00:00.000,Buenos Aires Argentina ATP World Tour,CLAY,2,Jiri Novak,David Rikl,Jiri Novak,6-2; 6-4,R32,74,0,2,42,62,25,42,10,20,4,7,9,35,62,0,2,31,63,14,31,14,32,7,13,9,28,63
1995-11-06 00:00:00.000,Buenos Aires Argentina ATP World Tour,CLAY,2,Javier Sanchez,Gaston Etlis,Javier Sanchez,6-4; 4-6; 6-1,R32,95,3,2,60,84,40,60,15,24,4,5,13,55,84,8,0,56,83,41,56,11,27,5,9,14,52,83
1995-11-06 00:00:00.000,Buenos Aires Argentina ATP World Tour,CLAY,2,Alberto Berasategui,Jordi Arrese,Alberto Berasategui,6-2; 6-4,R32,73,4,1,55,65,35,55,6,10,5,6,9,41,65,3,1,39,53,19,39,8,14,3,7,9,27,53
1995-11-06 00:00:00.000,Buenos Aires Argentina ATP World Tour,CLAY,2,Nuno Marques,Tomas Carbonell,Nuno Marques,6-3; 6-1,R32,56,1,1,37,45,31,37,3,8,1,1,8,34,45,2,2,37,51,22,37,3,14,0,4,8,25,51
1995-11-06 00:00:00.000,Buenos Aires Argentina ATP World Tour,CLAY,2,Karim Alami,Fernando Meligeni,Karim Alami,6-2; 6-2,R32,57,2,1,26,49,18,26,17,23,1,1,8,35,49,0,3,25,53,17,25,10,28,5,9,8,27,53
1995-11-06 00:00:00.000,Buenos Aires Argentina ATP World Tour,CLAY,2,Carlos Moya,Marcelo Filippini,Carlos Moya,6-4; 6-3,R32,81,1,3,34,58,26,34,15,24,3,3,9,41,58,3,0,47,71,26,47,14,24,9,12,10,40,71
1995-11-06 00:00:00.000,Buenos Aires Argentina ATP World Tour,CLAY,2,Vincent Spadea,Francisco Clavet,Vincent Spadea,6-2; 3-6; 6-3,R32,120,0,0,43,79,23,43,15,36,6,13,13,38,79,2,4,59,101,31,59,14,42,6,15,13,45,101
1995-11-06 00:00:00.000,Buenos Aires Argentina ATP World Tour,CLAY,2,Hernan Gumy,Mariano Zabaleta,Hernan Gumy,6-4; 3-6; 6-1,R32,130,3,7,54,83,37,54,13,29,4,6,13,50,83,3,1,55,86,32,55,18,31,5,9,13,50,86
1995-11-06 00:00:00.000,Buenos Aires Argentina ATP World Tour,CLAY,2,Alex Corretja,Slava Dosedel,Alex Corretja,6-4; 6-0,R32,61,1,0,32,44,26,32,5,12,3,4,8,31,44,0,0,27,43,9,27,8,16,2,7,8,17,43
1995-11-06 00:00:00.000,Buenos Aires Argentina ATP World Tour,CLAY,2,Marcelo Rios,Franco Davin,Marcelo Rios,6-7(6); 6-4; 6-4,R32,140,1,0,75,106,53,75,21,31,1,2,16,74,106,3,0,91,128,59,91,19,37,7,10,16,78,128
1995-11-06 00:00:00.000,Buenos Aires Argentina ATP World Tour,CLAY,2,Christian Ruud,Bohdan Ulihrach,Christian Ruud,6-3; 4-6; 7-6(3),R32,151,6,4,61,117,43,61,25,56,9,13,16,68,117,3,1,65,113,44,65,20,48,6,10,15,64,113
1995-11-06 00:00:00.000,Buenos Aires Argentina ATP World Tour,CLAY,2,Felix Mantilla,Sjeng Schalken,Felix Mantilla,7-5; 6-0,R32,78,0,0,45,58,27,45,8,13,3,5,9,35,58,1,3,36,60,22,36,4,24,3,9,9,26,60
1995-11-06 00:00:00.000,Buenos Aires Argentina ATP World Tour,CLAY,2,Emilio Sanchez,Donald Johnson,Emilio Sanchez,6-1; 6-4,R32,64,3,0,39,52,31,39,8,13,2,2,9,39,52,0,1,43,49,24,43,2,6,3,6,8,26,49
1995-11-06 00:00:00.000,Buenos Aires Argentina ATP World Tour,CLAY,2,Albert Costa,Javier Frana,Albert Costa,7-6(8); 3-6; 6-1,R32,124,1,4,75,111,47,75,23,36,9,11,14,70,111,6,1,60,99,41,60,21,39,4,7,14,62,99
1995-11-06 00:00:00.000,Buenos Aires Argentina ATP World Tour,CLAY,2,Galo Blanco,Jordi Burillo,Galo Blanco,7-5; 6-1,R16,65,1,1,32,53,20,32,12,21,2,5,10,32,53,4,1,33,62,17,33,10,29,6,12,9,27,62
1995-11-06 00:00:00.000,Buenos Aires Argentina ATP World Tour,CLAY,2,Jiri Novak,Javier Sanchez,Jiri Novak,6-0; 7-6(2),R16,70,3,0,41,64,23,41,15,23,3,6,9,38,64,0,4,31,58,16,31,7,27,3,9,9,23,58
1995-11-06 00:00:00.000,Buenos Aires Argentina ATP World Tour,CLAY,2,Alberto Berasategui,Nuno Marques,Alberto Berasategui,6-3; 6-7(2); 6-2,R16,109,3,2,77,89,51,77,7,12,7,8,14,58,89,4,5,78,104,51,78,8,26,8,13,15,59,104
1995-11-06 00:00:00.000,Buenos Aires Argentina ATP World Tour,CLAY,2,Carlos Moya,Karim Alami,Carlos Moya,6-4; 7-6(5),R16,78,0,0,47,65,31,47,13,18,3,5,11,44,65,4,3,36,71,25,36,15,35,2,5,11,40,71
1995-11-06 00:00:00.000,Buenos Aires Argentina ATP World Tour,CLAY,2,Hernan Gumy,Vincent Spadea,Hernan Gumy,6-2; 5-7; 6-4,R16,138,1,6,63,94,43,63,12,31,4,8,15,55,94,4,1,52,95,30,52,22,43,5,11,15,52,95
1995-11-06 00:00:00.000,Buenos Aires Argentina ATP World Tour,CLAY,2,Alex Corretja,Marcelo Rios,Alex Corretja,3-6; 6-2; 6-3,R16,104,1,1,57,81,39,57,9,24,5,8,13,48,81,4,0,53,86,30,53,16,33,3,8,13,46,86
1995-11-06 00:00:00.000,Buenos Aires Argentina ATP World Tour,CLAY,2,Felix Mantilla,Christian Ruud,Felix Mantilla,6-4; 7-6(3),R16,105,1,2,43,67,26,43,11,24,4,9,11,37,67,0,3,44,80,25,44,13,36,6,12,11,38,80
1995-11-06 00:00:00.000,Buenos Aires Argentina ATP World Tour,CLAY,2,Emilio Sanchez,Albert Costa,Emilio Sanchez,7-6(3); 1-6; 6-2,R16,138,4,5,60,104,42,60,17,44,7,11,13,59,104,0,4,81,103,49,81,10,22,9,13,14,59,103
1995-11-06 00:00:00.000,Buenos Aires Argentina ATP World Tour,CLAY,2,Jiri Novak,Galo Blanco,Jiri Novak,6-1; 6-0,Q,46,2,0,28,35,22,28,4,7,0,0,6,26,35,0,1,29,46,10,29,7,17,6,12,7,17,46
1995-11-06 00:00:00.000,Buenos Aires Argentina ATP World Tour,CLAY,2,Carlos Moya,Alberto Berasategui,Carlos Moya,6-3; 6-3,Q,64,1,0,34,50,21,34,11,16,1,3,9,32,50,0,1,44,66,18,44,13,22,6,11,9,31,66
1995-11-06 00:00:00.000,Buenos Aires Argentina ATP World Tour,CLAY,2,Alex Corretja,Hernan Gumy,Alex Corretja,6-4; 6-4,Q,104,2,0,46,66,26,46,10,20,6,9,10,36,66,1,0,32,58,20,32,11,26,1,6,10,31,58
1995-11-06 00:00:00.000,Buenos Aires Argentina ATP World Tour,CLAY,2,Felix Mantilla,Emilio Sanchez,Felix Mantilla,7-6(6); 6-4,Q,95,0,0,52,63,39,52,8,11,0,1,11,47,63,1,1,63,84,43,63,10,21,6,8,11,53,84
1995-11-06 00:00:00.000,Buenos Aires Argentina ATP World Tour,CLAY,2,Carlos Moya,Jiri Novak,Carlos Moya,7-5; 6-3,S,83,0,0,61,81,40,61,8,20,4,6,11,48,81,1,1,38,62,22,38,11,24,2,6,10,33,62
1995-11-06 00:00:00.000,Buenos Aires Argentina ATP World Tour,CLAY,2,Felix Mantilla,Alex Corretja,Felix Mantilla,3-6; 6-3; 6-3,S,135,3,0,60,91,37,60,19,31,9,11,13,56,91,2,1,54,88,33,54,20,34,6,10,14,53,88
1995-11-06 00:00:00.000,Buenos Aires Argentina ATP World Tour,CLAY,2,Carlos Moya,Felix Mantilla,Carlos Moya,6-0; 6-3,F,59,1,0,39,55,25,39,9,16,5,6,8,34,55,0,1,33,47,13,33,5,14,3,8,7,18,47
1995-11-06 00:00:00.000,Moscow Russia ATP World Tour,HARD,2,Yevgeny Kafelnikov,Frederik Fetterlein,Yevgeny Kafelnikov,6-3; 7-5,R32,0,0,0,0,0,0,0,0,0,0,0,0,0,0,0,0,0,0,0,0,0,0,0,0,0,0,0
1995-11-06 00:00:00.000,Moscow Russia ATP World Tour,HARD,2,Cedric Pioline,Brett Steven,Cedric Pioline,6-2; 6-3,R32,0,0,0,0,0,0,0,0,0,0,0,0,0,0,0,0,0,0,0,0,0,0,0,0,0,0,0
1995-11-06 00:00:00.000,Moscow Russia ATP World Tour,HARD,2,Jakob Hlasek,Hendrik Jan Davids,Jakob Hlasek,6-4; 6-3,R32,0,0,0,0,0,0,0,0,0,0,0,0,0,0,0,0,0,0,0,0,0,0,0,0,0,0,0
1995-11-06 00:00:00.000,Moscow Russia ATP World Tour,HARD,2,Byron Black,Vladimir Voltchkov,Byron Black,6-3; 6-2,R32,0,0,0,0,0,0,0,0,0,0,0,0,0,0,0,0,0,0,0,0,0,0,0,0,0,0,0
1995-11-06 00:00:00.000,Moscow Russia ATP World Tour,HARD,2,Andrei Chesnokov,Tommy Ho,Andrei Chesnokov,7-5; 7-6(3),R32,0,0,0,0,0,0,0,0,0,0,0,0,0,0,0,0,0,0,0,0,0,0,0,0,0,0,0
1995-11-06 00:00:00.000,Moscow Russia ATP World Tour,HARD,2,Daniel Vacek,Adrian Voinea,Daniel Vacek,6-2; 6-0,R32,0,0,0,0,0,0,0,0,0,0,0,0,0,0,0,0,0,0,0,0,0,0,0,0,0,0,0
1995-11-06 00:00:00.000,Moscow Russia ATP World Tour,HARD,2,Sander Groen,Michael Joyce,Sander Groen,6-3; 7-6(4),R32,0,0,0,0,0,0,0,0,0,0,0,0,0,0,0,0,0,0,0,0,0,0,0,0,0,0,0
1995-11-06 00:00:00.000,Moscow Russia ATP World Tour,HARD,2,Alexander Volkov,Lionel Roux,Alexander Volkov,4-6; 7-6(3); 6-0,R32,0,0,0,0,0,0,0,0,0,0,0,0,0,0,0,0,0,0,0,0,0,0,0,0,0,0,0
1995-11-06 00:00:00.000,Moscow Russia ATP World Tour,HARD,2,Karol Kucera,Jan Siemerink,Karol Kucera,4-6; 7-5; 7-5,R32,0,0,0,0,0,0,0,0,0,0,0,0,0,0,0,0,0,0,0,0,0,0,0,0,0,0,0
1995-11-06 00:00:00.000,Moscow Russia ATP World Tour,HARD,2,Scott Draper,Wayne Black,Scott Draper,6-1; 7-6(4),R32,0,0,0,0,0,0,0,0,0,0,0,0,0,0,0,0,0,0,0,0,0,0,0,0,0,0,0
1995-11-06 00:00:00.000,Moscow Russia ATP World Tour,HARD,2,Jan Kroslak,Aaron Krickstein,Jan Kroslak,6-1; 6-2,R32,0,0,0,0,0,0,0,0,0,0,0,0,0,0,0,0,0,0,0,0,0,0,0,0,0,0,0
1995-11-06 00:00:00.000,Moscow Russia ATP World Tour,HARD,2,Marc Rosset,Jeff Tarango,Marc Rosset,7-6(5); 7-6(2),R32,0,0,0,0,0,0,0,0,0,0,0,0,0,0,0,0,0,0,0,0,0,0,0,0,0,0,0
1995-11-06 00:00:00.000,Moscow Russia ATP World Tour,HARD,2,Andrei Olhovskiy,Renzo Furlan,Andrei Olhovskiy,7-6(3); 6-3,R32,0,0,0,0,0,0,0,0,0,0,0,0,0,0,0,0,0,0,0,0,0,0,0,0,0,0,0
1995-11-06 00:00:00.000,Moscow Russia ATP World Tour,HARD,2,Marc-Kevin Goellner,Jared Palmer,Marc-Kevin Goellner,6-3; 6-4,R32,0,0,0,0,0,0,0,0,0,0,0,0,0,0,0,0,0,0,0,0,0,0,0,0,0,0,0
1995-11-06 00:00:00.000,Moscow Russia ATP World Tour,HARD,2,Carl-Uwe Steeb,Martin Sinner,Carl-Uwe Steeb,3-6; 7-6(3); 7-6(3),R32,0,0,0,0,0,0,0,0,0,0,0,0,0,0,0,0,0,0,0,0,0,0,0,0,0,0,0
1995-11-06 00:00:00.000,Moscow Russia ATP World Tour,HARD,2,Shuzo Matsuoka,Goran Ivanisevic,Shuzo Matsuoka,7-6(5); 6-4,R32,0,0,0,0,0,0,0,0,0,0,0,0,0,0,0,0,0,0,0,0,0,0,0,0,0,0,0
1995-11-06 00:00:00.000,Moscow Russia ATP World Tour,HARD,2,Yevgeny Kafelnikov,Cedric Pioline,Yevgeny Kafelnikov,7-5; 6-1,R16,0,0,0,0,0,0,0,0,0,0,0,0,0,0,0,0,0,0,0,0,0,0,0,0,0,0,0
1995-11-06 00:00:00.000,Moscow Russia ATP World Tour,HARD,2,Byron Black,Jakob Hlasek,Byron Black,3-6; 6-3; 6-4,R16,0,0,0,0,0,0,0,0,0,0,0,0,0,0,0,0,0,0,0,0,0,0,0,0,0,0,0
1995-11-06 00:00:00.000,Moscow Russia ATP World Tour,HARD,2,Daniel Vacek,Andrei Chesnokov,Daniel Vacek,7-6(5); 6-4,R16,0,0,0,0,0,0,0,0,0,0,0,0,0,0,0,0,0,0,0,0,0,0,0,0,0,0,0
1995-11-06 00:00:00.000,Moscow Russia ATP World Tour,HARD,2,Alexander Volkov,Sander Groen,Alexander Volkov,5-7; 6-2; 6-3,R16,0,0,0,0,0,0,0,0,0,0,0,0,0,0,0,0,0,0,0,0,0,0,0,0,0,0,0
1995-11-06 00:00:00.000,Moscow Russia ATP World Tour,HARD,2,Scott Draper,Karol Kucera,Scott Draper,6-1; 7-6(3),R16,0,0,0,0,0,0,0,0,0,0,0,0,0,0,0,0,0,0,0,0,0,0,0,0,0,0,0
1995-11-06 00:00:00.000,Moscow Russia ATP World Tour,HARD,2,Marc Rosset,Jan Kroslak,Marc Rosset,6-4; 6-3,R16,0,0,0,0,0,0,0,0,0,0,0,0,0,0,0,0,0,0,0,0,0,0,0,0,0,0,0
1995-11-06 00:00:00.000,Moscow Russia ATP World Tour,HARD,2,Andrei Olhovskiy,Marc-Kevin Goellner,Andrei Olhovskiy,6-4; 6-7(8); 7-6(5),R16,0,0,0,0,0,0,0,0,0,0,0,0,0,0,0,0,0,0,0,0,0,0,0,0,0,0,0
1995-11-06 00:00:00.000,Moscow Russia ATP World Tour,HARD,2,Carl-Uwe Steeb,Shuzo Matsuoka,Carl-Uwe Steeb,6-2; 6-7(4); 6-3,R16,0,0,0,0,0,0,0,0,0,0,0,0,0,0,0,0,0,0,0,0,0,0,0,0,0,0,0
1995-11-06 00:00:00.000,Moscow Russia ATP World Tour,HARD,2,Yevgeny Kafelnikov,Byron Black,Yevgeny Kafelnikov,6-7(2); 6-0; 6-0,Q,0,0,0,0,0,0,0,0,0,0,0,0,0,0,0,0,0,0,0,0,0,0,0,0,0,0,0
1995-11-06 00:00:00.000,Moscow Russia ATP World Tour,HARD,2,Daniel Vacek,Alexander Volkov,Daniel Vacek,6-2; 6-3,Q,0,0,0,0,0,0,0,0,0,0,0,0,0,0,0,0,0,0,0,0,0,0,0,0,0,0,0
1995-11-06 00:00:00.000,Moscow Russia ATP World Tour,HARD,2,Marc Rosset,Scott Draper,Marc Rosset,6-4; 6-2,Q,0,0,0,0,0,0,0,0,0,0,0,0,0,0,0,0,0,0,0,0,0,0,0,0,0,0,0
1995-11-06 00:00:00.000,Moscow Russia ATP World Tour,HARD,2,Carl-Uwe Steeb,Andrei Olhovskiy,Carl-Uwe Steeb,6-1; 7-6(7),Q,0,0,0,0,0,0,0,0,0,0,0,0,0,0,0,0,0,0,0,0,0,0,0,0,0,0,0
1995-11-06 00:00:00.000,Moscow Russia ATP World Tour,HARD,2,Daniel Vacek,Yevgeny Kafelnikov,Daniel Vacek,7-6(8); 3-6; 7-6(5),S,0,0,0,0,0,0,0,0,0,0,0,0,0,0,0,0,0,0,0,0,0,0,0,0,0,0,0
1995-11-06 00:00:00.000,Moscow Russia ATP World Tour,HARD,2,Carl-Uwe Steeb,Marc Rosset,Carl-Uwe Steeb,7-5; 5-7; 6-4,S,0,0,0,0,0,0,0,0,0,0,0,0,0,0,0,0,0,0,0,0,0,0,0,0,0,0,0
1995-11-06 00:00:00.000,Moscow Russia ATP World Tour,HARD,2,Carl-Uwe Steeb,Daniel Vacek,Carl-Uwe Steeb,7-6(5); 3-6; 7-6(6),F,0,0,0,0,0,0,0,0,0,0,0,0,0,0,0,0,0,0,0,0,0,0,0,0,0,0,0
1995-11-06 00:00:00.000,Stockholm Sweden ATP World Tour,HARD,2,Jim Courier,Michael Tebbutt,Jim Courier,6-0; 6-2,R32,55,6,0,23,36,19,23,9,13,0,0,7,28,36,5,3,13,44,10,13,7,31,2,7,7,17,44
1995-11-06 00:00:00.000,Stockholm Sweden ATP World Tour,HARD,2,Todd Woodbridge,Magnus Gustafsson,Todd Woodbridge,4-6; 6-1; 6-4,R32,101,4,2,41,81,26,41,23,40,2,5,14,49,81,2,4,56,92,33,56,17,36,11,16,13,50,92
1995-11-06 00:00:00.000,Stockholm Sweden ATP World Tour,HARD,2,David Prinosil,David Wheaton,David Prinosil,6-4; 6-4,R32,69,12,1,31,60,26,31,15,29,1,2,10,41,60,2,4,41,65,29,41,10,24,6,9,10,39,65
1995-11-06 00:00:00.000,Stockholm Sweden ATP World Tour,HARD,2,Olivier Delaitre,Paul Haarhuis,Olivier Delaitre,6-2; 7-6(3),R32,74,3,4,25,61,20,25,23,36,1,2,10,43,61,7,1,41,74,29,41,13,33,5,8,10,42,74
1995-11-06 00:00:00.000,Stockholm Sweden ATP World Tour,HARD,2,Richard Krajicek,Greg Rusedski,Richard Krajicek,7-6(3); 5-7; 7-5,R32,135,9,2,73,107,57,73,22,34,2,3,18,79,107,10,3,93,149,69,93,25,56,17,18,18,94,149
1995-11-06 00:00:00.000,Stockholm Sweden ATP World Tour,HARD,2,Mikael Tillstrom,Mats Wilander,Mikael Tillstrom,6-3; 7-6(2),R32,99,4,4,44,81,33,44,16,37,5,8,11,49,81,4,2,47,79,29,47,12,32,8,12,10,41,79
1995-11-06 00:00:00.000,Stockholm Sweden ATP World Tour,HARD,2,Henrik Holm,Kenneth Carlsen,Henrik Holm,6-4; 3-6; 6-2,R32,96,11,12,39,71,36,39,16,32,1,2,13,52,71,8,4,46,83,34,46,19,37,2,5,14,53,83
1995-11-06 00:00:00.000,Stockholm Sweden ATP World Tour,HARD,2,Arnaud Boetsch,Patrick McEnroe,Arnaud Boetsch,7-5; 2-6; 7-6(3),R32,129,10,2,45,93,36,45,19,48,4,10,16,55,93,1,3,67,115,39,67,24,48,10,15,16,63,115
1995-11-06 00:00:00.000,Stockholm Sweden ATP World Tour,HARD,2,Todd Martin,Martin Damm,Todd Martin,6-7(4); 6-3; 6-3,R32,111,18,4,53,88,41,53,18,35,1,3,15,59,88,14,7,49,97,36,49,22,48,4,9,15,58,97
1995-11-06 00:00:00.000,Stockholm Sweden ATP World Tour,HARD,2,Richey Reneberg,Mark Woodforde,Richey Reneberg,6-2; 7-5,R32,88,3,0,32,64,27,32,16,32,6,7,10,43,64,2,0,61,81,35,61,8,20,5,9,10,43,81
1995-11-06 00:00:00.000,Stockholm Sweden ATP World Tour,HARD,2,Jonas Bjorkman,Jacco Eltingh,Jonas Bjorkman,7-5; 6-3,R32,79,2,0,28,53,21,28,20,25,0,0,10,41,53,5,6,44,85,33,44,16,41,6,9,11,49,85
1995-11-06 00:00:00.000,Stockholm Sweden ATP World Tour,HARD,2,Magnus Larsson,Anders Jarryd,Magnus Larsson,6-1; 6-4,R32,66,2,0,36,60,27,36,15,24,3,3,9,42,60,6,4,27,51,19,27,10,24,2,5,8,29,51
1995-11-06 00:00:00.000,Stockholm Sweden ATP World Tour,HARD,2,Stefan Edberg,Jonathan Stark,Stefan Edberg,6-3; 6-1,R32,61,2,0,33,45,25,33,8,12,0,0,8,33,45,5,4,27,54,17,27,11,27,4,8,8,28,54
1995-11-06 00:00:00.000,Stockholm Sweden ATP World Tour,HARD,2,MaliVai Washington,Filip Dewulf,MaliVai Washington,6-2; 7-5,R32,59,6,0,32,46,28,32,7,14,0,2,10,35,46,0,2,35,66,18,35,15,31,1,6,10,33,66
1995-11-06 00:00:00.000,Stockholm Sweden ATP World Tour,HARD,2,Andrei Pavel,Thomas Johansson,Andrei Pavel,6-3; 6-1,R32,56,2,2,31,47,23,31,12,16,2,2,8,35,47,2,0,19,49,12,19,12,30,3,7,8,24,49
1995-11-06 00:00:00.000,Stockholm Sweden ATP World Tour,HARD,2,Thomas Enqvist,Hendrik Dreekmann,Thomas Enqvist,7-6(4); 3-6; 7-5,R32,126,9,11,59,121,42,59,29,62,6,11,17,71,121,6,5,38,96,28,38,30,58,0,4,16,58,96
1995-11-06 00:00:00.000,Stockholm Sweden ATP World Tour,HARD,2,Jim Courier,Todd Woodbridge,Jim Courier,6-4; 6-3,R16,75,5,1,35,60,30,35,15,25,2,2,10,45,60,6,3,44,60,29,44,9,16,3,5,9,38,60
1995-11-06 00:00:00.000,Stockholm Sweden ATP World Tour,HARD,2,David Prinosil,Olivier Delaitre,David Prinosil,6-4; 6-3,R16,57,5,0,26,55,21,26,17,29,1,2,10,38,55,2,4,26,51,17,26,13,25,5,8,9,30,51
1995-11-06 00:00:00.000,Stockholm Sweden ATP World Tour,HARD,2,Mikael Tillstrom,Richard Krajicek,Mikael Tillstrom,7-6(7); 2-6; 6-3,R16,100,1,2,51,82,37,51,17,31,3,6,14,54,82,23,4,62,97,46,62,16,35,3,6,15,62,97
1995-11-06 00:00:00.000,Stockholm Sweden ATP World Tour,HARD,2,Arnaud Boetsch,Henrik Holm,Arnaud Boetsch,2-6; 6-2; 7-6(5),R16,112,5,2,48,91,35,48,23,43,3,6,14,58,91,16,14,47,98,37,47,23,51,7,10,14,60,98
1995-11-06 00:00:00.000,Stockholm Sweden ATP World Tour,HARD,2,Richey Reneberg,Todd Martin,Richey Reneberg,6-3; 7-6(7),R16,90,4,0,43,81,33,43,19,38,4,6,11,52,81,9,0,37,63,27,37,15,26,3,6,10,42,63
1995-11-06 00:00:00.000,Stockholm Sweden ATP World Tour,HARD,2,Magnus Larsson,Jonas Bjorkman,Magnus Larsson,5-7; 7-5; 7-5,R16,128,9,2,67,119,49,67,25,52,6,9,18,74,119,4,5,75,120,51,75,23,45,4,8,18,74,120
1995-11-06 00:00:00.000,Stockholm Sweden ATP World Tour,HARD,2,Stefan Edberg,MaliVai Washington,Stefan Edberg,6-3; 6-7(3); 6-0,R16,102,6,5,42,78,29,42,21,36,3,5,13,50,78,4,2,38,77,23,38,20,39,1,8,14,43,77
1995-11-06 00:00:00.000,Stockholm Sweden ATP World Tour,HARD,2,Thomas Enqvist,Andrei Pavel,Thomas Enqvist,6-1; 6-3,R16,57,6,0,22,48,18,22,16,26,2,3,8,34,48,3,1,36,56,18,36,9,20,7,12,8,27,56
1995-11-06 00:00:00.000,Stockholm Sweden ATP World Tour,HARD,2,David Prinosil,Jim Courier,David Prinosil,6-3; 7-6(4),Q,93,10,3,47,91,38,47,20,44,7,8,11,58,91,4,2,35,54,25,35,12,19,0,2,10,37,54
1995-11-06 00:00:00.000,Stockholm Sweden ATP World Tour,HARD,2,Arnaud Boetsch,Mikael Tillstrom,Arnaud Boetsch,7-5; 6-4,Q,72,4,3,43,74,33,43,13,31,6,8,11,46,74,3,4,30,59,24,30,12,29,3,7,11,36,59
1995-11-06 00:00:00.000,Stockholm Sweden ATP World Tour,HARD,2,Richey Reneberg,Magnus Larsson,Richey Reneberg,6-3; 6-2,Q,70,2,2,36,63,26,36,18,27,7,7,9,44,63,4,3,37,59,23,37,8,22,6,9,8,31,59
1995-11-06 00:00:00.000,Stockholm Sweden ATP World Tour,HARD,2,Thomas Enqvist,Stefan Edberg,Thomas Enqvist,6-3; 7-5,Q,88,5,3,44,79,34,44,17,35,3,4,11,51,79,4,2,47,70,30,47,11,23,6,9,10,41,70
1995-11-06 00:00:00.000,Stockholm Sweden ATP World Tour,HARD,2,Arnaud Boetsch,David Prinosil,Arnaud Boetsch,6-1; 1-6; 7-5,S,90,2,3,36,85,27,36,27,49,5,7,13,54,85,10,2,40,76,33,40,15,36,7,10,13,48,76
1995-11-06 00:00:00.000,Stockholm Sweden ATP World Tour,HARD,2,Thomas Enqvist,Richey Reneberg,Thomas Enqvist,6-2; 6-1,S,53,13,0,27,40,24,27,7,13,0,0,7,31,40,2,2,33,60,19,33,9,27,2,7,8,28,60
1995-11-06 00:00:00.000,Stockholm Sweden ATP World Tour,HARD,2,Thomas Enqvist,Arnaud Boetsch,Thomas Enqvist,7-5; 6-4,F,82,14,2,36,64,29,36,18,28,3,3,11,47,64,2,2,46,81,33,46,15,35,13,15,11,48,81
1995-12-05 00:00:00.000,Grand Slam Cup Germany ATP World Tour,HARD,2,Pete Sampras,Patrick McEnroe,Pete Sampras,6-1; 7-6,R16,0,0,0,0,0,0,0,0,0,0,0,0,0,0,0,0,0,0,0,0,0,0,0,0,0,0,0
1995-12-05 00:00:00.000,Grand Slam Cup Germany ATP World Tour,HARD,2,Goran Ivanisevic,Petr Korda,Goran Ivanisevic,7-6; 6-3,R16,0,0,0,0,0,0,0,0,0,0,0,0,0,0,0,0,0,0,0,0,0,0,0,0,0,0,0
1995-12-05 00:00:00.000,Grand Slam Cup Germany ATP World Tour,HARD,2,Jacco Eltingh,Michael Chang,Jacco Eltingh,7-6; 6-3,R16,0,0,0,0,0,0,0,0,0,0,0,0,0,0,0,0,0,0,0,0,0,0,0,0,0,0,0
1995-12-05 00:00:00.000,Grand Slam Cup Germany ATP World Tour,HARD,2,Yevgeny Kafelnikov,Renzo Furlan,Yevgeny Kafelnikov,6-4; 6-1,R16,0,0,0,0,0,0,0,0,0,0,0,0,0,0,0,0,0,0,0,0,0,0,0,0,0,0,0
1995-12-05 00:00:00.000,Grand Slam Cup Germany ATP World Tour,HARD,2,Byron Black,Thomas Muster,Byron Black,7-6; 2-6; 6-1,R16,0,0,0,0,0,0,0,0,0,0,0,0,0,0,0,0,0,0,0,0,0,0,0,0,0,0,0
1995-12-05 00:00:00.000,Grand Slam Cup Germany ATP World Tour,HARD,2,Boris Becker,Cedric Pioline,Boris Becker,6-1; 6-7; 9-7,R16,0,0,0,0,0,0,0,0,0,0,0,0,0,0,0,0,0,0,0,0,0,0,0,0,0,0,0
1995-12-05 00:00:00.000,Grand Slam Cup Germany ATP World Tour,HARD,2,Andrei Medvedev,Aaron Krickstein,Andrei Medvedev,6-2; 7-6,R16,0,0,0,0,0,0,0,0,0,0,0,0,0,0,0,0,0,0,0,0,0,0,0,0,0,0,0
1995-12-05 00:00:00.000,Grand Slam Cup Germany ATP World Tour,HARD,2,Todd Martin,Sergi Bruguera,Todd Martin,7-6; 6-2,R16,0,0,0,0,0,0,0,0,0,0,0,0,0,0,0,0,0,0,0,0,0,0,0,0,0,0,0
1995-12-05 00:00:00.000,Grand Slam Cup Germany ATP World Tour,HARD,2,Goran Ivanisevic,Pete Sampras,Goran Ivanisevic,W/O,Q,0,0,0,0,0,0,0,0,0,0,0,0,0,0,0,0,0,0,0,0,0,0,0,0,0,0,0
1995-12-05 00:00:00.000,Grand Slam Cup Germany ATP World Tour,HARD,2,Yevgeny Kafelnikov,Jacco Eltingh,Yevgeny Kafelnikov,3-6; 6-3; 6-2,Q,0,0,0,0,0,0,0,0,0,0,0,0,0,0,0,0,0,0,0,0,0,0,0,0,0,0,0
1995-12-05 00:00:00.000,Grand Slam Cup Germany ATP World Tour,HARD,2,Boris Becker,Byron Black,Boris Becker,7-6; 6-1,Q,0,0,0,0,0,0,0,0,0,0,0,0,0,0,0,0,0,0,0,0,0,0,0,0,0,0,0
1995-12-05 00:00:00.000,Grand Slam Cup Germany ATP World Tour,HARD,2,Todd Martin,Andrei Medvedev,Todd Martin,6-3; 3-6; 4-0 RET,Q,0,0,0,0,0,0,0,0,0,0,0,0,0,0,0,0,0,0,0,0,0,0,0,0,0,0,0
1995-12-05 00:00:00.000,Grand Slam Cup Germany ATP World Tour,HARD,2,Goran Ivanisevic,Yevgeny Kafelnikov,Goran Ivanisevic,7-6; 4-6; 6-3; 6-4,S,0,0,0,0,0,0,0,0,0,0,0,0,0,0,0,0,0,0,0,0,0,0,0,0,0,0,0
1995-12-05 00:00:00.000,Grand Slam Cup Germany ATP World Tour,HARD,2,Todd Martin,Boris Becker,Todd Martin,5-7; 6-3; 6-4; 7-6,S,0,0,0,0,0,0,0,0,0,0,0,0,0,0,0,0,0,0,0,0,0,0,0,0,0,0,0
1995-12-05 00:00:00.000,Grand Slam Cup Germany ATP World Tour,HARD,2,Goran Ivanisevic,Todd Martin,Goran Ivanisevic,7-6; 6-3; 6-4,F,0,0,0,0,0,0,0,0,0,0,0,0,0,0,0,0,0,0,0,0,0,0,0,0,0,0,0
